id;title;imdbID;rtAllCriticsRating;rtAllCriticsNumReviews;rtAllCriticsNumFresh;rtAllCriticsNumRotten;rtAllCriticsScore;rtTopCriticsRating;rtTopCriticsNumReviews;rtTopCriticsNumFresh;rtTopCriticsNumRotten;rtTopCriticsScore;rtAudienceRating;rtAudienceNumRatings;rtAudienceScore
1;Toy story;114709;9;73;73;0;100;8.5;17;17;0;100;3.7;102338;81
2;Jumanji;113497;5.6;28;13;15;46;5.8;5;2;3;40;3.2;44587;61
3;Grumpy Old Men;107050;5.9;36;24;12;66;7;6;5;1;83;3.2;10489;66
4;Waiting to Exhale;114885;5.6;25;14;11;56;5.5;11;5;6;45;3.3;5666;79
5;Father of the Bride Part II;113041;5.3;19;9;10;47;5.4;5;1;4;20;3;13761;64
6;Heat;113277;7.7;58;50;8;86;7.2;17;14;3;82;3.9;42785;92
7;Sabrina;47437;7.4;31;28;3;90;7.2;5;5;0;100;3.8;12812;87
8;Tom and Huck;112302;4.2;8;2;6;25;0;2;1;1;50;2.7;2649;45
9;Sudden Death;114576;5.2;32;17;15;53;5.6;9;5;4;55;2.6;3626;40
10;GoldenEye;113189;6.8;41;33;8;80;6.2;11;7;4;63;3.4;28260;78
11;The American President;112346;7;49;44;5;89;7.2;18;16;2;88;3.2;8320;71
12;Dracula: Dead and Loving It;112896;3;35;3;32;8;3.7;10;2;8;20;2.8;10078;52
13;Balto;112453;5.8;12;6;6;50;0;4;1;3;25;3.2;9195;66
14;Nixon;113987;6.7;56;42;14;75;6.1;18;12;6;66;3.5;3256;72
15;Cutthroat Island;112760;4.4;31;14;17;45;4.7;6;3;3;50;2.6;3350;42
16;Casino;112641;7.2;58;47;11;81;6.3;16;11;5;68;3.9;66463;91
17;Sense and Sensibility;114388;7.9;49;48;1;97;8.1;14;13;1;92;3.8;32782;88
18;Four Rooms;113101;3.5;42;6;36;14;2.9;11;0;11;0;3.5;14266;72
19;Ace Ventura: When Nature Calls;112281;4.1;25;9;16;36;0;3;1;2;33;3.2;87306;73
20;Money Train;113845;4;24;4;20;16;4.5;5;1;4;20;2.7;5263;38
21;Get Shorty;113161;7.7;49;42;7;85;8.4;14;14;0;100;3.2;10155;63
22;Copycat;112722;6.6;32;24;8;75;7.4;5;4;1;80;3.1;5628;58
23;Ninja Assassin;1186367;4.3;106;27;79;25;4.6;20;6;14;30;3.4;107023;58
24;Powder;114168;5.2;19;9;10;47;4.9;5;0;5;0;3.1;6650;67
25;Leaving Las Vegas;113627;7.7;45;40;5;88;8.1;11;11;0;100;3.6;12742;82
26;Othello;114057;6.3;38;26;12;68;6.1;11;7;4;63;3.3;2018;66
27;Now and Then;114011;4.7;16;3;13;18;5.2;5;1;4;20;3.5;17168;78
28;Persuasion;114117;7.7;23;19;4;82;8.5;9;9;0;100;3.9;7968;82
29;La cité des enfants perdus;112682;7;33;27;6;81;7.2;7;5;2;71;4;22420;89
30;Yao a yao yao dao waipo qiao;115012;6.8;21;18;3;85;0;4;3;1;75;3.6;1061;70
31;Dangerous Minds;112792;4.7;37;11;26;29;5;12;5;7;41;3.1;12136;66
32;Twelve Monkeys;114746;0;0;0;0;0;0;0;0;0;0;0;0;0
33;Wings of Courage;114952;0;4;2;2;50;0;2;1;1;50;0;0;0
34;Babe;112431;8.2;54;53;1;98;8.2;11;11;0;100;3;22954;54
35;Carrington;112637;6.2;19;9;10;47;7.4;5;4;1;80;3.5;781;68
36;Dead Man Walking;112818;8.2;53;50;3;94;7.9;20;18;2;90;3.6;15450;81
37;Across the Sea of Time;112286;0;4;2;2;50;0;1;0;1;0;2.9;237;27
38;It Takes Two;113442;3.9;24;2;22;8;4.6;8;2;6;25;2.9;16311;63
39;Clueless;112697;0;0;0;0;0;0;0;0;0;0;0;0;0
40;Cry, the Beloved Country;112749;7.2;13;10;3;76;0;4;3;1;75;3.5;520;66
41;Richard III;114279;8.1;43;41;2;95;7.6;11;10;1;90;3.7;1552;82
42;Dead Presidents;112819;5.7;31;14;17;45;6.3;12;7;5;58;3.3;4475;75
43;Restoration;114272;6.3;31;21;10;67;6.4;10;6;4;60;3.3;1103;56
44;Mortal Kombat;113855;4.4;26;9;17;34;3.9;6;2;4;33;2.8;18291;55
45;Live Free or Die Hard;337978;6.8;197;161;36;81;6.7;38;30;8;78;3.9;1145097;86
46;How to Make an American Quilt;113347;5.6;22;11;11;50;7.6;6;5;1;83;3.2;2626;58
47;Shichinin no samurai;47478;9.2;49;49;0;100;8.6;10;10;0;100;4.5;29509;97
48;Pocahontas;114148;6;49;27;22;55;6.6;14;10;4;71;3.2;37858;63
49;When Night Is Falling;114916;5.7;16;8;8;50;0;4;1;3;25;3.9;1132;83
50;The Usual Suspects;114814;7.5;47;41;6;87;6.9;14;12;2;85;4.2;109588;95
52;Mighty Aphrodite;113819;6.7;33;25;8;75;7.2;6;4;2;66;3.3;4866;69
53;Lamerica;110299;8;10;9;1;90;0;1;1;0;100;3.9;239;82
54;The Big Green;112499;2.8;5;0;5;0;0;1;0;1;0;2.7;2596;47
55;Georgia Rule;791304;3.8;116;20;96;17;3.4;30;2;28;6;3;64056;55
56;Kids of the Round Table;113541;0;0;0;0;0;0;0;0;0;0;0;0;0
57;Home for the Holidays;113321;6;44;28;16;63;5.7;11;5;6;45;3.4;3045;69
58;Il postino;110877;7.9;25;23;2;92;0;4;4;0;100;4.1;5794;92
59;Le confessionnal;112714;0;1;1;0;100;0;0;0;0;0;0;0;0
60;The Indian in the Cupboard;113419;6.2;19;13;6;68;0;2;1;1;50;2.7;5127;41
61;Eye for an Eye;116260;0;0;0;0;0;0;0;0;0;0;0;0;0
62;Mr. Holland's Opus;113862;6.7;26;19;7;73;7.5;6;5;1;83;3.5;9569;79
63;Don't Be a Menace to South Central While Drinking Your Juice in the Hood;116126;4.5;24;7;17;29;5.6;7;3;4;42;0;0;0
64;Two If by Sea;118002;3.9;27;3;24;11;0;4;0;4;0;2.6;1608;29
65;Bio-Dome;115683;1.9;21;1;20;4;2;7;0;7;0;2.6;8972;51
66;Lawnmower Man 2: Beyond Cyberspace;116839;2.8;9;1;8;11;0;3;1;2;33;2.1;952;18
67;Two Bits;114753;5;10;4;6;40;0;4;1;3;25;3.3;685;54
68;Gazon maudit;113149;6.1;10;5;5;50;0;4;1;3;25;3.4;597;58
69;Friday;113118;0;0;0;0;0;0;0;0;0;0;0;0;0
70;From Dusk Till Dawn;116367;6;43;27;16;62;4.9;10;5;5;50;3.4;36073;75
71;Fair Game;113010;2.4;24;3;21;12;3.1;8;1;7;12;2.1;1761;16
72;Kicking & Screaming;384642;5.1;137;57;80;41;5;31;12;19;38;3;14260;51
73;Les misérables;119683;6.9;41;31;10;75;6.6;11;6;5;54;3.6;7310;81
74;Bed of Roses;115644;5.3;14;3;11;21;5.2;5;1;4;20;3.2;3163;66
75;Big Bully;115676;2.8;7;0;7;0;0;2;0;2;0;2.4;1459;23
76;Screamers;114367;4.7;30;9;21;30;4.9;9;2;7;22;3;2070;45
77;Nico Icon;113973;7.1;13;11;2;84;8;5;4;1;80;4;87;85
78;The Crossing Guard;112744;6.5;27;20;7;74;0;4;2;2;50;3.3;2170;56
79;The Juror;116731;4.4;19;3;16;15;4.3;6;1;5;16;2.8;2266;39
80;Badkonake sefid;112445;6.8;20;16;4;80;6.6;8;6;2;75;4;547;86
81;Things to Do in Denver When You're Dead;114660;4.9;27;9;18;33;5.5;5;1;4;20;3.5;3197;72
82;Antonia;112379;6.5;25;16;9;64;7.8;10;9;1;90;4.2;1707;90
83;Once Upon a Time... When We Were Colored;114039;7.3;14;10;4;71;7.9;5;5;0;100;3.7;414;76
84;Last Summer in the Hamptons;113612;5.6;15;9;6;60;0;2;2;0;100;3.3;89;47
85;Angels and Insects;112365;6.5;20;14;6;70;8.1;5;5;0;100;3.3;635;62
86;White Squall;118158;5.8;30;19;11;63;6.3;10;7;3;70;3.2;3184;62
87;Dunston Checks In;116151;3.8;15;1;14;6;0;4;1;3;25;2.5;2935;39
88;Black Sheep;779982;6.4;87;61;26;70;6.3;21;15;6;71;3.2;19454;54
89;Nick of Time;113972;4.6;28;8;20;28;3.8;5;0;5;0;3.1;10563;54
90;The Journey of August King;113490;6.2;7;4;3;57;0;2;1;1;50;3.1;286;54
92;Mary Reilly;117002;4.4;41;11;30;26;4.6;9;2;7;22;2.8;3733;41
93;Vampire in Brooklyn;114825;3.6;28;3;25;10;3.1;9;0;9;0;2.4;6122;37
94;Beautiful Girls;115639;7;46;36;10;78;6.3;14;9;5;64;3.6;4674;79
95;Broken Arrow;115759;5.8;29;16;13;55;6.1;6;3;3;50;2.9;12489;51
96;In the Bleak Midwinter;113403;7.3;19;17;2;89;0;3;2;1;66;4.1;309;88
97;La haine;113247;8;14;14;0;100;0;4;4;0;100;4.3;11987;95
98;Going Shopping;295605;5;29;12;17;41;5;15;5;10;33;2.8;691;37
99;Heidi Fleiss: Hollywood Madam;113283;7.5;7;5;2;71;8.8;5;4;1;80;3;281;46
100;City Hall;115907;6.1;22;12;10;54;7;6;3;3;50;3;2730;42
101;Bottle Rocket;115734;6.6;42;33;9;78;6.1;9;5;4;55;3.7;16217;80
102;Mr. Wrong;117102;3.1;28;1;27;3;3.1;8;0;8;0;2.4;1544;29
103;Unforgettable;118040;4.4;26;6;20;23;0;4;0;4;0;3;358;36
104;Happy Gilmore;116483;5.5;50;29;21;58;5.1;11;4;7;36;3.7;114875;83
105;The Bridges of Madison County;112579;7.2;40;36;4;90;7.9;9;9;0;100;3.6;11573;83
106;Keiner liebt mich;110251;6;6;4;2;66;0;1;1;0;100;4.2;161;89
107;Muppet Treasure Island;117110;6.1;22;15;7;68;7.4;5;4;1;80;3.2;8588;68
110;Braveheart;112573;7;48;37;11;77;6.7;16;12;4;75;3.8;204275;83
111;Taxi Driver;75314;8.7;50;49;1;98;7.7;9;8;1;88;4.1;58145;93
112;Hung fan kui;113326;6.4;52;41;11;78;6.5;16;13;3;81;3.1;7517;62
113;Before and After;115645;4.8;19;6;13;31;5.7;5;2;3;40;3;1276;39
114;Margaret's Museum;113774;6.9;6;4;2;66;0;1;1;0;100;3.7;500;76
115;Le bonheur est dans le pré;112556;0;0;0;0;0;0;0;0;0;0;0;0;0
116;Anne Frank Remembered;112373;7.8;27;26;1;96;7.6;16;15;1;93;3.7;1076;79
117;The Young Poisoner's Handbook;115033;7.1;13;11;2;84;0;3;3;0;100;3.7;541;79
118;If Lucy Fell;116606;4;26;5;21;19;4.3;9;2;7;22;3.1;1202;49
119;Steal Big Steal Little;114536;4.5;13;2;11;15;0;3;0;3;0;2.9;555;36
120;Race the Sun;117427;4.8;9;2;7;22;0;3;0;3;0;2.9;822;40
121;The Boys of St. Vincent;106473;8.2;6;6;0;100;0;1;1;0;100;3.5;401;77
122;Boomerang;103859;4.8;27;10;17;37;5.4;8;4;4;50;2.8;4751;55
123;Chung Hing sam lam;109424;7.7;27;26;1;96;6.8;7;6;1;85;4.2;11068;93
124;L'uomo delle stelle;114808;6.5;12;9;3;75;7;5;4;1;80;3.7;543;73
125;Flirting with Disaster;116324;7.4;42;36;6;85;8.5;6;6;0;100;3.3;2127;65
126;The Neverending Story III;110647;0;3;1;2;33;0;0;0;0;0;0;0;0
128;Jupiter's Wife;110217;0;4;3;1;75;0;1;0;1;0;0;0;0
129;Pie in the Sky;114131;0;2;1;1;50;0;0;0;0;0;0;0;0
130;Angela's Ashes;145653;5.7;84;44;40;52;5.3;26;10;16;38;3.6;4588;79
131;Frankie Starlight;113107;5.8;6;4;2;66;0;1;1;0;100;3.8;133;61
132;The Curse of the Jade Scorpion;256524;5.2;122;55;67;45;5;36;14;22;38;3.1;4108;52
134;Sonic Outlaws;114500;0;3;2;1;66;0;0;0;0;0;0;0;0
135;Down Periscope;116130;3.8;31;4;27;12;4;8;1;7;12;2.8;3851;60
136;From the Journals of Jean Seberg;113125;7.6;9;9;0;100;0;3;3;0;100;4;30;75
137;Man of the Year;483726;4.4;141;30;111;21;5;35;11;24;31;3;29127;51
139;Hard Target;107076;5.2;29;14;15;48;5.6;7;4;3;57;0;0;0
140;Up Close & Personal;118055;5.1;31;10;21;32;6.5;6;3;3;50;3.2;2932;63
141;The Birdcage;115685;6.7;29;22;7;75;7.5;5;5;0;100;3.3;13502;75
143;Gospa;113200;\N;\N;\N;\N;\N;\N;\N;\N;\N;\N;\N;\N;\N
144;The Brothers McMullen;112585;7.1;34;31;3;91;7.8;6;6;0;100;3.2;1225;55
145;Bad Boys;112442;4.8;41;16;25;39;3.7;9;1;8;11;3.5;67658;79
146;The Amazing Panda Adventure;112342;4.3;9;2;7;22;0;3;1;2;33;3;1335;46
147;The Basketball Diaries;112461;4.9;35;15;20;42;4.7;11;3;8;27;3.5;12119;77
148;An Awfully Big Adventure;112427;5.4;11;4;7;36;0;3;0;3;0;3.2;1433;55
149;The Moguls;405163;3.9;24;4;20;16;0;4;1;3;25;3;8865;46
150;Apollo 13;112384;8;51;49;2;96;7.9;11;10;1;90;3.6;30565;78
151;Rob Roy;114287;6.3;42;30;12;71;5.8;10;5;5;50;3.3;5253;73
152;Basic Instinct 2;430912;3.1;149;10;139;6;3.2;35;1;34;2;2.5;28208;33
153;Batman Forever;112462;5.2;54;23;31;42;5.9;14;10;4;71;2.9;47498;42
154;Belle de jour;61395;8.6;36;34;2;94;7.9;9;8;1;88;4;1378;84
155;Beyond Rangoon;112495;5.1;30;11;19;36;5;10;4;6;40;3.5;3962;64
156;Blue in the Face;112541;5.5;20;9;11;45;0;3;1;2;33;3.5;1323;73
157;Canadian Bacon;109370;3.3;14;2;12;14;0;2;0;2;0;2.9;3460;49
158;Casper;112642;4.7;34;14;20;41;4.5;10;3;7;30;3;20672;54
159;Clockers;112688;6.5;46;31;15;67;6.7;12;9;3;75;3.5;2502;74
160;Congo;112715;3.6;42;9;33;21;3.2;12;1;11;8;2.6;7008;34
161;Crimson Tide;112740;7.4;44;38;6;86;8;10;9;1;90;3.5;11550;77
162;Crumb;109508;8.3;39;37;2;94;0;4;4;0;100;4;2689;88
163;Desperado;112851;6.3;38;23;15;60;5.4;10;3;7;30;3.5;23821;79
164;Devil in a Blue Dress;112857;7.3;50;44;6;88;7;14;11;3;78;3.3;2742;64
165;Die Hard: With a Vengeance;112864;5.7;42;20;22;47;5.8;10;5;5;50;3.6;61394;83
166;The Doom Generation;112887;4.9;29;14;15;48;5.3;12;7;5;58;3.3;2680;64
167;Feast of July;113044;6.2;9;6;3;66;0;4;2;2;50;2.9;226;40
168;First Knight;113071;5.2;42;19;23;45;5.5;14;7;7;50;3;13290;59
169;Free Willy 2: The Adventure Home;113114;4.6;12;3;9;25;0;3;1;2;33;2.8;8336;53
170;Hackers;113243;4.7;19;7;12;36;0;3;2;1;66;3.2;16863;66
171;Jeffrey;113464;6.1;23;14;9;60;5.7;9;4;5;44;3.4;836;68
172;Johnny Mnemonic;113481;3.3;28;4;24;14;4.7;5;1;4;20;2.5;7062;33
173;Judge Dredd;113492;3.6;47;7;40;14;3.7;10;0;10;0;2.5;10571;35
174;Jury Duty;113500;2.1;11;0;11;0;0;2;0;2;0;2.4;1843;33
175;Kids;113540;5;52;26;26;50;6.5;7;4;3;57;3.5;11282;78
176;Living in Oblivion;113677;7.4;24;21;3;87;0;2;2;0;100;3.8;1878;85
177;Lord of Illusions;113690;5.7;19;13;6;68;0;2;1;1;50;3;2344;51
178;Love & Human Remains;107447;6.5;11;7;4;63;0;4;2;2;50;0;0;0
179;Mad Love;113729;0;0;0;0;0;0;0;0;0;0;0;0;0
180;Mallrats;113749;5.4;40;21;19;52;5;9;2;7;22;3.6;40221;83
181;Mighty Morphin Power Rangers: The Movie;113820;4.6;19;8;11;42;5.5;8;5;3;62;2.7;5904;52
182;Moonlight and Valentino;113851;4.6;13;2;11;15;0;3;0;3;0;3.1;978;51
183;Mute Witness;110604;6.9;19;15;4;78;7.3;6;5;1;83;3.2;644;61
184;Nadja;110620;0;0;0;0;0;0;0;0;0;0;0;0;0
185;The Net;113957;5.1;33;11;22;33;6.9;5;3;2;60;2.8;10933;50
186;Nine Months;113986;4.3;24;6;18;25;5;5;1;4;20;2.7;8930;40
187;Party Girl;114095;6.3;31;24;7;77;6;13;8;5;61;3.5;1243;73
188;The Prophecy;114194;5.2;19;8;11;42;0;1;0;1;0;3.3;5062;71
189;The Reckless Moment;41786;0;3;3;0;100;0;0;0;0;0;0;0;0
190;Fail-Safe;58083;7.6;13;12;1;92;0;0;0;0;0;0;0;0
191;The Scarlet Letter;114345;3;33;5;28;15;3.6;11;1;10;9;2.9;3493;48
193;Showgirls;114436;2.9;41;5;36;12;3.4;10;0;10;0;2.3;7443;35
194;Smoke;114478;7.8;27;25;2;92;0;4;3;1;75;3.9;3101;88
195;Something to Talk About;114496;5.3;27;10;17;37;6.5;9;5;4;55;3;6137;55
196;Species;114508;4.9;31;12;19;38;5.1;5;1;4;20;2.7;6716;37
197;The Stars Fell on Henrietta;114534;4.9;7;2;5;28;0;1;0;1;0;3;66;18
198;Strange Days;114558;6;38;23;15;60;5.9;8;4;4;50;3.3;7016;70
199;Les parapluies de Cherbourg;58450;8.6;45;44;1;97;7.9;10;9;1;90;4.1;3199;86
200;The Tie That Binds;114666;2.8;9;1;8;11;0;3;0;3;0;3;286;34
201;Three Wishes;114663;4.4;15;2;13;13;0;4;0;4;0;3;1249;52
202;Total Eclipse;114702;4.9;16;4;12;25;0;4;1;3;25;3.4;2222;63
203;To Wong Foo Thanks for Everything, Julie Newmar;114682;5;23;8;15;34;5.2;5;0;5;0;3.1;6833;69
204;Under Siege 2: Dark Territory;114781;4.5;29;10;19;34;0;3;2;1;66;2.6;5213;47
205;Unstrung Heroes;114798;6.3;21;16;5;76;0;4;2;2;50;3.2;530;54
206;Unzipped;114805;6.7;13;10;3;76;7.9;5;5;0;100;3.3;64;67
207;A Walk in the Clouds;114887;5.5;22;9;13;40;0;3;1;2;33;3.3;12692;74
208;Waterworld;114898;5.1;48;20;28;41;6.4;9;7;2;77;2.6;18023;46
209;White Man's Burden;114928;4.5;32;8;24;25;4.4;10;1;9;10;2.8;1275;38
210;Wild Bill;114938;\N;\N;\N;\N;\N;\N;\N;\N;\N;\N;\N;\N;\N
211;The Browning Version;43362;7.8;17;15;2;88;0;3;1;2;33;4.3;270;94
212;Bushwhacked;112602;2.1;9;0;9;0;0;2;0;2;0;2.6;1388;38
213;Utomlyonnye solntsem;111579;7;13;10;3;76;0;4;3;1;75;4.3;1533;93
214;Before the Rain;110882;7.5;12;10;2;83;0;2;2;0;100;4.4;1683;93
215;Before Sunrise;112471;8.2;34;34;0;100;9.3;5;5;0;100;4.1;20616;92
216;Billy Madison;112508;4.8;35;15;20;42;0;4;1;3;25;3.5;91595;79
217;The Babysitters;796302;4.4;26;8;18;30;4.6;12;3;9;25;2.9;1237;35
218;Boys on the Side;112571;6;32;23;9;71;6.1;8;5;3;62;3.1;4572;65
219;The Cure;112757;5.5;10;4;6;40;0;4;1;3;25;3.7;2207;79
220;Castle Freak;112643;5.4;7;4;3;57;0;0;0;0;0;0;0;0
222;Circle of Friends;112679;6.5;35;27;8;77;6.5;11;8;3;72;3.3;3292;65
223;Clerks.;109445;7.4;48;42;6;87;7.1;9;8;1;88;3.8;57642;89
224;Don Juan DeMarco;112883;5.8;22;16;6;72;0;2;1;1;50;3.3;14169;70
225;Disclosure;109635;5.7;40;24;16;60;5.8;9;5;4;55;2.8;3648;41
226;Tucker: The Man and His Dream;96316;7.2;35;30;5;85;6.8;7;5;2;71;3.2;1497;58
227;Drop Zone;109676;4.1;19;6;13;31;0;3;1;2;33;2.7;2485;36
228;Destiny Turns on the Radio;112854;2.7;15;2;13;13;0;2;0;2;0;2.6;446;27
229;Death and the Maiden;109579;7;48;40;8;83;6.2;10;7;3;70;3.6;1972;76
230;Dolores Claiborne;109642;6.8;33;28;5;84;0;4;3;1;75;3.4;4632;75
231;Dumb & Dumber;109686;5.8;45;28;17;62;4.8;10;4;6;40;3.3;95871;79
232;Yin shi nan nu;111797;7.4;31;29;2;93;7.9;8;8;0;100;4;3802;91
233;Exotica;109759;8.3;27;26;1;96;0;3;3;0;100;3.7;1837;81
234;Exit to Eden;109758;2.4;15;1;14;6;0;3;0;3;0;2.3;1694;27
235;Ed Wood;109707;7.9;57;52;5;91;7.2;12;9;3;75;3.7;28216;83
236;French Kiss;113117;5.7;21;10;11;47;0;4;1;3;25;3.2;11010;70
237;Forget Paris;113097;5.4;33;17;16;51;4.7;8;2;6;25;3;2108;51
238;Far from Home: The Adventures of Yellow Dog;113028;5.2;6;3;3;50;0;0;0;0;0;0;0;0
239;A Goofy Movie;113198;5.7;14;8;6;57;0;2;1;1;50;3.1;17024;57
240;Hideaway;113303;3.5;12;2;10;16;0;4;1;3;25;2.8;1077;41
241;Fluke;113089;4;9;3;6;33;0;3;0;3;0;3.4;1598;70
242;Farinelli;109771;5.7;21;14;7;66;4.7;6;2;4;33;3.8;1092;81
243;Flash Gordon;80745;6.3;32;26;6;81;0;3;2;1;66;3.1;6492;64
244;Gumby: The Movie;113234;0;4;0;4;0;0;0;0;0;0;0;0;0
245;The Glass Shield;109906;5.6;21;13;8;61;5.2;7;3;4;42;3;263;41
246;Hoop Dreams;110057;8.5;44;43;1;97;8.1;12;12;0;100;4.1;3243;92
247;Heavenly Creatures;110005;8.3;41;39;2;95;7.8;9;9;0;100;3.7;8208;82
248;Houseguest;110066;3.4;20;3;17;15;5.2;5;3;2;60;2.8;1745;51
249;Immortal Beloved;110116;6;30;17;13;56;0;3;2;1;66;3.8;4786;87
250;Heavy Weights;110006;4.1;5;1;4;20;0;0;0;0;0;0;0;0
251;The Hunted;269347;4.7;143;44;99;30;4.5;34;10;24;29;3;5362;51
252;I.Q.;110099;5.1;21;9;12;42;0;3;1;2;33;2.8;3758;46
253;Interview with the Vampire: The Vampire Chronicles;110148;5.8;45;26;19;57;4.6;10;4;6;40;3.7;77706;85
254;Jefferson in Paris;113463;4.9;14;5;9;35;0;3;1;2;33;2.8;404;27
255;The Jerky Boys;110189;1.6;10;1;9;10;0;0;0;0;0;0;0;0
256;Junior;110216;4.7;30;10;20;33;5.8;8;5;3;62;2.4;9754;28
257;Just Cause;113501;4;26;6;20;23;4.2;8;2;6;25;3.1;2888;51
258;A Kid in King Arthur's Court;113538;3.2;6;0;6;0;0;0;0;0;0;0;0;0
259;Kiss of Death;113552;6.4;36;24;12;66;7.2;12;9;3;75;2.9;2125;39
260;Star Wars;76759;8.2;64;60;4;93;7.4;17;15;2;88;4.1;147448;93
261;Little Women;110367;0;0;0;0;0;0;0;0;0;0;0;0;0
262;A Little Princess;113670;8.4;20;19;1;95;0;3;3;0;100;3.4;13643;81
263;Ladybird Ladybird;110296;7.2;6;4;2;66;0;2;2;0;100;4;368;87
264;L'enfer;109731;7.9;8;8;0;100;0;1;1;0;100;3.5;421;67
265;Como agua para chocolate;103994;7.6;28;25;3;89;0;3;3;0;100;3.9;5713;86
266;Legends of the Fall;110322;0;0;0;0;0;0;0;0;0;0;0;0;0
267;Major Payne;110443;4.6;10;3;7;30;0;2;1;1;50;2.9;8555;69
268;Little Odessa;110365;5.8;17;11;6;64;0;3;1;2;33;3.5;985;69
269;Mi vida loca;107566;6.6;15;12;3;80;0;3;2;1;66;3.9;2251;81
270;Love Affair;110391;4.8;26;8;18;30;0;3;1;2;33;3.5;1260;71
271;Losing Isaiah;113691;5.1;28;12;16;42;5;9;4;5;44;3.6;2364;76
272;The Madness of King George;110428;7.8;42;39;3;92;8.1;10;10;0;100;3.6;1886;76
273;Frankenstein;21884;8.5;38;38;0;100;7.8;5;5;0;100;3.6;7211;81
274;Man of the House;331933;3.3;60;5;55;8;3.9;16;4;12;25;3.1;10877;59
275;Mixed Nuts;110538;2.8;28;2;26;7;2.5;6;0;6;0;2.9;2410;46
276;Milk Money;110516;2.6;25;1;24;4;2.5;8;0;8;0;2.7;2126;40
277;Miracle on 34th Street;39628;8;31;29;2;93;0;2;2;0;100;3.5;5409;81
278;Miami Rhapsody;113808;6.1;18;8;10;44;0;3;2;1;66;2.6;766;28
279;My Family;113896;7.2;11;9;2;81;0;3;3;0;100;3.9;1137;85
280;Murder in the First;113870;5.5;34;17;17;50;4.8;10;4;6;40;3.5;3888;78
281;Nobody's Fool;91642;0;4;0;4;0;0;1;0;1;0;3;289;43
282;Nell;110638;5;31;16;15;51;0;3;3;0;100;3.1;5373;63
283;New Jersey Drive;113967;6.5;7;4;3;57;0;3;2;1;66;3.8;814;81
284;Nyû Yôku no koppu;117169;0;0;0;0;0;0;0;0;0;0;0;0;0
285;Beyond Bedlam;106402;0;1;0;1;0;0;0;0;0;0;0;0;0
286;Nemesis 2: Nebula;113948;0;0;0;0;0;0;0;0;0;0;0;0;0
287;Nina Takes a Lover;110671;5.2;6;3;3;50;0;2;0;2;0;3.4;125;52
288;Natural Born Killers;110632;6;29;15;14;51;5.9;7;3;4;42;3.5;39062;80
289;Only You;110737;5.5;22;11;11;50;0;3;1;2;33;3.3;4388;69
290;Once Were Warriors;110729;7.7;31;29;2;93;7.4;8;7;1;87;0;0;0
291;Poison Ivy II;114151;3.8;6;1;5;16;0;0;0;0;0;0;0;0
292;Outbreak;114069;5.6;41;24;17;58;5.1;10;4;6;40;3.1;10732;55
293;Léon;110413;6.8;39;30;9;76;5.8;8;4;4;50;4.1;59011;94
294;The Perez Family;114113;6.3;15;10;5;66;5.9;5;2;3;40;3.2;500;50
295;A Pyromaniac's Love Story;114210;3.4;9;0;9;0;0;2;0;2;0;3.1;773;44
296;Pulp Fiction;110912;8.9;50;47;3;94;8.4;14;13;1;92;4.2;249269;95
297;The Pink Panther 2;838232;3.5;128;16;112;12;3.9;25;4;21;16;3.1;77879;48
298;Tui shou;105652;0;2;2;0;100;0;0;0;0;0;0;0;0
299;Priest;110889;7.2;19;13;6;68;0;4;3;1;75;3.8;1042;81
300;Quiz Show;110932;8.1;50;48;2;96;8.2;12;12;0;100;3.5;5428;79
301;Picture Bride;114129;6.8;10;8;2;80;0;3;3;0;100;3.7;324;77
302;La reine Margot;110963;5.9;22;17;5;77;0;2;1;1;50;4;2511;86
303;The Quick and the Dead;114214;5.9;39;22;17;56;4.2;8;1;7;12;3.1;12178;56
304;Roommates;114296;5.1;13;4;9;30;0;2;0;2;0;3.2;387;51
305;Prêt-à-Porter;110907;4.8;21;6;15;28;4.3;5;0;5;0;2.5;1885;26
306;Trois couleurs: Rouge;111495;8.5;40;40;0;100;8.2;10;10;0;100;4.2;9557;94
307;Trois couleurs: Bleu;108394;8.4;32;32;0;100;8;5;5;0;100;4.2;11731;93
308;Trzy kolory: Bialy;111507;7.5;31;28;3;90;7.6;9;9;0;100;3.9;5105;86
309;Pao Da Shuang Deng;110769;0;4;3;1;75;0;1;0;1;0;4.6;71;100
310;Rent-a-Kid;114268;0;0;0;0;0;0;0;0;0;0;0;0;0
312;Stuart Saves His Family;114571;4.6;25;7;18;28;5.2;10;3;7;30;2.6;531;44
313;The Swan Princess;111333;5.3;9;4;5;44;0;3;2;1;66;3.1;5951;66
314;The Secret of Roan Inish;111112;7.8;40;39;1;97;7.5;12;11;1;91;3.9;1439;86
315;The Specialist;111255;3.1;24;1;23;4;3.8;5;0;5;0;2.5;5147;34
316;Stargate;111282;5.2;37;17;20;45;0;4;1;3;25;3.3;23611;75
317;Santa Claus;89961;4.1;17;3;14;17;0;1;0;1;0;3.1;2513;66
318;The Shawshank Redemption;111161;8;57;50;7;87;7.9;11;10;1;90;4.4;168839;98
319;Shallow Grave;111149;6.4;42;30;12;71;5.4;10;5;5;50;3.6;9041;81
320;Suture;108260;6.2;11;7;4;63;0;3;0;3;0;3.6;236;74
321;Fresa y chocolate;106966;6.6;19;15;4;78;0;2;2;0;100;3.9;848;83
322;Swimming with Sharks;114594;6.3;33;25;8;75;5.4;10;5;5;50;3.6;2888;78
324;The Sum of Us;111309;6.5;13;9;4;69;0;2;1;1;50;3.6;1056;74
325;Senior Trip;113936;2.6;7;0;7;0;0;1;0;1;0;3;1370;53
326;Huozhe;110081;8.1;14;12;2;85;0;3;3;0;100;4.3;1836;95
327;Tank Girl;114614;4.9;33;14;19;42;5.3;9;4;5;44;2.8;7013;61
328;Tales from the Crypt: Demon Knight;114608;4;23;7;16;30;3.4;7;1;6;14;3.2;4989;63
329;Star Trek: Generations;111280;5.5;44;20;24;45;6.4;9;6;3;66;3.3;15342;62
330;Tales from the Hood;114609;4.3;15;5;10;33;0;2;1;1;50;3.1;2119;58
331;Tom & Viv;111454;4.8;11;4;7;36;0;2;1;1;50;3.4;351;59
332;Village of the Damned;114852;4;30;9;21;30;4.2;5;2;3;40;2.7;4194;36
333;Tommy Boy;114694;5.2;38;17;21;44;3.6;6;1;5;16;3.6;34476;89
334;Vanya on 42nd Street;111590;7.6;32;28;4;87;7.7;9;8;1;88;3.7;466;73
335;Underneath;114788;5.7;19;10;9;52;5.8;8;3;5;37;3;405;36
336;Incubo sulla città contaminata;80931;0;4;2;2;50;0;0;0;0;0;0;0;0
337;What's Eating Gilbert Grape;108550;7.3;42;37;5;88;5.8;9;6;3;66;3.7;57512;86
338;Virtuosity;114857;4.3;29;10;19;34;4;8;2;6;25;2.8;4167;37
339;While You Were Sleeping;114924;6.5;41;35;6;85;6.5;13;11;2;84;3.2;25923;75
340;War;499556;0;0;0;0;0;0;0;0;0;0;0;0;0
341;Double Happiness;109655;7;10;7;3;70;0;2;2;0;100;3.4;627;61
342;Muriel's Wedding;110598;7.1;32;29;3;90;0;4;4;0;100;3.4;8356;78
343;The Baby-Sitters Club;112435;6;15;9;6;60;6.1;7;3;4;42;2.9;1930;46
344;Ace Ventura: Pet Detective;109040;4.6;37;18;19;48;0;2;0;2;0;3.1;163811;57
345;The Adventures of Priscilla, Queen of the Desert;109045;7;29;27;2;93;7;6;5;1;83;3.7;8695;84
346;Backbeat;106339;6.2;34;25;9;73;6.5;9;6;3;66;3.3;926;67
347;Bitter Moon;104779;6.2;29;19;10;65;4.7;8;3;5;37;3.8;3436;79
348;Bullets Over Broadway;109348;7.9;54;52;2;96;8.2;12;12;0;100;3.6;3913;79
349;Clear and Present Danger;109444;6.8;37;29;8;78;7.1;9;7;2;77;3.3;11095;69
350;The Client;109446;6.1;35;28;7;80;6.2;7;5;2;71;3.3;7408;67
351;Corrina, Corrina;109484;5.2;16;6;10;37;0;3;0;3;0;3.1;4265;65
352;Crooklyn;109504;6.6;24;18;6;75;6.8;7;6;1;85;4.1;3115;87
353;The Crow;109506;7;40;33;7;82;6.9;8;6;2;75;3.8;64467;87
354;Cobb;109450;6.2;32;21;11;65;5.2;8;4;4;50;3.2;875;57
355;The Flintstones;109813;3.7;40;8;32;20;4.5;7;2;5;28;2.5;11823;35
356;Forrest Gump;109830;6.9;53;37;16;69;7;13;9;4;69;4.1;205253;93
357;Four Weddings and a Funeral;109831;7.5;49;47;2;95;7.3;9;8;1;88;3.2;21524;68
358;Higher Learning;113305;5.3;34;17;17;50;4.6;11;4;7;36;3.5;4026;77
359;I Like It Like That;110091;7.4;9;7;2;77;0;3;3;0;100;4;625;85
360;I Love Trouble;110093;\N;\N;\N;\N;\N;\N;\N;\N;\N;\N;\N;\N;\N
361;It Could Happen to You;110167;6.2;34;23;11;67;6.2;8;6;2;75;3;6180;53
362;The Jungle Book;61852;7.3;27;24;3;88;0;2;1;1;50;3.5;35715;70
363;Die Macht der Bilder: Leni Riefenstahl;107472;7.6;22;21;1;95;0;4;3;1;75;3.7;257;81
364;The Lion King;110357;8;61;56;5;91;7.8;13;13;0;100;3.9;127550;89
365;Little Buddha;107426;5.8;22;14;8;63;6.4;7;4;3;57;3.1;2898;50
366;New Nightmare;111686;6.6;31;25;6;80;6.3;9;7;2;77;3.2;11902;65
367;The Mask;110475;6.4;44;33;11;75;6.1;9;5;4;55;3.2;68419;66
368;Maverick;110478;6;37;26;11;70;7.4;6;6;0;100;3.2;11507;68
369;Mrs. Parker and the Vicious Circle;110588;6.3;24;17;7;70;0;3;2;1;66;3.5;634;62
370;Naked Gun 33 1/3: The Final Insult;110622;5.6;32;17;15;53;7;7;6;1;85;2.9;10482;59
371;The Paper;110771;6.7;31;27;4;87;6.9;7;6;1;85;3.1;1357;54
372;Reality Bites;110950;6;42;27;15;64;6.1;9;5;4;55;3.3;10533;74
373;Red Rock West;105226;7.5;37;35;2;94;7.2;8;7;1;87;0;0;0
374;Ri¢hie Ri¢h;110989;4.2;20;5;15;25;4.8;5;2;3;40;2.5;10242;38
375;Safe Passage;111054;5.8;12;6;6;50;0;3;1;2;33;3.4;310;59
376;The River Wild;110997;5.8;27;15;12;55;5.8;6;3;3;50;2.9;5610;50
377;Speed;111257;7.6;41;37;4;90;7.1;9;7;2;77;3.3;51008;72
378;Speechless;111256;3.9;25;3;22;12;3.8;6;0;6;0;2.8;683;34
379;Timecop;111438;5.3;38;18;20;47;5.1;9;4;5;44;2.6;6534;38
380;True Lies;111503;6.4;45;31;14;68;5.4;9;5;4;55;3.2;27905;70
381;When a Man Loves a Woman;111693;6.5;19;13;6;68;0;3;2;1;66;3.3;6791;76
382;Wolf;111742;5.9;48;29;19;60;5.9;8;5;3;62;2.8;6634;43
383;Wyatt Earp;111756;5.3;26;11;15;42;0;3;0;3;0;3.2;8070;63
384;Bad Company;280486;3.9;134;14;120;10;4;31;5;26;16;2.8;6415;42
385;A Man of No Importance;110455;7;12;10;2;83;0;3;2;1;66;3.6;111;62
386;S.F.W.;111048;3.2;16;2;14;12;0;2;0;2;0;3;1184;49
387;A Low Down Dirty Shame;110399;3.6;20;0;20;0;3.5;6;0;6;0;2.9;3460;58
388;This Boy's Life;108330;6.3;34;26;8;76;5;10;4;6;40;3.5;5072;76
389;Le colonel Chabert;109454;7.1;6;5;1;83;0;1;1;0;100;3.6;142;59
390;Faster, Pussycat! Kill! Kill!;59170;6.9;25;18;7;72;0;3;2;1;66;3.8;3351;77
391;Jason's Lyric;110186;6;14;10;4;71;0;3;2;1;66;4;2470;87
392;The Secret Adventures of Tom Thumb;108069;6.3;5;4;1;80;0;0;0;0;0;0;0;0
393;Street Fighter;111301;2.9;24;3;21;12;0;4;0;4;0;2.2;10305;25
394;In Cold Blood;61809;8.3;25;22;3;88;7.8;5;4;1;80;3.8;2614;83
395;Desert Winds;112849;4.3;9;2;7;22;4.5;6;2;4;33;4;36;100
396;Fall Time;113014;0;3;0;3;0;0;0;0;0;0;0;0;0
397;Cape Fear;101540;6.9;38;29;9;76;8.3;6;6;0;100;3.4;13943;74
398;Frank and Ollie;113104;7.3;8;7;1;87;0;1;1;0;100;3.9;177;83
401;Mirage;59448;0;3;2;1;66;0;0;0;0;0;0;0;0
402;Open Season;400717;5.4;98;46;52;46;5.7;24;13;11;54;3.4;91895;66
404;Brother Minister: The Assassination of Malcolm X;109339;0;1;1;0;100;0;1;1;0;100;4.2;76;90
405;Highlander III: The Sorcerer;110027;0;0;0;0;0;0;0;0;0;0;0;0;0
406;Federal Hill;109785;6.4;15;12;3;80;6.2;9;6;3;66;3;131;41
407;In the Mouth of Madness;113409;5;29;14;15;48;4.6;7;2;5;28;3.5;5731;73
408;8 Seconds;109021;5.2;12;4;8;33;0;2;0;2;0;3.6;7861;89
409;Above the Rim;109035;5.4;18;10;8;55;5;6;3;3;50;3.5;4319;84
410;Addams Family Values;106220;6.3;35;26;9;74;5.5;7;4;3;57;3.1;21548;57
412;The Age of Innocence;106226;\N;\N;\N;\N;\N;\N;\N;\N;\N;\N;\N;\N;\N
413;Airheads;109068;4.2;31;7;24;22;4.6;8;3;5;37;2.9;13551;51
414;The Air Up There;109067;4;26;6;20;23;3;6;0;6;0;2.6;2385;33
415;Another Stakeout;106292;3.9;21;3;18;14;0;3;1;2;33;2.5;1861;31
416;Bad Girls;109198;3.5;21;2;19;9;0;4;0;4;0;2.8;5946;49
417;Vicky Cristina Barcelona;497465;6.9;188;154;34;81;7.2;35;29;6;82;3.6;45494;73
418;Being Human;1349938;\N;\N;\N;\N;\N;\N;\N;\N;\N;\N;\N;\N;\N
419;The Beverly Hillbillies;106400;3.6;28;7;21;25;4.2;8;3;5;37;2.5;4897;40
420;Beverly Hills Cop III;109254;3.3;30;3;27;10;2.9;6;0;6;0;2.9;12777;50
421;Black Beauty;109279;0;0;0;0;0;0;0;0;0;0;0;0;0
423;Blown Away;109303;4.8;18;5;13;27;0;3;0;3;0;2.9;3591;46
424;Blue Chips;109305;5.1;26;10;16;38;4.6;8;3;5;37;3;1545;50
425;Blue Sky;109306;6.3;18;13;5;72;0;3;2;1;66;3.2;809;52
426;Invasion of the Body Snatchers;49366;8.9;36;36;0;100;0;2;2;0;100;3.6;3820;81
427;Boxing Helena;106471;3.7;30;6;24;20;3.4;7;1;6;14;2.6;1775;39
428;A Bronx Tale;106489;7.4;26;25;1;96;0;3;3;0;100;3.9;17840;89
429;Cabin Boy;109361;4.9;23;10;13;43;0;2;0;2;0;2.4;1694;36
430;Calendar Girls;337909;6.5;118;87;31;73;6.5;33;23;10;69;3.1;8453;59
431;Carlito's Way;106519;6.8;33;27;6;81;0;4;2;2;50;3.8;32475;88
432;City Slickers II: The Legend of Curly's Gold;109439;3.6;21;4;17;19;0;3;0;3;0;2.7;5885;34
433;Clean Slate;109443;4.1;16;3;13;18;0;2;0;2;0;2.5;630;33
434;Cliffhanger;106582;6.3;33;27;6;81;6.2;7;5;2;71;2.8;9768;47
435;Coneheads;106598;4.5;27;9;18;33;4.7;8;3;5;37;2.6;9202;37
436;Color of Night;109456;3.9;26;8;18;30;0;3;0;3;0;2.7;3955;40
437;Cops and Robbersons;109480;3.5;19;3;16;15;2.6;6;0;6;0;2.5;1201;26
438;The Cowboy Way;109493;4.2;12;2;10;16;0;2;0;2;0;3;2782;61
440;Dave;106673;7.4;37;36;1;97;7.5;9;9;0;100;3.1;4985;63
441;Dazed and Confused;106677;7.9;41;40;1;97;7.6;7;6;1;85;3.8;45956;89
442;Demolition Man;106697;5.6;32;20;12;62;4.2;8;3;5;37;3;16135;60
443;The Endless Summer 2;109729;5.8;14;8;6;57;5;5;2;3;40;4;802;89
444;Even Cowgirls Get the Blues;106834;3.2;17;4;13;23;0;3;0;3;0;2.6;1583;31
445;Fatal Instinct;106873;4.2;20;4;16;20;3.6;8;1;7;12;2.6;808;36
446;Ba wang bie ji;106332;7.4;33;29;4;87;7.2;10;8;2;80;4.1;4321;91
447;The Favor;109783;4.9;10;3;7;30;0;3;0;3;0;2.8;891;23
448;Huo Yuan Jia;446059;0;0;0;0;0;0;0;0;0;0;0;0;0
449;Fear of a Black Hat;106880;7;19;16;3;84;7.2;8;8;0;100;3.8;898;81
450;With Honors;111732;4;21;4;17;19;0;3;0;3;0;3.3;3484;72
451;Flesh and Bone;106926;6.1;23;16;7;69;0;3;1;2;33;3;851;40
452;Widows' Peak;111712;7.1;15;15;0;100;0;3;3;0;100;3.2;348;46
453;For Love or Money;106941;\N;\N;\N;\N;\N;\N;\N;\N;\N;\N;\N;\N;\N
454;The Firm;106918;6.2;50;38;12;76;5;9;4;5;44;3.2;11507;61
455;Free Willy;106965;5.5;21;11;10;52;0;3;2;1;66;2.9;19451;48
456;Fresh;109842;7.5;19;17;2;89;0;3;3;0;100;4;1823;90
457;The Fugitive;106977;7.6;52;49;3;94;8;9;9;0;100;3.6;28862;82
458;Geronimo: An American Legend;107004;6.2;17;9;8;52;0;3;1;2;33;3.2;1686;53
459;A Perfect Getaway;971209;5.8;124;76;48;61;5.9;29;18;11;62;3.2;102622;50
460;Getting Even with Dad;109891;3.3;12;1;11;8;0;3;0;3;0;2.4;2200;29
461;Go Fish;109913;6.6;13;10;3;76;7.4;5;4;1;80;3.2;898;54
462;A Good Man in Africa;109920;4.4;8;1;7;12;0;2;0;2;0;2.9;306;34
463;Guilty as Sin;107057;5.2;13;5;8;38;0;3;2;1;66;2.8;474;30
464;Hard Target;107076;5.2;29;14;15;48;5.6;7;4;3;57;0;0;0
465;Heaven & Earth;107096;5.2;17;8;9;47;5.8;5;2;3;40;3.6;1458;71
466;Hot Shots! Part Deux;107144;5.6;28;17;11;60;5.8;6;3;3;50;3;9890;61
467;Live Nude Girls;113674;4.4;8;3;5;37;0;1;1;0;100;3.2;368;46
468;The Englishman Who Went Up a Hill But Came Down a Mountain;112966;5.8;22;13;9;59;7;5;4;1;80;3;3033;50
469;The House of the Spirits;107151;5.4;14;6;8;42;0;3;1;2;33;3.7;3169;74
470;House Party 3;110064;2.7;6;0;6;0;0;0;0;0;0;0;0;0
471;The Hudsucker Proxy;110074;6.2;38;22;16;57;4.1;9;2;7;22;3.6;10291;80
472;I'll Do Anything;110097;5.2;17;10;7;58;0;3;3;0;100;3;481;40
473;In the Army Now;110123;2.2;21;0;21;0;2.5;5;0;5;0;2.5;3672;47
474;In the Line of Fire;107206;7.6;41;39;2;95;8.3;7;6;1;85;3.4;7831;72
475;In the Name of the Father;107207;7.6;39;37;2;94;7.4;9;8;1;88;4;10715;92
476;The Inkwell;110137;5;7;2;5;28;0;2;1;1;50;3.8;507;78
477;What's Love Got to Do with It;108551;7.5;33;32;1;96;8.2;7;7;0;100;3.6;9612;83
478;Jimmy Hollywood;110197;4.1;20;3;17;15;0;3;0;3;0;2.5;544;24
479;Judgment Night;107286;4.2;15;4;11;26;3.2;5;1;4;20;3.1;2059;53
480;Jurassic Park;107290;7.2;38;33;5;86;7.1;10;9;1;90;3.6;91260;81
481;Kalifornia;107302;6.2;24;16;8;66;0;2;1;1;50;3.2;9852;63
482;Killing Zoe;110265;5.1;25;10;15;40;0;2;0;2;0;3.4;3407;65
483;King of the Hill;107322;7.9;25;24;1;96;7.8;7;6;1;85;3.6;963;77
484;Lassie;110305;6.8;8;6;2;75;0;2;2;0;100;2.9;2576;52
485;Last Action Hero;107362;4.9;37;14;23;37;4.6;5;1;4;20;2.6;11445;43
486;Life with Mikey;107413;3.9;9;2;7;22;0;2;0;2;0;2.8;1377;39
487;Lightning Jack;110353;3.4;16;1;15;6;3.9;6;1;5;16;2.8;2199;43
488;M. Butterfly;107468;0;0;0;0;0;0;0;0;0;0;0;0;0
489;Made in America;107478;3.9;28;8;20;28;0;3;1;2;33;2.5;4179;38
490;Malice;107497;5.8;18;10;8;55;0;3;0;3;0;3;2429;42
491;The Man Without a Face;107501;5.7;20;12;8;60;0;3;2;1;66;3.1;5277;63
492;Manhattan Murder Mystery;107507;6.9;21;19;2;90;0;3;3;0;100;3.7;4405;81
493;Menace II Society;107554;7.4;34;29;5;85;8;8;7;1;87;3.8;14420;88
494;Executive Decision;116253;6;37;24;13;64;6.3;10;6;4;60;2.9;5176;51
495;Ai no korîda;74102;7.5;28;23;5;82;0;1;1;0;100;3.5;1565;67
496;What Happened Was...;111689;7;20;18;2;90;0;4;3;1;75;4.1;120;84
497;Much Ado About Nothing;107616;7.1;41;37;4;90;6.8;8;6;2;75;3.6;9764;82
498;Mr. Jones;107611;5.2;13;6;7;46;0;2;1;1;50;3;1067;45
499;Mr. Wonderful;107613;5.9;18;10;8;55;6.1;5;3;2;60;3.1;870;46
500;Mrs. Doubtfire;107614;5.7;42;27;15;64;0;2;1;1;50;3.4;61130;73
501;Naked;107653;8;21;19;2;90;0;2;2;0;100;4.3;3386;92
502;The Next Karate Kid;110657;3.6;17;1;16;5;0;4;0;4;0;0;0;0
503;The New Age;110649;6;11;7;4;63;0;3;2;1;66;3.1;82;40
504;No Escape;110678;5.1;15;8;7;53;0;3;0;3;0;3;2147;43
505;North;110687;3;18;2;16;11;0;3;0;3;0;2.6;2932;32
506;Orlando;107756;6.2;26;21;5;80;0;2;1;1;50;3.9;2705;81
507;A Perfect World;107808;7.2;27;22;5;81;7.4;5;4;1;80;3.5;7814;77
508;Philadelphia;107818;6.5;43;32;11;74;6.7;5;4;1;80;3.7;20896;87
509;The Piano;107822;8;45;40;5;88;9.3;7;7;0;100;3.7;12303;86
510;Poetic Justice;107840;4.6;14;5;9;35;0;3;1;2;33;3.4;5709;83
511;The Program;107889;5;14;5;9;35;0;3;1;2;33;3.6;2842;77
512;The Puppet Masters;111003;4.9;22;6;16;27;4;5;0;5;0;2.8;1068;38
513;Radioland Murders;110939;4;15;3;12;20;0;2;0;2;0;3.1;601;52
514;The Ref;110955;6.6;41;32;9;78;5.6;8;4;4;50;3.3;3390;73
515;The Remains of the Day;107943;8.4;38;37;1;97;8.3;8;7;1;87;3.8;6319;86
516;Renaissance Man;110971;4.4;18;3;15;16;0;3;0;3;0;2.9;2575;54
517;Rising Sun;107969;5.1;35;12;23;34;5.2;11;4;7;36;2.9;4796;47
518;The Road to Wellville;111001;4.9;16;7;9;43;0;2;1;1;50;2.8;1442;39
519;RoboCop 3;107978;3.1;28;1;27;3;3;6;0;6;0;2.3;6600;21
520;Robin Hood: Men in Tights;107977;5.1;22;10;12;45;0;1;0;1;0;3.5;45946;79
521;Romeo Is Bleeding;107983;4.5;34;8;26;23;3.6;9;0;9;0;3.3;1704;62
522;Romper Stomper;105275;6.2;24;19;5;79;0;4;1;3;25;3.5;11581;72
523;Ruby in Paradise;108000;7.8;15;14;1;93;0;2;2;0;100;3.8;186;77
524;Rudy;108002;6.8;34;27;7;79;6.7;8;6;2;75;3.7;21916;88
525;The Saint of Fort Washington;108026;6.5;9;6;3;66;0;3;2;1;66;3.9;305;84
526;Les nuits fauves;105032;0;0;0;0;0;0;0;0;0;0;0;0;0
527;Schindler's List;108052;8.8;59;57;2;96;8.4;10;10;0;100;4.3;83125;96
528;The Last Boy Scout;102266;5.1;30;13;17;43;0;4;2;2;50;3.3;11177;66
529;Searching for Bobby Fischer;108065;8.1;33;33;0;100;8.4;8;8;0;100;3.5;3580;81
530;Second Best;328390;5;16;6;10;37;4.5;8;2;6;25;3;174;37
531;The Secret Garden;108071;8.1;17;16;1;94;0;3;2;1;66;3.3;14794;72
532;Serial Mom;111127;5.8;44;27;17;61;4;8;1;7;12;3;6394;62
533;Kagemusha;80979;7.5;19;16;3;84;0;2;1;1;50;4.2;4005;91
534;Shadowlands;108101;8;28;27;1;96;8.8;6;6;0;100;3.9;3260;85
535;Short Cuts;108122;7.8;51;48;3;94;8.1;8;7;1;87;3.9;5867;87
536;A Simple Twist of Fate;111194;5.5;19;9;10;47;0;2;0;2;0;3.1;1672;52
537;Sairen;494815;0;0;0;0;0;0;0;0;0;0;0;0;0
538;Six Degrees of Separation;108149;7.1;30;27;3;90;0;3;1;2;33;3.3;3720;67
539;Sleepless in Seattle;108160;6.5;43;31;12;72;5.6;10;6;4;60;3.3;36965;75
540;Sliver;108162;3.6;24;3;21;12;0;2;0;2;0;2.5;2511;34
541;Blade Runner;83658;0;0;0;0;0;0;0;0;0;0;0;0;0
542;Son in Law;108186;3.8;17;4;13;23;0;3;0;3;0;2.9;5679;62
543;So I Married an Axe Murderer;108174;5.3;30;15;15;50;5;8;3;5;37;3;11154;66
544;Striking Distance;108238;3.6;19;3;16;15;0;2;0;2;0;2.8;4532;39
545;Harem suaré;179841;0;1;1;0;100;0;0;0;0;0;0;0;0
546;Super Mario Bros.;108255;\N;\N;\N;\N;\N;\N;\N;\N;\N;\N;\N;\N;\N
547;Surviving the Game;111323;4.3;13;3;10;23;0;1;0;1;0;3;1673;48
548;Terminal Velocity;111400;3.6;20;3;17;15;0;3;0;3;0;2.6;1883;25
549;Thirty Two Short Films About Glenn Gould;108328;8;17;15;2;88;0;3;3;0;100;3.8;1129;79
550;Threesome;111418;4.4;23;6;17;26;4.1;6;1;5;16;3;1708;52
551;The Nightmare Before Christmas;107688;8.2;70;68;2;97;8.2;17;17;0;100;3.8;124838;89
552;The Three Musketeers;108333;4.8;24;7;17;29;0;3;0;3;0;3.2;13783;67
553;Tombstone;108358;6.4;39;30;9;76;0;3;0;3;0;3.8;31660;93
554;Law & Order: Trial by Jury;406429;\N;\N;\N;\N;\N;\N;\N;\N;\N;\N;\N;\N;\N
555;True Romance;108399;7.5;44;40;4;90;6.2;9;7;2;77;3.9;43205;90
556;Dr. Strangelove or: How I Learned to Stop Worrying and Love the Bomb;57012;9;58;58;0;100;8.6;8;8;0;100;4.2;33662;94
558;The Pagemaster;110763;4.6;15;3;12;20;5;6;2;4;33;2.8;7531;49
559;2 Days in Paris;841044;6.8;113;96;17;84;6.9;34;30;4;88;3.6;27100;71
560;The Beans of Egypt, Maine;109226;0;3;1;2;33;0;0;0;0;0;0;0;0
561;Killer Movie;988083;0;1;0;1;0;0;0;0;0;0;0;0;0
562;Welcome to the Dollhouse;114906;7.9;46;41;5;89;8.1;7;6;1;85;3.7;6911;84
563;Germinal;107002;6.9;10;9;1;90;0;2;2;0;100;3.7;511;71
564;Chugyeogja;1190539;6.7;27;22;5;81;6.8;5;4;1;80;4;1927;88
565;Cronos;104029;7.3;35;31;4;88;7.8;7;6;1;85;3.5;3398;68
566;Naked in New York;110623;6.1;11;6;5;54;0;3;1;2;33;2.9;444;34
567;Kika;107315;5.7;13;8;5;61;5.1;5;2;3;40;0;0;0
568;Bhaji on the Beach;106408;7.4;8;7;1;87;0;2;2;0;100;3.3;372;60
569;Little Big League;110363;5.2;15;5;10;33;0;3;2;1;66;2.9;2288;50
570;Kådisbellan;107349;6.9;9;8;1;88;0;1;1;0;100;3.5;76;59
571;Wide-Eyed and Legless;111709;6;5;2;3;40;0;2;1;1;50;0;0;0
572;Foreign Student;109828;0;3;1;2;33;0;0;0;0;0;0;0;0
573;Io speriamo che me la cavo;107225;6.2;7;4;3;57;0;2;1;1;50;3.6;412;71
574;Spanking the Monkey;111252;7.2;21;19;2;90;0;2;2;0;100;3.1;824;52
575;The Little Rascals;110366;3.8;10;2;8;20;0;0;0;0;0;0;0;0
577;Andre;109120;5.3;16;7;9;43;0;2;0;2;0;2.7;2286;52
579;La scorta;108059;5.9;7;4;3;57;0;3;0;3;0;3.3;52;59
580;Princess Caraboo;110892;5.7;14;8;6;57;0;3;0;3;0;3;723;43
581;The Celluloid Closet;112651;7.8;24;23;1;95;8.6;5;5;0;100;3.9;1222;87
582;Métisse;107642;5.9;6;4;2;66;0;2;1;1;50;0;0;0
583;Caro diario;109382;6.7;9;6;3;66;0;2;0;2;0;4.1;936;86
585;The Brady Bunch Movie;112572;5.7;38;23;15;60;6.4;11;7;4;63;2.4;3906;38
586;Home Alone;99785;5;30;14;16;46;0;2;0;2;0;3.3;66201;74
587;Ghost;99653;6.8;42;34;8;80;0;4;4;0;100;3.5;62365;79
588;Aladdin;103639;\N;\N;\N;\N;\N;\N;\N;\N;\N;\N;\N;\N;\N
589;Terminator 2: Judgment Day;103064;8.4;42;41;1;97;7.4;11;10;1;90;3.7;77100;88
590;Dances with Wolves;99348;7;46;35;11;76;6.9;10;7;3;70;3.6;28000;84
591;Tough and Deadly;114706;\N;\N;\N;\N;\N;\N;\N;\N;\N;\N;\N;\N;\N
592;Batman;60153;6.2;22;18;4;81;0;1;1;0;100;3;13951;51
593;The Silence of the Lambs;102926;8.5;52;50;2;96;7.8;11;10;1;90;4;98921;93
594;Snow White and the Seven Dwarfs;29583;0;0;0;0;0;0;0;0;0;0;0;0;0
595;Beauty and the Beast;101414;8;57;52;5;91;7.8;18;17;1;94;3.7;81050;85
596;Pinocchio;32910;9;37;37;0;100;8.5;5;5;0;100;3.3;19102;66
597;Pretty Woman;100405;5.7;55;34;21;61;5.9;9;6;3;66;3.5;200724;68
598;Okno v Parizh;110719;5.4;7;3;4;42;0;1;0;1;0;3.9;42;88
599;The Wild Bunch;65214;8.8;38;37;1;97;8.2;7;6;1;85;4;8004;90
600;Love and a .45;110395;6.2;6;5;1;83;0;0;0;0;0;0;0;0
602;A Great Day in Harlem;109934;7.5;18;16;2;88;7.1;7;6;1;85;3.9;85;82
603;Bye Bye Love;112606;4.2;21;4;17;19;0;3;1;2;33;2.9;1015;49
605;One Fine Day;117247;5.7;29;13;16;44;5.8;6;1;5;16;3.1;7990;63
606;Candyman: Farewell to the Flesh;112625;4.9;10;4;6;40;0;1;0;1;0;2.7;4578;44
608;Fargo;116282;8.4;66;62;4;93;7.6;21;18;3;85;3.9;48610;91
609;Homeward Bound II: Lost in San Francisco;116552;5.7;16;9;7;56;6.4;7;5;2;71;2.9;5368;53
610;Heavy Metal;82509;5.7;25;15;10;60;5.4;5;3;2;60;3.3;6386;69
611;Hellraiser: Bloodline;116514;3.5;10;3;7;30;0;1;0;1;0;2.9;4846;52
612;The Pallbearer;117283;5;18;7;11;38;0;4;2;2;50;2.3;1285;14
613;Jane Eyre;780362;\N;\N;\N;\N;\N;\N;\N;\N;\N;\N;\N;\N;\N
614;Loaded;893406;0;0;0;0;0;0;0;0;0;0;0;0;0
615;Pane e cioccolata;70506;0;4;4;0;100;0;0;0;0;0;0;0;0
616;The AristoCats;65421;6.1;26;17;9;65;0;4;3;1;75;3.3;23247;71
617;La flor de mi secreto;113083;7;23;19;4;82;6.6;11;8;3;72;3.7;1997;75
618;Two Much;118001;3.6;7;1;6;14;0;3;0;3;0;2.7;947;33
619;Ed;247091;\N;\N;\N;\N;\N;\N;\N;\N;\N;\N;\N;\N;\N
620;Cerro Torre: Schrei aus Stein;102855;0;0;0;0;0;0;0;0;0;0;0;0;0
621;Ma saison préférée;107471;7.3;12;11;1;91;0;3;3;0;100;0;0;0
623;A Modern Affair;113839;0;2;0;2;0;0;1;0;1;0;3.2;63;38
624;Condition Red;112712;\N;\N;\N;\N;\N;\N;\N;\N;\N;\N;\N;\N;\N
625;Asfour Stah;90665;0;0;0;0;0;0;0;0;0;0;0;0;0
626;A Thin Line Between Love and Hate;117891;3.5;24;3;21;12;3.2;7;0;7;0;3.5;3360;73
627;The Last Supper;113613;0;0;0;0;0;0;0;0;0;0;0;0;0
628;Primal Fear;117381;6.7;41;30;11;73;7.3;6;4;2;66;3.7;15640;85
629;Rude Boy;81441;0;0;0;0;0;0;0;0;0;0;0;0;0
630;Carried Away;115837;6;22;14;8;63;5.4;6;3;3;50;3.3;256;51
631;All Dogs Go to Heaven 2;115509;0;3;0;3;0;0;1;0;1;0;2.8;10564;48
632;Land and Freedom;114671;7.8;10;8;2;80;0;2;2;0;100;4.3;1552;93
633;Denise Calls Up;112844;6.4;22;17;5;77;6.9;9;7;2;77;3.4;47;67
634;Theodore Rex;114658;0;4;0;4;0;0;0;0;0;0;0;0;0
635;A Family Thing;116275;6.3;22;16;6;72;6.8;6;5;1;83;3.4;546;61
636;Nina Frisk;827729;0;0;0;0;0;0;0;0;0;0;0;0;0
637;Sgt. Bilko;117608;4.4;36;12;24;33;5.4;10;6;4;60;2.6;3074;46
638;Jack & Sarah;113448;6;11;9;2;81;0;2;1;1;50;3.6;1366;74
639;Girl 6;116414;4.6;32;11;21;34;4;11;1;10;9;0;0;0
640;Diabolique;116095;3.8;25;3;22;12;4;6;0;6;0;2.7;1450;35
641;Un indien dans la ville;111543;3.2;8;1;7;12;0;4;0;4;0;2.8;552;34
643;Peanuts - Die Bank zahlt alles;117312;\N;\N;\N;\N;\N;\N;\N;\N;\N;\N;\N;\N;\N
645;Nelly & Monsieur Arnaud;113947;7.6;21;20;1;95;7.8;10;9;1;90;3.8;381;78
647;Courage Under Fire;115956;7.3;52;44;8;84;7.8;15;14;1;93;3.2;6918;61
648;Mission: Impossible III;317919;6.6;217;152;65;70;6.2;42;26;16;61;3.3;86328;69
649;Cold Fever;109028;7.3;10;9;1;90;0;3;3;0;100;3.9;284;81
650;Moll Flanders;117071;5.5;20;9;11;45;6.3;6;3;3;50;3.5;855;72
651;Das Superweib;117788;\N;\N;\N;\N;\N;\N;\N;\N;\N;\N;\N;\N;\N
652;301, 302;112257;5.9;7;5;2;71;0;1;0;1;0;3.7;163;69
653;DragonHeart;116136;5.7;30;15;15;50;6.4;5;3;2;60;3.2;19438;63
655;Mutters Courage;117117;0;0;0;0;0;0;0;0;0;0;0;0;0
656;48 Hrs.;83511;7.4;33;31;2;93;0;4;3;1;75;3.2;10471;61
658;Billy's Holiday;112509;0;1;0;1;0;0;0;0;0;0;0;0;0
659;Plein soleil;54189;8.2;21;21;0;100;0;4;4;0;100;4;670;89
660;August Rush;426931;4.8;120;44;76;36;4.4;27;7;20;25;4;105941;84
661;James and the Giant Peach;116683;7;55;51;4;92;7.5;12;11;1;91;3;18876;55
662;Fear;116287;4.8;28;11;17;39;0;4;1;3;25;3.2;11285;66
663;Kids in the Hall: Brain Candy;116768;4.7;33;13;20;39;4.3;9;3;6;33;3.4;2060;72
664;Faithful;116269;3.8;14;1;13;7;5;5;1;4;20;3.1;397;47
665;Underground;114787;7.5;18;15;3;83;0;4;4;0;100;4.4;6157;96
666;Lust och fägring stor;113720;0;1;1;0;100;0;0;0;0;0;0;0;0
667;Bloodsport 2;112536;0;0;0;0;0;0;0;0;0;0;0;0;0
668;Pather Panchali;48473;8.9;33;32;1;96;8.6;6;6;0;100;4.5;1572;95
670;Apur Sansar;52572;9;16;16;0;100;9.2;6;6;0;100;4.4;1009;94
671;Mystery Science Theater 3000: The Movie;117128;6.4;37;27;10;72;6.3;13;9;4;69;3.8;4508;86
673;Space Jam;117705;5.1;44;16;28;36;5.4;14;6;8;42;2.9;27911;52
674;Barbarella;62711;6;35;26;9;74;4.8;5;2;3;40;3;5461;55
678;Some Folks Call It a Sling Blade;108181;0;0;0;0;0;0;0;0;0;0;0;0;0
679;The Run of the Country;114307;6;7;3;4;42;0;2;1;1;50;3.3;237;60
680;Alphaville, une étrange aventure de Lemmy Caution;58898;7.9;25;21;4;84;0;2;1;1;50;3.9;4907;82
681;Coup de torchon;82206;7.2;6;5;1;83;0;1;0;1;0;3.8;497;77
682;Tigrero: A Film That Was Never Made;111430;0;2;2;0;100;0;0;0;0;0;0;0;0
683;L'oeil de Vichy;107727;0;2;2;0;100;0;0;0;0;0;0;0;0
685;It's My Party;113443;5.8;14;7;7;50;6.2;6;3;3;50;3.7;843;78
687;Country Life;109491;6.5;6;4;2;66;0;2;2;0;100;3.1;265;44
688;Operation Dumbo Drop;114048;4;24;7;17;29;0;3;2;1;66;2.4;2200;31
690;Das Versprechen;111613;7;6;5;1;83;0;1;1;0;100;3.7;95;74
691;Mrs. Winterbourne;117104;3.8;29;2;27;6;3.3;10;0;10;0;3.1;2892;60
692;Solo;117688;3.2;26;1;25;3;3.8;10;1;9;10;2.3;827;25
693;Etz Hadomim Tafus;109751;0;1;1;0;100;0;0;0;0;0;0;0;0
694;The Substitute;117774;4.6;21;8;13;38;4.2;8;2;6;25;2.9;1815;44
695;True Crime;139668;6;38;20;18;52;6.8;6;5;1;83;3.2;2873;51
696;Butterfly Kiss;112604;6.4;13;10;3;76;0;1;1;0;100;3.2;586;55
697;Feeling Minnesota;116289;3.8;19;3;16;15;0;4;1;3;25;2.7;2783;30
698;Delta of Venus;109593;4.4;5;0;5;0;0;0;0;0;0;0;0;0
700;Angus, Thongs and Perfect Snogging;963743;6;24;17;7;70;0;2;1;1;50;3.9;6295;76
701;Daens;104046;0;0;0;0;0;0;0;0;0;0;0;0;0
702;Face/Off;119094;7.9;60;56;4;93;8.4;15;15;0;100;3.5;62348;81
703;Boy A;1078188;7.5;57;51;6;89;7.5;23;20;3;86;3.5;5895;84
704;Galaxy Quest;177789;7.2;111;99;12;89;6.9;27;22;5;81;3;19804;67
705;Così fan tutte;104014;0;0;0;0;0;0;0;0;0;0;0;0;0
706;Sunset Park;117784;4.6;8;1;7;12;0;3;0;3;0;3.6;636;78
707;Mulholland Falls;117107;5.1;29;9;20;31;5.9;5;2;3;40;2.9;1519;40
708;The Truth About Cats & Dogs;117979;6.7;36;30;6;83;7.6;6;5;1;83;2.9;6120;55
709;Oliver & Company;95776;5.4;33;14;19;42;7.2;5;4;1;80;3.3;9618;65
710;Celtic Pride;115851;3.1;23;2;21;8;4.5;7;2;5;28;2.6;1756;30
711;Flipper;116322;4.8;17;5;12;29;5.4;5;1;4;20;2.6;6086;44
712;La captive;216605;6.7;10;7;3;70;0;1;1;0;100;3;119;47
713;Of Love and Shadows;110712;4.2;5;1;4;20;0;0;0;0;0;0;0;0
714;Dead Man;112817;6.8;33;23;10;69;5.8;6;2;4;33;4;16798;86
715;Le hussard sur le toit;113362;6.6;20;13;7;65;6.4;5;3;2;60;3.7;1134;77
716;The Jezebels;73778;5.4;19;10;9;52;4.4;7;2;5;28;3.5;847;69
717;Boca a boca;112546;5.8;9;3;6;33;0;2;1;1;50;3.3;162;56
718;Les visiteurs;108500;5.4;11;4;7;36;0;3;0;3;0;3.7;3693;74
719;Multiplicity;117108;5.4;43;19;24;44;5.2;14;4;10;28;2.7;4648;43
720;Wallace & Gromit: The Best of Aardman Animation;118114;\N;\N;\N;\N;\N;\N;\N;\N;\N;\N;\N;\N;\N
722;The Haunted World of Edward D. Wood Jr.;113270;0;1;1;0;100;0;0;0;0;0;0;0;0
724;The Craft;115963;5.4;29;13;16;44;5.5;6;2;4;33;3.1;23740;67
725;The Great White Hype;116448;5.1;20;9;11;45;6.6;5;3;2;60;2.7;1488;32
726;Save the Last Dance;206275;0;0;0;0;0;0;0;0;0;0;0;0;0
727;War Stories;315091;0;0;0;0;0;0;0;0;0;0;0;0;0
728;Cold Comfort Farm;112701;7.5;31;26;5;83;8.6;5;5;0;100;3.7;1564;79
729;Institute Benjamenta, or This Dream People Call Human Life;113429;7.5;6;6;0;100;0;1;1;0;100;4.2;375;87
730;The Riches;496343;\N;\N;\N;\N;\N;\N;\N;\N;\N;\N;\N;\N;\N
731;Heaven's Prisoners;116508;4.1;19;3;16;15;4.9;5;1;4;20;2.7;457;25
733;The Rock;117500;6.5;47;31;16;65;6;15;9;6;60;3.6;45013;85
734;Getting Away with Murder;116405;3;7;0;7;0;0;3;0;3;0;2.8;747;29
735;Dellamorte Dellamore;109592;6;26;16;10;61;0;2;0;2;0;3.8;3149;78
736;Twister;117998;6;49;28;21;57;6.7;10;7;3;70;3.2;45771;62
737;Barb Wire;115624;\N;\N;\N;\N;\N;\N;\N;\N;\N;\N;\N;\N;\N
738;Le garçu;113145;0;0;0;0;0;0;0;0;0;0;0;0;0
741;Kôkaku kidôtai;113568;7.4;31;29;2;93;0;3;3;0;100;3.9;25483;87
742;Thinner;117894;3.8;17;3;14;17;0;3;0;3;0;2.7;3249;40
743;Spy Hard;117723;3.2;30;2;28;6;2.6;8;0;8;0;2.5;4450;37
744;Brothers in Trouble;112586;0;3;3;0;100;0;0;0;0;0;0;0;0
745;Wallace and Gromit in A Close Shave;112691;8.5;19;19;0;100;0;0;0;0;0;0;0;0
746;Force of Evil;40366;8.6;12;12;0;100;0;2;2;0;100;3.7;600;74
747;The Stupids;117768;3.1;14;3;11;21;0;2;1;1;50;2.3;2070;35
748;The Arrival;115571;6.3;27;18;9;66;6.1;5;3;2;60;2.9;2211;41
750;Dr. Strangelove or: How I Learned to Stop Worrying and Love the Bomb;57012;9;58;58;0;100;8.6;8;8;0;100;4.2;33662;94
751;Careful;103926;6.4;11;9;2;81;0;4;3;1;75;4;200;79
753;A Month by the Lake;113849;6.2;17;12;5;70;0;4;2;2;50;3.1;914;44
754;Gold Diggers: The Secret of Bear Mountain;113188;6.2;8;4;4;50;0;4;1;3;25;0;0;0
755;Kim;42644;6.6;5;5;0;100;0;0;0;0;0;0;0;0
756;Carmen Miranda: Bananas Is My Business;109381;6;5;4;1;80;0;0;0;0;0;0;0;0
757;Dung che sai duk;1233247;6.6;69;54;15;78;6.7;18;14;4;77;3.6;2166;71
759;Maya Lin: A Strong Clear Vision;110480;7.5;6;6;0;100;0;2;2;0;100;3.8;180;72
760;Stalingrad;108211;7.1;7;5;2;71;0;1;1;0;100;4;2247;87
761;Star Wars: Episode I - The Phantom Menace;120915;0;0;0;0;0;0;0;0;0;0;0;0;0
762;Striptease;117765;3.4;34;4;30;11;4.4;6;0;6;0;2.4;5832;28
763;The Last of the High Kings;116833;0;1;1;0;100;0;0;0;0;0;0;0;0
764;This Is Spinal Tap;88258;8.6;53;51;2;96;7.7;7;6;1;85;3.9;23608;91
765;Jack;116669;4;29;5;24;17;4.8;5;1;4;20;3;11920;57
766;I Shot Andy Warhol;116594;6.7;25;19;6;76;8.3;6;5;1;83;3.4;1521;68
767;The Grass Harp;113211;5.9;14;7;7;50;6.2;5;2;3;40;3.4;297;56
769;Marlene Dietrich: Shadow and Light;116992;\N;\N;\N;\N;\N;\N;\N;\N;\N;\N;\N;\N;\N
771;La môme;450188;5.8;12;6;6;50;0;4;1;3;25;3.8;33;80
774;Wend Kuuni;84898;0;0;0;0;0;0;0;0;0;0;0;0;0
775;Histoires extraordinaires;63715;6.6;18;16;2;88;0;1;1;0;100;3.5;736;65
778;Trainspotting;117951;8.2;55;49;6;89;7.7;14;12;2;85;4;88351;92
779;'Til There Was You;118523;3.9;28;2;26;7;3.7;10;0;10;0;2.7;1660;36
780;Independence Day;116629;6.2;54;33;21;61;6.5;17;11;6;64;3.5;94416;75
781;Stealing Beauty;117737;5.9;47;25;22;53;5.9;11;6;5;54;3.5;5036;73
782;The Fan;116277;4.8;25;10;15;40;5.3;5;2;3;40;2.8;5593;37
783;The Hunchback of Notre Dame;31455;8.3;9;9;0;100;0;0;0;0;0;0;0;0
784;The Cable Guy;115798;5.4;54;28;26;51;4;14;2;12;14;2.8;27061;50
785;Kingpin;116778;5.8;35;18;17;51;5.7;5;3;2;60;3.1;13950;63
786;Eraser;116213;4.9;44;15;29;34;5.2;11;4;7;36;2.8;10891;43
787;The Gate of Heavenly Peace;113147;0;1;1;0;100;0;0;0;0;0;0;0;0
788;The Nutty Professor;117218;6;51;34;17;66;6.7;15;13;2;86;2.9;25286;50
789;Yo, la peor de todas;100990;\N;\N;\N;\N;\N;\N;\N;\N;\N;\N;\N;\N;\N
791;The Last Klezmer: Leopold Kozlowski, His Life and Music;113610;0;2;2;0;100;0;0;0;0;0;0;0;0
792;Hol volt, hol nem volt;93199;0;1;1;0;100;0;0;0;0;0;0;0;0
793;En compagnie d'Antonin Artaud;106810;6.9;6;5;1;83;0;2;1;1;50;0;0;0
795;Somebody to Love;111237;\N;\N;\N;\N;\N;\N;\N;\N;\N;\N;\N;\N;\N
796;A Very Natural Thing;72362;0;1;0;1;0;0;0;0;0;0;0;0;0
798;Daylight;116040;4.7;27;6;21;22;4.9;6;0;6;0;2.8;7912;41
799;The Frighteners;116365;6.3;25;18;7;72;5.1;6;2;4;33;3.3;9928;70
800;Lone Star State of Mind;269483;0;4;0;4;0;0;0;0;0;0;0;0;0
801;Harriet the Spy;116493;5.1;29;13;16;44;4.8;13;4;9;30;2.6;3584;46
802;Phenomenon;117333;5.9;32;16;16;50;5.5;6;1;5;16;3;9166;62
803;Walking and Talking;118113;7.1;21;18;3;85;0;4;3;1;75;3.6;674;67
804;She's the One;117628;5.8;48;29;19;60;5.9;12;7;5;58;2.9;3031;39
805;A Time to Kill;117913;6.1;50;34;16;68;6.6;12;8;4;66;3.6;17074;83
806;American Buffalo;115530;6.6;25;19;6;76;7.4;6;5;1;83;3;598;46
807;Les rendez-vous de Paris;114266;6.8;17;13;4;76;6.5;6;4;2;66;3.6;158;63
808;Mystery, Alaska;134618;4.9;78;29;49;37;5.1;26;11;15;42;3.2;4196;66
809;Fled;116320;4.3;29;4;25;13;4.5;11;2;9;18;2.6;1281;26
810;Kazaam;116756;2.5;25;1;24;4;3;10;0;10;0;1.8;3161;19
813;Larger Than Life;116823;4.1;17;2;15;11;4;6;0;6;0;2.6;1363;28
814;A Boy Called Hate;112568;0;1;1;0;100;0;0;0;0;0;0;0;0
815;Power 98;114170;\N;\N;\N;\N;\N;\N;\N;\N;\N;\N;\N;\N;\N
818;A Very Brady Sequel;118073;5.6;32;16;16;50;6.5;9;6;3;66;2.3;4591;26
820;La mort en ce jardin;49521;7.8;11;10;1;90;0;2;2;0;100;3.4;201;47
821;The Crude Oasis;112746;0;1;0;1;0;0;1;0;1;0;3.1;38;50
823;La collectionneuse;61495;7.1;9;8;1;88;0;2;1;1;50;3.9;566;83
824;Jeder für sich und Gott gegen alle;71691;0;0;0;0;0;0;0;0;0;0;0;0;0
827;O Convento;112716;3.5;7;2;5;28;0;0;0;0;0;0;0;0
828;The Adventures of Pinocchio;115472;4.8;15;4;11;26;5.4;5;1;4;20;2.6;1746;33
829;Joe's Apartment;116707;3.8;26;4;22;15;3.6;8;1;7;12;2.5;3311;43
830;The First Wives Club;116313;5.4;32;13;19;40;5.7;7;2;5;28;3.2;9522;67
831;Stonewall;114550;6.5;8;5;3;62;0;3;1;2;33;3.4;282;57
832;Ransom;117438;6.4;30;21;9;70;5.7;7;4;3;57;3.1;10364;61
833;High School Musical 3: Senior Year;962726;5.9;127;83;44;65;6;27;18;9;66;3.6;80210;76
834;Phat Beach;117332;0;3;0;3;0;0;1;0;1;0;3;375;46
835;Foxfire;116353;5.3;10;3;7;30;0;4;1;3;25;3.5;3071;67
836;Chain Reaction;115857;4.1;31;4;27;12;5.1;9;2;7;22;2.7;6845;33
837;Matilda;117008;7.4;20;18;2;90;7.4;5;5;0;100;3.1;24214;65
838;Emma;116191;0;0;0;0;0;0;0;0;0;0;0;0;0
839;The Crow: City of Angels;115986;3.4;33;4;29;12;3.3;8;1;7;12;3;12460;51
840;House Arrest;116571;3.5;12;1;11;8;0;3;0;3;0;2.8;2789;44
841;Les yeux sans visage;53459;8.2;42;41;1;97;7.8;9;8;1;88;4;785;86
842;Bordello of Blood;117826;3.2;27;4;23;14;3.6;7;1;6;14;2.6;3764;41
844;Xinghua san yue tian;108227;0;0;0;0;0;0;0;0;0;0;0;0;0
845;Tian guo ni zi;111424;0;3;2;1;66;0;0;0;0;0;0;0;0
846;Flirt;113080;6.6;10;7;3;70;0;2;0;2;0;3.7;271;71
847;The Big Squeeze;115680;5;7;3;4;42;0;1;0;1;0;3.8;49;75
848;The Spitfire Grill;117718;5.4;26;9;17;34;5.2;6;0;6;0;3.6;777;77
849;Escape from L.A.;116225;5.6;45;25;20;55;5.9;14;8;6;57;2.8;10054;41
850;Xich lo;112767;6.5;11;8;3;72;0;0;0;0;0;0;0;0
851;Basquiat;115632;0;0;0;0;0;0;0;0;0;0;0;0;0
852;Tin Cup;117918;6.5;48;33;15;68;7;13;10;3;76;2.9;6148;57
853;Evil Angels;94924;6.8;20;18;2;90;0;1;1;0;100;3.3;1554;63
858;The Godfather;68646;9;66;66;0;100;8.4;11;11;0;100;4.4;172072;97
860;Der bewegte Mann;109255;5.9;9;5;4;55;0;3;2;1;66;3.5;359;64
861;Ging chat goo si 3: Chiu kup ging chat;104558;7.3;37;35;2;94;6.8;9;8;1;88;3.4;4064;69
862;Manny & Lo;116985;5.8;21;13;8;61;6.2;11;8;3;72;3.4;477;55
864;The Time Traveler's Wife;452694;5.1;151;56;95;37;4.8;34;10;24;29;2.9;189828;65
865;Small Faces;114474;6.7;9;6;3;66;0;2;2;0;100;4.1;183;85
866;Bound;115736;7.7;34;30;4;88;8.6;5;5;0;100;3.5;5521;80
867;Carpool;115836;2.4;10;0;10;0;0;3;0;3;0;2.6;1096;39
868;Death in Brunswick;101692;0;4;2;2;50;0;0;0;0;0;0;0;0
869;Kansas City;116745;5.9;33;19;14;57;6.2;9;5;4;55;3;608;37
870;Gone Fishin';119214;2.2;22;1;21;4;2.4;6;0;6;0;2.6;2183;39
872;Ai qing wan sui;109066;8.1;5;4;1;80;0;0;0;0;0;0;0;0
875;Nothing to Lose;119807;5.1;23;6;17;26;5.7;5;1;4;20;3.1;5245;67
876;Chao ji ji hua;106544;6;14;9;5;64;0;1;1;0;100;3.1;871;46
877;Girls Town;116418;6.8;23;20;3;86;7;10;9;1;90;3.8;173;76
879;The Relic;120004;4.4;28;9;19;32;5.8;5;2;3;40;2.7;3098;36
880;The Island of Dr. Moreau;116654;4.3;31;7;24;22;4;5;0;5;0;2.4;5032;26
881;First Kid;116311;4;12;2;10;16;0;2;0;2;0;2.5;2541;37
882;The Trigger Effect;117965;6.4;23;17;6;73;0;3;1;2;33;3;521;35
884;Sweet Nothing in My Ear;1158793;0;0;0;0;0;0;0;0;0;0;0;0;0
885;Bill & Ted's Bogus Journey;101452;6;33;19;14;57;6;6;4;2;66;3;17201;59
886;Bulletproof Monk;245803;4.3;130;28;102;21;4;31;5;26;16;2.9;13789;50
887;Talk of Angels;120271;0;3;2;1;66;0;0;0;0;0;0;0;0
888;The Land Before Time III: The Time of the Great Giving;113596;0;4;2;2;50;0;0;0;0;0;0;0;0
889;Miami Vice;430357;5.6;189;89;100;47;6.4;41;28;13;68;2.8;55637;48
891;Halloween: The Curse of Michael Myers;113253;2.5;27;1;26;3;1.7;6;0;6;0;3.1;12571;56
892;Twelfth Night;117991;6.8;30;21;9;70;6.5;10;7;3;70;3.7;1937;77
893;Mother Night;117093;6.3;23;14;9;60;6.4;5;2;3;40;3.6;706;74
896;Les roseaux sauvages;111019;8.2;10;10;0;100;0;3;3;0;100;4;604;86
897;For Whom the Bell Tolls;35896;6.4;12;10;2;83;0;0;0;0;0;0;0;0
898;The Philadelphia Story;32904;8.6;43;43;0;100;8;5;5;0;100;4.1;11465;92
899;Singin' in the Rain;45152;9.2;44;44;0;100;8.8;9;9;0;100;3.9;28033;91
900;An American in Paris;43278;7.9;47;46;1;97;7.2;5;5;0;100;3.7;6926;77
901;Funny Face;50419;7.6;22;19;3;86;0;2;2;0;100;3.7;8892;80
902;Breakfast at Tiffany's;54698;7.4;43;37;6;86;7.4;5;5;0;100;3.9;56438;91
903;Vertigo;52357;8.6;54;53;1;98;8;14;13;1;92;4.1;28291;92
904;Rear Window;47396;8.9;60;60;0;100;8.7;17;17;0;100;4.2;33508;95
905;It Happened One Night;25316;8.7;32;31;1;96;8.2;5;5;0;100;4.1;7375;92
906;Gaslight;36855;7.6;16;14;2;87;0;1;1;0;100;4;2391;89
907;The Gay Divorcee;25164;7.8;8;8;0;100;0;0;0;0;0;0;0;0
908;North by Northwest;53125;9;58;58;0;100;7.8;6;6;0;100;4.2;23243;93
909;The Apartment;53604;8.3;43;39;4;90;7.6;8;7;1;87;4.1;9116;93
910;Some Like It Hot;53291;8.9;40;39;1;97;0;4;4;0;100;4.1;23119;93
911;Charade;56923;8.1;33;30;3;90;6;5;3;2;60;4.1;9173;92
912;Casablanca;34583;9;58;56;2;96;7.7;7;6;1;85;4;66776;94
913;The Maltese Falcon;33870;9;40;40;0;100;8.2;6;6;0;100;4;14452;90
914;My Fair Lady;58385;8;36;34;2;94;8.6;6;6;0;100;3.7;27491;87
915;Sabrina;47437;7.4;31;28;3;90;7.2;5;5;0;100;3.8;12812;87
916;Roman Holiday;46250;8.2;43;42;1;97;7.5;6;5;1;83;4.1;17541;93
917;A Little Princess;113670;8.4;20;19;1;95;0;3;3;0;100;3.4;13643;81
918;Meet Me in St. Louis;37059;8.4;24;24;0;100;0;4;4;0;100;3.8;7067;84
919;The Wizard of Oz;32138;9.2;70;70;0;100;8.7;11;11;0;100;3.6;69148;82
920;Gone with the Wind;31381;8.7;62;60;2;96;8.3;13;13;0;100;3.9;62786;91
921;My Favorite Year;84370;7.8;22;22;0;100;0;0;0;0;0;0;0;0
922;Sunset Blvd.;43014;9.2;52;51;1;98;8.2;7;7;0;100;4.3;12588;95
923;Citizen Kane;33467;9.4;54;54;0;100;8.9;7;7;0;100;4.1;33926;91
924;2001: A Space Odyssey;62622;8.8;53;51;2;96;7.1;11;9;2;81;3.7;46687;86
925;Golden Earrings;39428;0;0;0;0;0;0;0;0;0;0;0;0;0
926;All About Eve;42192;9;54;54;0;100;8.2;10;10;0;100;4.2;10267;94
927;The Women;430770;3.9;142;18;124;12;3.8;34;4;30;11;3;20081;41
928;Rebecca;32976;8.7;36;36;0;100;8.2;5;5;0;100;0;0;0
929;Foreign Correspondent;32484;7.9;28;26;2;92;0;3;3;0;100;3.7;1921;77
930;Notorious;472198;5.5;136;68;68;50;6.2;36;22;14;61;3.6;66668;66
931;Spellbound;38109;7.3;30;26;4;86;0;1;1;0;100;3.8;4332;82
932;An Affair to Remember;50105;6.4;25;16;9;64;0;1;0;1;0;4;7962;88
933;To Catch a Thief;48728;8;32;31;1;96;0;2;2;0;100;0;0;0
934;Father of the Bride;101862;5.8;29;21;8;72;0;2;2;0;100;3.2;22336;67
935;The Band Wagon;45537;8.5;13;13;0;100;0;1;1;0;100;3.8;1257;79
936;Ninotchka;31725;8.3;23;23;0;100;0;3;3;0;100;4.1;1769;89
937;Love in the Afternoon;50658;7.1;23;20;3;86;0;4;4;0;100;3.8;2060;80
938;Gigi;51658;7.1;27;20;7;74;0;4;3;1;75;3.7;5450;75
939;The Reluctant Debutante;52126;0;4;2;2;50;0;0;0;0;0;0;0;0
940;The Adventures of Robin Hood;29843;8.9;43;43;0;100;8.6;7;7;0;100;3.7;6404;84
941;The Mask of Zorro;120746;7.1;66;54;12;81;6.5;13;10;3;76;3.3;31107;70
942;Laura;37008;8.6;45;45;0;100;8;6;6;0;100;0;0;0
943;The Ghost and Mrs. Muir;39420;8.2;12;12;0;100;0;0;0;0;0;0;0;0
944;Lost Horizon;29162;7.6;8;8;0;100;0;0;0;0;0;0;0;0
945;Top Hat;27125;8.6;37;37;0;100;8;6;6;0;100;4;2908;89
946;To Be or Not to Be;35446;8.7;34;33;1;97;7;5;4;1;80;4.2;1733;92
947;My Man Godfrey;28010;8.4;26;26;0;100;8;6;6;0;100;4.1;1789;90
948;Giant;49261;7.7;35;34;1;97;7.8;6;6;0;100;3.9;5890;86
949;East of Eden;48028;8.2;30;26;4;86;0;3;2;1;66;4;5957;90
950;The Thin Man;25878;8.5;26;26;0;100;0;1;1;0;100;4.2;3591;93
951;His Girl Friday;32599;8.6;36;35;1;97;0;4;4;0;100;0;0;0
952;Around the World in 80 Days;327437;4.8;127;39;88;30;4.7;33;9;24;27;2.7;14038;45
953;It's a Wonderful Life;38650;8.7;54;51;3;94;8.4;6;6;0;100;4;35280;94
954;Mr. Smith Goes to Washington;31679;7.4;12;10;2;83;7.4;7;6;1;85;3.6;869;66
955;Bringing Up Baby;29947;8.4;36;34;2;94;0;4;3;1;75;4;8722;90
956;Penny Serenade;34012;7.4;15;14;1;93;0;3;3;0;100;3.7;1083;74
957;The Scarlet Letter;114345;3;33;5;28;15;3.6;11;1;10;9;2.9;3493;48
958;Lady of Burlesque;36094;5.5;5;3;2;60;0;3;2;1;66;3.2;263;52
959;Of Human Bondage;25586;6.9;9;7;2;77;0;0;0;0;0;0;0;0
960;Angel on My Shoulder;38300;0;3;2;1;66;0;0;0;0;0;0;0;0
961;Little Lord Fauntleroy;27893;7;5;4;1;80;0;0;0;0;0;0;0;0
963;The Inspector General;41509;6.8;8;7;1;87;0;0;0;0;0;0;0;0
964;Angel and the Badman;39152;6.5;6;4;2;66;0;0;0;0;0;0;0;0
965;The 39 Steps;26029;8.8;32;31;1;96;0;4;4;0;100;3.8;5603;84
966;A Walk in the Sun;38235;0;0;0;0;0;0;0;0;0;0;0;0;0
967;Outlaw;758771;0;0;0;0;0;0;0;0;0;0;0;0;0
968;Night of the Living Dead;63350;8.5;45;43;2;95;7;5;4;1;80;3.7;26113;85
969;The African Queen;43265;8.7;29;29;0;100;0;3;3;0;100;3.8;6609;87
970;Beat the Devil;46414;6.6;11;7;4;63;0;2;1;1;50;3.3;793;55
971;Cat on a Hot Tin Roof;51459;7.8;30;30;0;100;0;4;4;0;100;3.9;6600;91
972;The Last Time I Saw Paris;47162;6.3;6;5;1;83;0;2;1;1;50;3.1;883;44
973;Meet John Doe;33891;7.2;13;11;2;84;0;0;0;0;0;0;0;0
974;La battaglia di Algeri;58946;9;70;69;1;98;8.9;17;17;0;100;4.4;4132;95
976;A Farewell to Arms;22879;7.6;8;7;1;87;0;0;0;0;0;0;0;0
980;Huang jia shi jie;93229;0;2;2;0;100;0;0;0;0;0;0;0;0
981;On Dangerous Ground;43879;8.3;11;11;0;100;0;1;1;0;100;3.8;411;75
982;Picnic;48491;6.5;6;3;3;50;0;1;0;1;0;3.5;632;64
983;Madagascar Skin;113730;0;3;2;1;66;0;1;0;1;0;3.5;295;58
984;The Pompatus of Love;117357;3.8;6;1;5;16;0;2;1;1;50;2.9;52;31
985;Small Wonder;88610;\N;\N;\N;\N;\N;\N;\N;\N;\N;\N;\N;\N;\N
986;Fly Away Home;116329;7.1;32;27;5;84;8.1;7;7;0;100;3;5636;63
987;Bliss;118742;5.8;12;6;6;50;0;4;1;3;25;3.4;337;58
988;Grace of My Heart;116442;6.7;22;16;6;72;0;4;0;4;0;3.6;611;71
989;Schlafes Bruder;114354;6.6;7;5;2;71;0;2;2;0;100;4.1;119;84
990;Maximum Risk;117011;4.3;31;9;22;29;4.2;10;3;7;30;2.8;2236;38
991;Michael Collins;117039;6.8;44;34;10;77;6.8;9;7;2;77;3.6;4673;79
992;The Rich Man's Wife;117473;4.1;14;2;12;14;0;4;0;4;0;3;769;49
993;Infinity;116635;6.2;13;8;5;61;0;4;2;2;50;3.1;399;38
994;Big Night;115678;8;52;50;2;96;8.2;11;11;0;100;3.9;1944;84
996;Last Man Standing;116830;5.1;30;11;19;36;4;6;1;5;16;3.1;8711;56
997;Caught;115847;6.3;12;9;3;75;0;3;2;1;66;3.2;209;58
998;Set It Off;117603;6;23;14;9;60;7.5;6;5;1;83;3.6;10301;86
999;2 Days in the Valley;115438;6.1;52;32;20;61;6;11;8;3;72;3;3984;48
1000;Curdled;115994;4.3;12;2;10;16;0;2;0;2;0;3.4;441;62
1001;The Associate;115580;5.1;17;4;13;23;6.2;7;3;4;42;2.9;1259;52
1002;Ed's Next Move;116167;6.3;9;7;2;77;0;2;2;0;100;3.2;43;75
1003;Extreme Measures;116259;6;31;17;14;54;5.7;6;2;4;33;2.9;2772;37
1004;The Glimmer Man;116421;3.4;24;3;21;12;2.6;9;0;9;0;2.7;2801;48
1005;D3: The Mighty Ducks;116000;3.7;14;2;12;14;0;4;0;4;0;2.8;9838;50
1006;The Chamber;115862;4.5;24;3;21;12;4.6;7;0;7;0;3;1633;43
1007;The Apple Dumpling Gang;72653;6;8;4;4;50;0;2;0;2;0;3.2;2133;60
1008;Davy Crockett, King of the Wild Frontier;47977;0;4;4;0;100;0;0;0;0;0;0;0;0
1009;Escape to Witch Mountain;72951;6;20;15;5;75;0;3;2;1;66;3.1;3761;60
1010;The Love Bug;64603;5.7;15;11;4;73;0;4;1;3;25;3.1;3795;63
1011;Herbie Rides Again;71607;0;4;3;1;75;0;0;0;0;0;0;0;0
1012;Old Yeller;50798;7.7;17;16;1;94;0;2;2;0;100;3.3;6399;73
1013;The Parent Trap;120783;7;34;27;7;79;6.5;7;4;3;57;3.1;41455;67
1014;Pollyanna;54195;7.4;11;9;2;81;0;2;2;0;100;3.3;3331;71
1015;Homeward Bound: The Incredible Journey;107131;6.5;22;19;3;86;6.9;8;7;1;87;3.2;15019;66
1016;The Shaggy Dog;393735;4.4;103;28;75;27;4.8;29;10;19;34;2.9;41890;50
1017;Swiss Family Robinson;54357;6.7;17;14;3;82;0;2;1;1;50;3.3;3986;71
1018;That Darn Cat;120317;3.8;14;1;13;7;0;4;0;4;0;2.5;2029;30
1019;20000 Leagues Under the Sea;46672;7.7;24;22;2;91;0;4;4;0;100;3.2;7628;57
1020;Cool Runnings;106611;6;30;22;8;73;6;6;4;2;66;3.4;35317;77
1021;Angels in the Outfield;43286;0;1;1;0;100;0;0;0;0;0;0;0;0
1022;Cinderella;42332;7.3;26;24;2;92;8;5;5;0;100;3.5;63946;76
1023;Winnie the Pooh and the Blustery Day;63819;\N;\N;\N;\N;\N;\N;\N;\N;\N;\N;\N;\N;\N
1024;The Three Caballeros;38166;6.8;15;13;2;86;0;4;3;1;75;3.3;2192;62
1025;The Sword in the Stone;57546;6;22;16;6;72;0;3;2;1;66;3.3;11900;68
1026;So Dear to My Heart;41890;0;0;0;0;0;0;0;0;0;0;0;0;0
1027;Robin Hood: Prince of Thieves;102798;5.2;27;15;12;55;0;2;1;1;50;3.4;30722;72
1028;Mary Poppins;58331;8.2;37;37;0;100;0;3;3;0;100;3.5;44140;79
1029;Dumbo;33563;8.4;31;30;1;96;0;4;4;0;100;3.3;32327;65
1030;Pete's Dragon;76538;4.6;20;10;10;50;0;2;2;0;100;3.1;7622;59
1031;Bedknobs and Broomsticks;66817;6;28;17;11;60;4.8;5;1;4;20;3.3;15857;67
1032;Alice in Wonderland;43274;6.5;22;18;4;81;0;3;2;1;66;3.3;37778;70
1033;The Fox and the Hound;82406;6.6;22;15;7;68;0;3;3;0;100;3.4;24666;77
1034;Freeway;116361;6.4;35;26;9;74;7.6;8;6;2;75;3.4;4677;73
1035;The Sound of Music;59742;7.7;47;38;9;80;5;5;2;3;40;3.6;72590;86
1036;Die Hard;95016;8.1;50;47;3;94;6.2;9;6;3;66;3.9;99625;91
1037;The Lawnmower Man;104692;4.9;19;9;10;47;0;0;0;0;0;0;0;0
1038;Unhook the Stars;118044;6.6;16;13;3;81;6.4;6;5;1;83;3.2;257;49
1039;Synthetic Pleasures;114597;5.4;6;1;5;16;0;2;0;2;0;0;0;0
1040;Secret Agent;28231;7.6;10;10;0;100;0;0;0;0;0;0;0;0
1041;Secrets & Lies;117589;8.6;34;32;2;94;9.2;7;7;0;100;4.1;3358;90
1042;That Thing You Do!;117887;7.1;50;46;4;92;7.2;17;16;1;94;3.2;14364;69
1043;To Gillian on Her 37th Birthday;117924;4.7;27;4;23;14;5.2;7;0;7;0;2.9;1032;43
1044;Surviving Picasso;117791;5;17;5;12;29;6.2;6;2;4;33;3.4;1054;58
1045;Love Is All There Is;116928;0;2;0;2;0;0;0;0;0;0;0;0;0
1046;Beautiful Thing;115640;6.8;20;18;2;90;6.8;8;7;1;87;4.3;3357;91
1047;The Long Kiss Goodnight;116908;6.1;29;20;9;68;4.1;6;0;6;0;3.3;10833;69
1049;The Ghost and the Darkness;116409;5.5;45;23;22;51;4.3;10;2;8;20;3.3;7987;71
1050;Looking for Richard;116913;7.1;45;37;8;82;6.5;12;8;4;66;3.6;1885;73
1051;Trees Lounge;117958;6.9;25;20;5;80;0;4;3;1;75;3.6;1441;78
1053;Normal Life;117202;6;10;7;3;70;0;2;2;0;100;3;289;45
1054;Get on the Bus;116404;7.5;38;33;5;86;7.7;10;9;1;90;3.5;1014;70
1055;Shadow Conspiracy;120107;3;27;0;27;0;3.3;9;0;9;0;2.6;692;24
1056;Jude;116722;7.3;28;24;4;85;7.7;8;7;1;87;3.6;1931;71
1057;Everyone Says I Love You;116242;7.3;41;32;9;78;7;9;5;4;55;3.4;6964;63
1058;Azúcar amarga;115600;0;3;2;1;66;0;0;0;0;0;0;0;0
1059;Romeo + Juliet;117509;0;0;0;0;0;0;0;0;0;0;0;0;0
1060;Swingers;117802;7.7;51;44;7;86;7.6;10;8;2;80;3.8;14060;89
1061;Sleepers;117665;6.7;48;35;13;72;7.3;9;8;1;88;3.6;20694;81
1062;The Sunchaser;117781;3.9;5;1;4;20;0;1;0;1;0;3.3;191;52
1063;Indiana Jones and the Last Crusade;97576;7.9;54;48;6;88;6.5;7;5;2;71;3.9;103952;91
1064;Aladdin and the King of Thieves;115491;4.4;9;2;7;22;0;0;0;0;0;0;0;0
1066;Shall We Dance;358135;5.4;152;69;83;45;5.2;37;16;21;43;3;26935;63
1067;A Damsel in Distress;28757;0;4;3;1;75;0;1;1;0;100;3.5;179;59
1068;Crossfire;39286;7.7;12;10;2;83;0;3;3;0;100;3.5;577;72
1069;Murder, My Sweet;37101;7.7;14;13;1;92;0;0;0;0;0;0;0;0
1070;Macao;44863;5.7;9;5;4;55;0;2;0;2;0;3.4;169;55
1071;For the Moment;109823;0;0;0;0;0;0;0;0;0;0;0;0;0
1073;Willy Wonka & the Chocolate Factory;67992;7.5;29;26;3;89;0;0;0;0;0;0;0;0
1076;The Innocents;55018;7.9;24;23;1;95;0;4;3;1;75;4;2095;85
1077;Sleeper;70707;8;28;28;0;100;0;4;4;0;100;3.7;6718;80
1078;Bananas;66808;7;18;16;2;88;0;1;1;0;100;3.6;4533;73
1079;A Fish Called Wanda;95159;8;46;44;2;95;7.8;8;7;1;87;3.4;15157;77
1080;Life of Brian;79470;8.2;53;51;2;96;7.9;13;12;1;92;3.9;40453;91
1081;Victor Victoria;84865;8;17;16;1;94;0;1;1;0;100;3.7;3624;82
1082;The Manchurian Candidate;56218;8.6;48;47;1;97;7.5;6;5;1;83;3.9;6006;89
1083;The Great Race;59243;6.1;20;15;5;75;0;2;2;0;100;3.8;2175;81
1084;Bonnie and Clyde;61418;8.1;46;41;5;89;6;7;4;3;57;3.7;12684;84
1085;The Old Man and the Sea;52027;6.4;8;7;1;87;0;0;0;0;0;0;0;0
1086;Dial M for Murder;46912;7.2;26;21;5;80;6.8;6;5;1;83;3.9;9307;88
1087;M. Butterfly;107468;0;0;0;0;0;0;0;0;0;0;0;0;0
1088;Dirty Dancing;92890;5.8;43;29;14;67;5.8;6;4;2;66;3.7;185439;88
1089;Reservoir Dogs;105236;8.9;45;43;2;95;8.5;12;11;1;91;4.1;125757;93
1090;Platoon;91763;7.8;42;36;6;85;6.8;10;7;3;70;3.9;49655;91
1091;Weekend at Bernie's;98627;4.9;21;10;11;47;0;1;0;1;0;3;6596;57
1092;Basic Instinct;103772;6;42;25;17;59;5.7;10;6;4;60;3.1;14326;64
1093;The Doors;101761;5.8;44;25;19;56;4.1;9;2;7;22;3.6;14440;80
1094;The Crying Game;104036;8.5;38;38;0;100;9.4;6;6;0;100;3.5;5761;76
1095;Glengarry Glen Ross;104348;8.5;41;40;1;97;0;4;4;0;100;3.9;9083;87
1096;Sophie's Choice;84707;7.1;26;21;5;80;6.6;5;3;2;60;3.9;5468;87
1097;E.T.: The Extra-Terrestrial;83866;8.9;89;87;2;97;8.6;18;17;1;94;3.5;154405;65
1098;The Search for One-eye Jimmy;117577;0;0;0;0;0;0;0;0;0;0;0;0;0
1099;A Christmas Carol;87056;0;0;0;0;0;0;0;0;0;0;0;0;0
1100;Days of Thunder;99371;4.6;43;17;26;39;5.6;8;5;3;62;3;14585;59
1101;Top Gun;92099;0;0;0;0;0;0;0;0;0;0;0;0;0
1102;American Strays;115531;0;0;0;0;0;0;0;0;0;0;0;0;0
1103;Rebel Without a Cause;48545;8.2;41;39;2;95;7.7;5;5;0;100;3.9;14558;87
1104;A Streetcar Named Desire;44081;8.5;46;45;1;97;8.5;5;5;0;100;3.9;13151;88
1105;Children of the Corn: The Gathering;115885;0;1;0;1;0;0;0;0;0;0;0;0;0
1107;Loser;217630;4.2;94;23;71;24;4.5;26;9;17;34;2.6;5745;37
1111;Microcosmos: Le peuple de l'herbe;117040;8;29;28;1;96;9.3;5;5;0;100;4;1418;89
1112;Palookaville;117284;6.2;11;7;4;63;0;3;3;0;100;3.3;334;58
1113;The Associate;115580;5.1;17;4;13;23;6.2;7;3;4;42;2.9;1259;52
1114;The Funeral;116378;7;24;20;4;83;7.6;5;5;0;100;3.4;1110;65
1115;Sleepover;368975;3.7;95;14;81;14;3.9;29;5;24;17;3.3;29842;62
1116;La fille seule;113057;6.8;7;5;2;71;0;0;0;0;0;0;0;0
1117;Le huitième jour;116581;6.8;6;4;2;66;0;3;1;2;33;4;1377;86
1119;Punch-Drunk Love;272338;7.4;179;141;38;78;7.4;36;29;7;80;3.2;24379;72
1120;The People vs. Larry Flynt;117318;7.7;53;46;7;86;7.7;15;13;2;86;3.3;7206;73
1121;Glory Daze;116422;0;4;0;4;0;0;0;0;0;0;0;0;0
1123;A Perfect Candidate;117320;6.9;16;14;2;87;7.5;8;7;1;87;3.2;252;66
1124;On Golden Pond;82846;7.5;21;19;2;90;0;4;3;1;75;3.7;4024;84
1125;The Return of the Pink Panther;72081;6.6;16;14;2;87;0;0;0;0;0;0;0;0
1126;Drop Dead Fred;101775;2.7;12;1;11;8;0;1;0;1;0;3.1;20039;72
1127;The Abyss;96754;7.2;43;38;5;88;6.5;6;4;2;66;3.5;17381;78
1128;The Fog;432291;2.7;66;3;63;4;2.8;11;0;11;0;2.5;14642;35
1129;Escape from New York;82340;6.8;45;37;8;82;0;4;2;2;50;3.4;15629;72
1130;The Howling;82533;6.1;25;15;10;60;0;1;0;1;0;3.2;4849;61
1131;Jean de Florette;91288;8;19;19;0;100;0;3;3;0;100;4.2;3691;94
1132;Manon des sources;91480;8.9;13;13;0;100;0;2;2;0;100;4.2;2871;91
1133;Kinsey;362269;7.6;187;168;19;89;7.9;39;36;3;92;3.4;6162;72
1135;Private Benjamin;81375;6.7;22;19;3;86;0;1;1;0;100;3;3377;57
1136;Monty Python and the Holy Grail;71853;7.8;51;48;3;94;7.1;13;12;1;92;4.1;94032;94
1137;Hustler White;116587;0;2;1;1;50;0;0;0;0;0;0;0;0
1138;Dadetown;112777;0;4;3;1;75;0;3;2;1;66;0;0;0
1139;Everything Relative;116245;4.9;8;2;6;25;0;4;1;3;25;3.2;49;50
1140;Entertaining Angels: The Dorothy Day Story;116212;4.8;6;3;3;50;0;1;0;1;0;3.7;176;67
1142;Get Over It;192071;5.1;62;28;34;45;5.4;18;9;9;50;2.9;9761;51
1143;Trois vies & une seule mort;117968;6.3;9;5;4;55;0;2;1;1;50;4;162;80
1144;The Line King: The Al Hirschfeld Story;116886;0;2;2;0;100;0;0;0;0;0;0;0;0
1146;Curtis's Charm;112759;\N;\N;\N;\N;\N;\N;\N;\N;\N;\N;\N;\N;\N
1147;When We Were Kings;118147;8.4;42;41;1;97;8.1;12;12;0;100;4.1;2489;91
1148;Wallace & Gromit in The Wrong Trousers;108598;9.1;24;24;0;100;0;0;0;0;0;0;0;0
1149;JLG/JLG - autoportrait de décembre;110173;\N;\N;\N;\N;\N;\N;\N;\N;\N;\N;\N;\N;\N
1150;Le retour de Martin Guerre;84589;8;9;9;0;100;0;0;0;0;0;0;0;0
1151;Faust: Love of the Damned;223268;0;3;1;2;33;0;0;0;0;0;0;0;0
1152;He Walked by Night;40427;7.6;6;5;1;83;0;0;0;0;0;0;0;0
1153;Raw Deal;91828;3.8;12;3;9;25;0;1;0;1;0;2.7;3041;32
1154;T-Men;39881;7.8;6;6;0;100;0;0;0;0;0;0;0;0
1156;I bambini ci guardano;34493;0;2;2;0;100;0;0;0;0;0;0;0;0
1157;La symphonie pastorale;39004;0;0;0;0;0;0;0;0;0;0;0;0;0
1161;Die Blechtrommel;78875;7.3;12;9;3;75;0;1;0;1;0;4;2140;86
1162;The Ruling Class;69198;7.2;11;9;2;81;0;1;0;1;0;3.9;956;85
1163;Mina Tannenbaum;110521;0;2;2;0;100;0;0;0;0;0;0;0;0
1164;2 ou 3 choses que je sais d'elle;60304;8;29;27;2;93;7.6;8;7;1;87;3.8;1050;73
1167;Dear God;116059;3.6;33;4;29;12;3.2;10;0;10;0;2.6;883;26
1168;Bad Moon;115610;3.3;5;1;4;20;0;1;0;1;0;2.8;1122;41
1169;Hollywoodism: Jews, Movies and the American Dream;141163;\N;\N;\N;\N;\N;\N;\N;\N;\N;\N;\N;\N;\N
1170;Best of the Best 3: No Turning Back;112483;0;0;0;0;0;0;0;0;0;0;0;0;0
1171;Bob Roberts;103850;7.5;34;34;0;100;7.4;7;7;0;100;3.5;1689;70
1172;Nuovo Cinema Paradiso;95765;7.9;56;50;6;89;7.8;15;13;2;86;4.4;21396;96
1173;The Cook the Thief His Wife & Her Lover;97108;7.3;37;33;4;89;8;7;6;1;85;3.9;5208;88
1174;Grosse fatigue;109942;6.8;6;3;3;50;0;2;1;1;50;3.3;124;60
1175;Delicatessen;101700;7.6;39;34;5;87;5.4;6;3;3;50;4.1;14805;91
1176;La double vie de Véronique;101765;7.6;25;21;4;84;7.6;5;5;0;100;4.3;5676;92
1177;Enchanted April;101811;7.2;19;17;2;89;0;2;2;0;100;3.9;2525;80
1178;Paths of Glory;50825;8.6;39;36;3;92;7.1;7;5;2;71;0;0;0
1179;The Grifters;99703;7.9;38;34;4;89;7.1;8;6;2;75;3.4;2730;69
1180;Hear My Song;102014;7.1;12;11;1;91;0;2;2;0;100;3.7;154;74
1183;The English Patient;116209;7.7;58;48;10;82;7.8;17;15;2;88;3.6;22977;82
1184;Mediterraneo;102426;6.3;13;10;3;76;0;1;0;1;0;4.1;1443;91
1185;My Left Foot: The Story of Christy Brown;97937;8.2;30;30;0;100;8.1;5;5;0;100;3.9;5875;90
1186;Sex, Lies, and Videotape;98724;7.9;34;33;1;97;8;5;5;0;100;3.3;5946;73
1187;Passion Fish;105107;7.8;22;22;0;100;0;3;3;0;100;3.6;614;79
1188;Strictly Ballroom;105488;0;0;0;0;0;0;0;0;0;0;0;0;0
1189;The Thin Blue Line;96257;8.7;11;11;0;100;0;1;1;0;100;4;1805;89
1190;Átame!;101026;6.5;23;17;6;73;0;4;1;3;25;3.7;4683;79
1191;Madonna: Truth or Dare;102370;6.1;16;12;4;75;0;2;2;0;100;3.2;2102;62
1192;Paris Is Burning;100332;7.4;9;9;0;100;0;2;2;0;100;4;878;82
1193;One Flew Over the Cuckoo's Nest;73486;8.8;50;48;2;96;6.3;6;4;2;66;4.2;61369;95
1194;Up in Smoke;78446;5.1;16;7;9;43;0;2;0;2;0;3.6;11888;81
1196;Star Wars: Episode V - The Empire Strikes Back;80684;8.6;71;69;2;97;7.5;17;15;2;88;4.1;146071;94
1197;The Princess Bride;93779;8.2;44;42;2;95;7.4;7;6;1;85;4;116640;92
1198;Raiders of the Lost Ark;82971;0;0;0;0;0;0;0;0;0;0;0;0;0
1199;Brazil;88846;8.6;40;39;1;97;7.2;8;7;1;87;4.1;35162;89
1200;Aliens;90605;8.8;47;47;0;100;8;7;7;0;100;3.8;72406;90
1201;Il buono, il brutto, il cattivo.;60196;8.7;62;61;1;98;8;11;10;1;90;4;40790;93
1202;Withnail & I;94336;8.3;28;26;2;92;0;1;1;0;100;4.4;11574;95
1203;12 Angry Men;50083;8.8;36;36;0;100;0;4;4;0;100;4.1;22784;95
1204;Lawrence of Arabia;56172;8.8;56;55;1;98;8.3;15;14;1;93;4.1;22451;91
1206;A Clockwork Orange;66921;0;0;0;0;0;0;0;0;0;0;0;0;0
1207;To Kill a Mockingbird;56592;8.8;39;38;1;97;0;3;3;0;100;3.8;19861;91
1208;Apocalypse Now;78788;8.8;61;60;1;98;8.4;11;10;1;90;4.1;67647;93
1209;C'era una volta il West;64116;9;48;47;1;97;7.2;5;4;1;80;4.3;18310;94
1210;Star Wars: Episode VI - Return of the Jedi;86190;6.7;63;49;14;77;6.4;17;13;4;76;4;137818;93
1211;Der Himmel über Berlin;93191;8.5;39;38;1;97;7.5;6;5;1;83;4.4;9110;94
1212;The Third Man;41959;9.1;57;57;0;100;8.2;14;14;0;100;4.3;13251;94
1213;Goodfellas;99685;8.8;58;56;2;96;7.8;10;9;1;90;4.3;124589;96
1214;Alien;78748;0;0;0;0;0;0;0;0;0;0;0;0;0
1215;Army of Darkness;106308;6.9;37;27;10;72;0;4;2;2;50;3.8;33240;85
1216;Le grand bleu;95250;5.8;12;8;4;66;0;2;0;2;0;4.1;10653;92
1217;Ran;89881;8.7;56;54;2;96;8.5;11;11;0;100;4.3;9990;94
1218;Dip huet seung hung;97202;8.6;31;31;0;100;0;4;4;0;100;4;6079;91
1219;Psycho;54215;8.9;67;66;1;98;7.5;8;7;1;87;3.9;32475;90
1220;The Blues Brothers;80455;6.9;45;38;7;84;4.8;5;2;3;40;3.7;29786;89
1221;The Godfather: Part II;71562;9.2;55;54;1;98;7.3;6;5;1;83;4.3;106035;96
1222;Full Metal Jacket;93058;8.2;55;53;2;96;7.7;8;7;1;87;4;77926;93
1223;A Grand Day Out with Wallace and Gromit;104361;8.3;19;19;0;100;0;0;0;0;0;0;0;0
1224;Henry V;97499;8.2;32;32;0;100;7.8;7;7;0;100;4;3619;87
1225;Amadeus;86879;8.6;69;66;3;95;8.1;12;11;1;91;3.9;24420;94
1226;The Quiet Man;45061;8;34;31;3;91;0;4;4;0;100;4.1;6203;91
1227;Once Upon a Time in America;87843;8.4;29;27;2;93;0;4;3;1;75;4.2;25390;92
1228;Raging Bull;81398;9;54;53;1;98;8.1;9;8;1;88;4.1;33528;92
1230;Annie Hall;75686;8.8;46;45;1;97;8.2;5;5;0;100;3.9;27350;92
1231;The Right Stuff;86197;8.6;30;29;1;96;0;1;1;0;100;3.9;5615;87
1232;Stalker;79944;8.2;16;16;0;100;0;2;2;0;100;4.5;6877;95
1233;Das Boot;82096;9;36;36;0;100;8.5;5;5;0;100;4.1;11718;94
1234;The Sting;70735;8.1;45;41;4;91;6.9;5;4;1;80;4.1;16187;93
1235;Harold and Maude;67185;7.6;38;32;6;84;0;4;0;4;0;4.2;15115;93
1236;Trust the Man;427968;4.6;100;27;73;27;4.5;25;3;22;12;2.9;11451;38
1237;Det sjunde inseglet;50976;9;46;43;3;93;0;4;3;1;75;4.3;12987;94
1238;Local Hero;85859;8.8;30;30;0;100;0;4;4;0;100;4.1;2127;87
1240;Terminator Salvation;438488;5;251;80;171;31;4.9;35;10;25;28;3.4;267474;64
1241;Braindead;103873;7.4;20;17;3;85;0;1;1;0;100;3.8;16839;84
1242;Glory;97441;7.9;40;37;3;92;7.4;9;8;1;88;4;13978;92
1243;Rosencrantz & Guildenstern Are Dead;100519;6.3;27;18;9;66;0;4;0;4;0;4;4144;89
1244;Manhattan;79522;8.6;43;42;1;97;8.5;6;6;0;100;4.1;14496;92
1245;Miller's Crossing;100150;8;51;46;5;90;6.9;9;7;2;77;4;14665;90
1246;Dead Poets Society;97165;7.2;49;42;7;85;6.5;7;5;2;71;3.8;56733;90
1247;The Graduate;61722;8;44;39;5;88;6.7;6;5;1;83;3.7;22493;90
1248;Touch of Evil;52311;0;0;0;0;0;0;0;0;0;0;0;0;0
1249;La Femme Nikita;118379;\N;\N;\N;\N;\N;\N;\N;\N;\N;\N;\N;\N;\N
1250;The Bridge on the River Kwai;50212;8.8;43;41;2;95;7.9;6;5;1;83;3.9;10774;90
1251;8½;56801;8.4;34;33;1;97;7.5;9;8;1;88;4.3;12375;92
1252;Chinatown;71315;9.3;47;47;0;100;8.8;6;6;0;100;4.2;22995;92
1253;The Day the Earth Stood Still;43456;8;50;47;3;94;7;5;4;1;80;3.8;8999;86
1254;The Treasure of the Sierra Madre;40897;9;38;38;0;100;8.5;5;5;0;100;4.1;6732;90
1255;Bad Taste;92610;6.4;20;14;6;70;0;0;0;0;0;0;0;0
1256;Duck Soup;23969;8.9;35;33;2;94;0;4;3;1;75;4.1;7416;91
1257;Better Off Dead...;88794;7;21;17;4;80;0;1;1;0;100;3.7;11561;86
1258;The Shining;81505;7.8;45;39;6;86;5.4;6;3;3;50;4;91362;91
1259;Stand by Me;92005;7.8;34;32;2;94;0;2;2;0;100;0;0;0
1260;M;22100;9;40;40;0;100;8.4;8;8;0;100;4.3;9191;94
1261;Evil Dead II;92991;7.8;42;41;1;97;6.6;6;5;1;83;3.8;30657;86
1262;The Great Escape;57115;0;0;0;0;0;0;0;0;0;0;0;0;0
1263;The Deer Hunter;77416;8.3;44;40;4;90;7.1;5;4;1;80;4.1;27513;91
1264;Diva;82269;8.1;41;39;2;95;8;14;13;1;92;4;1807;86
1265;Groundhog Day;107048;7.9;52;50;2;96;7.5;10;10;0;100;3.3;34921;79
1266;Unforgiven;105695;8.5;56;54;2;96;7.5;11;9;2;81;4;27203;91
1267;The Manchurian Candidate;56218;8.6;48;47;1;97;7.5;6;5;1;83;3.9;6006;89
1268;Pump Up the Volume;100436;6.7;31;25;6;80;0;3;2;1;66;3.4;5356;79
1269;Arsenic and Old Lace;36613;7.6;21;19;2;90;0;3;2;1;66;4;9161;91
1270;Back to the Future;88763;8.4;54;52;2;96;7.3;6;5;1;83;3.8;126816;88
1271;Fried Green Tomatoes;101921;6.5;22;18;4;81;0;3;3;0;100;3.7;24457;88
1272;Patton;66206;8.2;36;35;1;97;8.3;6;5;1;83;4;8522;93
1273;Down by Law;90967;7.4;24;21;3;87;6.1;6;4;2;66;4.3;6805;94
1274;Akira;94625;7.3;34;30;4;88;6.9;6;5;1;83;4;33398;89
1275;Highlander;91203;5.9;29;19;10;65;0;2;1;1;50;3.5;18748;78
1276;Cool Hand Luke;61512;8.8;44;44;0;100;8.5;6;6;0;100;4.1;17521;93
1277;Cyrano de Bergerac;42367;6.9;12;10;2;83;0;3;1;2;33;3.8;668;81
1278;Young Frankenstein;72431;8.5;46;43;3;93;0;4;4;0;100;3.8;37773;91
1279;Night on Earth;102536;6.3;16;13;3;81;0;2;2;0;100;4;5592;91
1280;Da hong deng long gao gao gua;101640;8.4;24;23;1;95;7.6;9;8;1;88;4.1;5193;92
1281;The Great Dictator;32553;8.9;34;32;2;94;8.8;7;6;1;85;4.2;16082;93
1282;Fantasia;32455;8.5;42;41;1;97;8.3;6;6;0;100;3.5;12184;77
1283;High Noon;44706;8.8;41;39;2;95;8.5;5;5;0;100;3.9;6074;87
1284;The Big Sleep;38355;8.6;43;41;2;95;7.5;8;7;1;87;4.1;7772;91
1285;Heathers;97493;7.8;41;39;2;95;7;9;7;2;77;3.7;17025;82
1286;Somewhere in Time;81534;5.8;16;10;6;62;0;4;1;3;25;3.9;7602;88
1287;Ben-Hur;52618;7.8;33;30;3;90;0;4;3;1;75;3.7;25817;80
1288;This Is Spinal Tap;88258;8.6;53;51;2;96;7.7;7;6;1;85;3.9;23608;91
1289;Koyaanisqatsi;85809;8;18;16;2;88;0;1;1;0;100;4.3;4109;91
1290;Some Kind of Wonderful;94006;6.4;33;26;7;78;5.8;6;4;2;66;3.5;7505;78
1291;Indiana Jones and the Last Crusade;97576;7.9;54;48;6;88;6.5;7;5;2;71;3.9;103952;91
1292;Being There;78841;8.4;38;36;2;94;0;4;4;0;100;4.1;6371;91
1293;Gandhi;83987;7.7;40;34;6;85;6.9;5;4;1;80;3.9;10562;91
1295;The Unbearable Lightness of Being;96332;8.3;17;16;1;94;0;2;1;1;50;3.9;5178;84
1296;A Room with a View;91867;8.6;21;21;0;100;0;2;2;0;100;3.9;6394;85
1297;Real Genius;89886;6.5;23;17;6;73;0;4;2;2;50;3.5;6720;78
1298;Pink Floyd The Wall;84503;6.5;17;11;6;64;0;0;0;0;0;0;0;0
1299;The Killing Fields;87553;8.1;33;30;3;90;5.8;6;3;3;50;4;6389;89
1300;Mitt liv som hund;89606;7.9;28;28;0;100;0;3;3;0;100;4.1;2751;88
1301;Forbidden Planet;49223;8.1;36;35;1;97;0;2;2;0;100;3.8;4780;82
1302;Field of Dreams;97351;7.7;45;41;4;91;5.9;8;5;3;62;3.4;16498;85
1303;The Man Who Would Be King;73341;8.6;20;19;1;95;0;4;3;1;75;4;3790;88
1304;Butch Cassidy and the Sundance Kid;64115;8.1;42;38;4;90;6.5;5;3;2;60;3.9;17396;90
1305;Paris, Texas;87884;8.2;25;25;0;100;0;1;1;0;100;4.2;6389;93
1306;Bis ans Ende der Welt;101458;6.5;12;10;2;83;0;1;0;1;0;4.1;1508;87
1307;When Harry Met Sally...;98635;7.8;47;43;4;91;6.2;8;6;2;75;3.5;47834;83
1310;Hype!;116589;7.5;6;6;0;100;0;2;2;0;100;3.9;430;85
1311;Santa with Muscles;117550;0;3;0;3;0;0;0;0;0;0;0;0;0
1312;Female Perversions;116293;6.3;21;14;7;66;6.8;9;7;2;77;3.1;264;48
1313;Mad Dog Time;116953;2.9;6;1;5;16;0;2;0;2;0;2.9;429;48
1314;Breathing Room;1220706;0;0;0;0;0;0;0;0;0;0;0;0;0
1317;I'm Not Rappaport;116601;5.6;15;5;10;33;0;4;1;3;25;3.4;285;61
1318;Blue Juice;112537;0;2;0;2;0;0;1;0;1;0;3;1487;46
1320;Alien³;103644;5;39;15;24;38;5.8;7;4;3;57;3.1;30526;55
1321;An American Werewolf in London;82010;7.5;43;38;5;88;0;4;2;2;50;3.4;18421;76
1322;Amityville 1992: It's About Time;103678;2.3;7;1;6;14;0;0;0;0;0;0;0;0
1323;Amityville 3-D;85159;2.9;15;0;15;0;0;2;0;2;0;2.7;2070;32
1324;Amityville: Dollhouse;115535;0;2;0;2;0;0;0;0;0;0;0;0;0
1325;Amityville: A New Generation;106262;0;1;0;1;0;0;0;0;0;0;0;0;0
1326;Amityville II: The Possession;83550;2.7;14;1;13;7;0;1;0;1;0;2.9;3306;47
1327;The Amityville Horror;384806;4.2;155;37;118;23;3.9;33;7;26;21;3.2;31070;64
1328;The Amityville Curse;99030;3.6;5;1;4;20;0;0;0;0;0;0;0;0
1329;Blood for Dracula;71233;6.4;15;10;5;66;0;2;1;1;50;3.4;1432;58
1330;April Fool's Day;1018817;0;3;0;3;0;0;0;0;0;0;0;0;0
1331;Audrey Rose;75704;5.4;9;5;4;55;0;0;0;0;0;0;0;0
1332;Believers;878652;0;3;0;3;0;0;0;0;0;0;0;0;0
1333;The Birds;56869;8;40;38;2;95;0;4;2;2;50;3.5;17449;80
1334;The Blob;94761;5.6;16;9;7;56;0;0;0;0;0;0;0;0
1335;Blood Beach;82083;2.6;6;0;6;0;0;0;0;0;0;0;0;0
1336;Body Parts;101492;4.4;15;6;9;40;0;1;0;1;0;2.6;958;31
1337;Invasion of the Body Snatchers;49366;8.9;36;36;0;100;0;2;2;0;100;3.6;3820;81
1339;Dracula;21814;7.7;42;39;3;92;7.7;6;6;0;100;3.6;8598;76
1340;Bride of Frankenstein;26138;8.9;39;39;0;100;8.6;6;6;0;100;3.7;4867;82
1341;Burnt Offerings;74258;5.2;8;3;5;37;0;1;0;1;0;3.1;927;45
1342;Candyman;103919;6.3;37;27;10;72;5.4;5;3;2;60;3;12889;58
1343;Cape Fear;101540;6.9;38;29;9;76;8.3;6;6;0;100;3.4;13943;74
1344;Cape Fear;101540;6.9;38;29;9;76;8.3;6;6;0;100;3.4;13943;74
1345;Carrie;74285;8;42;38;4;90;6.4;7;4;3;57;3.3;23161;70
1346;Cat People;83722;6.1;36;23;13;63;0;3;2;1;66;3;2400;46
1347;A Nightmare on Elm Street;87800;7.7;40;38;2;95;0;4;4;0;100;3.5;57452;78
1348;Nosferatu, eine Symphonie des Grauens;13442;8.9;47;46;1;97;8.2;5;5;0;100;3.9;11264;86
1349;Nosferatu a Venezia;91651;0;0;0;0;0;0;0;0;0;0;0;0;0
1350;The Omen;75005;7;32;27;5;84;0;2;1;1;50;3.5;17016;78
1351;Blood and Wine;115710;6.1;31;19;12;61;6.5;9;6;3;66;3;951;36
1352;Albino Alligator;115495;5.5;17;8;9;47;5.4;6;2;4;33;3;1198;42
1353;The Mirror Has Two Faces;117057;5.3;28;15;13;53;0;4;1;3;25;3.5;2549;72
1354;Breaking the Waves;115751;8;42;36;6;85;7.8;7;6;1;85;4.1;7949;91
1355;Nochnoy dozor;403358;5.9;125;73;52;58;5.9;30;17;13;56;3.3;19774;70
1356;Star Trek: First Contact;117731;7.4;52;48;4;92;7.4;13;12;1;92;3.5;20013;84
1357;Shine;117631;8;31;28;3;90;8.8;7;7;0;100;3.8;6087;89
1358;Sling Blade;117666;8.3;49;47;2;95;7.9;16;14;2;87;3.9;10557;91
1359;Jingle All the Way;116705;4;38;6;32;15;5.3;6;1;5;16;2.6;10937;42
1361;Paradise Lost: The Child Murders at Robin Hood Hills;117293;8.2;24;23;1;95;0;3;3;0;100;4.1;1701;90
1363;The Preacher's Wife;117372;5.8;38;23;15;60;7.2;11;8;3;72;2.9;3793;54
1364;Kjærlighetens kjøtere;113557;0;0;0;0;0;0;0;0;0;0;0;0;0
1365;Ridicule;117477;7.3;17;13;4;76;8.2;5;5;0;100;3.8;979;83
1366;The Crucible;115988;7.2;26;20;6;76;8.3;6;4;2;66;3.2;4752;64
1367;One Hundred and One Dalmatians;55254;8;37;36;1;97;7.6;5;5;0;100;3.3;29711;63
1369;J'ai pas sommeil;110171;7.5;7;5;2;71;0;2;1;1;50;3.4;283;70
1370;Die Hard;95016;8.1;50;47;3;94;6.2;9;6;3;66;3.9;99625;91
1371;Star Trek: The Motion Picture;79945;5.8;31;15;16;48;4.8;5;2;3;40;3.1;14598;48
1372;Star Trek VI: The Undiscovered Country;102975;6.8;46;38;8;82;7.1;6;5;1;83;3.5;13463;77
1373;Star Trek V: The Final Frontier;98382;4;41;9;32;21;3.4;7;0;7;0;2.8;11133;37
1374;Star Trek: The Wrath of Khan;84726;7.8;40;36;4;90;7.1;6;5;1;83;3.7;18490;86
1375;Star Trek III: The Search for Spock;88170;6.4;38;29;9;76;6.4;6;5;1;83;3.3;13649;60
1376;Star Trek IV: The Voyage Home;92007;6.8;37;31;6;83;6.2;7;5;2;71;3.5;14361;77
1377;Batman Returns;103776;6.5;46;36;10;78;5.8;9;6;3;66;3.3;65412;68
1378;Young Guns;96487;4.6;25;10;15;40;0;3;1;2;33;3.5;11858;77
1379;Young Guns II;100994;4.9;16;6;10;37;0;2;0;2;0;3.2;7476;67
1380;Grease;77631;6.7;54;45;9;83;5.9;11;9;2;81;3.7;176349;85
1381;Grease;77631;6.7;54;45;9;83;5.9;11;9;2;81;3.7;176349;85
1382;Marked for Death;100114;3.2;9;2;7;22;0;0;0;0;0;0;0;0
1383;Adrenalin: Fear the Rush;115471;1.4;5;0;5;0;0;1;0;1;0;2.7;684;30
1384;The Substance of Fire;117773;6.1;10;6;4;60;0;3;1;2;33;3;189;26
1385;Under Siege;105690;6.2;23;17;6;73;0;3;2;1;66;3;9661;60
1386;Terror in a Texas Town;52287;0;3;3;0;100;0;0;0;0;0;0;0;0
1387;Jaws;73195;8.8;37;37;0;100;8.5;5;5;0;100;3.5;63534;81
1388;Jaws;73195;8.8;37;37;0;100;8.5;5;5;0;100;3.5;63534;81
1389;Jaws 3-D;85750;2.9;24;3;21;12;0;2;0;2;0;2.5;15576;33
1390;My Fellow Americans;117119;5.2;38;19;19;50;4.6;14;4;10;28;3.2;1831;61
1391;Mars Attacks!;116996;5.8;56;28;28;50;5.4;15;6;9;40;2.8;24991;49
1392;Citizen Ruth;115906;6.8;24;19;5;79;6;5;3;2;60;3.5;998;72
1393;Jerry Maguire;116695;7.4;57;48;9;84;7.5;19;17;2;89;3.3;32601;72
1394;Raising Arizona;93822;7.6;49;44;5;89;5.5;6;3;3;50;3.6;19379;82
1395;Tin Men;94155;6.4;19;15;4;78;0;1;1;0;100;3.1;778;54
1396;Sneakers;105435;6.8;45;36;9;80;6.4;7;5;2;71;3.4;6830;77
1397;Bastard Out of Carolina;115633;7.1;9;9;0;100;0;0;0;0;0;0;0;0
1398;In Love and War;116621;4.1;26;3;23;11;3.4;6;0;6;0;3;2942;52
1399;Marvin's Room;116999;6.7;47;38;9;80;6;13;9;4;69;3.2;4558;58
1401;Ghosts of Mississippi;116410;5.8;26;13;13;50;6.4;7;3;4;42;3.4;1916;64
1404;Night Falls on Manhattan;119783;6.7;26;17;9;65;8;5;4;1;80;3.2;471;49
1405;Beavis and Butt-Head Do America;115641;6.2;51;36;15;70;6.4;12;8;4;66;3;19512;61
1406;La cérémonie;112769;7.7;27;25;2;92;7.4;12;11;1;91;3.9;747;85
1407;Scream;117571;7;53;43;10;81;6.6;14;10;4;71;3.2;50339;70
1408;The Last of the Mohicans;104691;8;32;31;1;96;7.9;7;7;0;100;3.6;34073;84
1409;Michael Clayton;465538;7.6;192;173;19;90;7.9;37;35;2;94;3.6;123924;72
1410;The Evening Star;116240;4.2;25;6;19;24;4.2;6;1;5;16;3.2;1029;59
1411;Hamlet;116477;8.2;54;51;3;94;7.2;14;11;3;78;3.8;5816;86
1412;Some Mother's Son;117690;6.3;15;10;5;66;6.8;6;3;3;50;4;520;86
1413;The Whole Wide World;118163;6.9;15;12;3;80;0;4;3;1;75;3.6;707;73
1414;The Mother;323298;7;88;68;20;77;7.4;32;29;3;90;3.4;862;61
1415;Les voleurs;118100;7;11;9;2;81;0;4;4;0;100;3.4;257;64
1416;Evita;116250;6.5;31;19;12;61;6.4;6;4;2;66;3.1;8855;65
1417;The Portrait of a Lady;117364;5.5;28;12;16;42;6.2;6;3;3;50;3.2;2438;50
1419;Walkabout;67959;8.1;26;24;2;92;0;3;3;0;100;3.9;1862;86
1420;Message to Love: The Isle of Wight Festival;117028;0;0;0;0;0;0;0;0;0;0;0;0;0
1421;The Grateful Dead;76104;0;0;0;0;0;0;0;0;0;0;0;0;0
1422;Murder at 1600;119731;5;30;10;20;33;5.3;6;1;5;16;2.9;4012;48
1423;Hearts and Minds;71604;0;0;0;0;0;0;0;0;0;0;0;0;0
1425;Fierce Creatures;119115;5.6;31;17;14;54;5.6;5;1;4;20;3.1;3023;56
1426;Zeus and Roxanne;120550;4.4;7;3;4;42;0;1;0;1;0;2.9;1549;47
1427;Turbulence;120390;3.2;18;3;15;16;0;4;0;4;0;2.5;718;23
1428;Angel Baby;112362;\N;\N;\N;\N;\N;\N;\N;\N;\N;\N;\N;\N;\N
1429;Ging chaat goo si 4: Ji gaan daan yam mo;116704;6;21;11;10;52;0;4;2;2;50;3;4216;55
1430;Underworld;320691;4.7;155;47;108;30;4.4;32;5;27;15;3.6;101467;82
1431;Beverly Hills Ninja;118708;3.2;28;4;24;14;4.6;8;3;5;37;2.8;13679;54
1432;Metro;119664;4;33;5;28;15;3.6;9;1;8;11;2.6;2757;31
1433;The Time Machine;268695;4.8;146;41;105;28;5;32;6;26;18;2.7;10389;45
1434;The Strangers;482606;5;146;65;81;44;4.8;26;13;13;50;3.1;55773;48
1437;The Cement Garden;106535;0;0;0;0;0;0;0;0;0;0;0;0;0
1438;Dante's Peak;118928;4.9;25;7;18;28;4.8;7;0;7;0;2.7;20021;45
1439;Meet Wally Sparks;119644;2.5;14;2;12;14;0;2;1;1;50;2.6;586;32
1440;Amos & Andrew;106266;4;23;5;18;21;3.9;8;1;7;12;2.7;1624;36
1441;Benny & Joon;106387;5.7;30;22;8;73;5.1;8;4;4;50;3.6;28905;85
1442;Prefontaine;119937;6.4;26;16;10;61;6.7;9;5;4;55;3.7;1530;79
1444;Guantanamera;109949;6.9;9;7;2;77;0;3;2;1;66;3.5;310;69
1445;McHale's Navy;119640;2.2;29;1;28;3;1.7;7;0;7;0;2.6;1386;36
1446;Kolja;116790;7.8;22;21;1;95;8.8;6;6;0;100;4.2;2011;91
1447;Gridlock'd;119225;6.8;31;27;4;87;7.1;10;9;1;90;3.6;2054;79
1449;Waiting for Guffman;118111;7.7;53;48;5;90;7.2;11;9;2;81;3.9;8495;90
1450;Kavkazskiy plennik;116754;7.2;23;20;3;86;8.3;8;8;0;100;3.9;356;85
1453;The Beautician and the Beast;118691;4.6;18;3;15;16;4.7;6;1;5;16;2.4;2687;43
1454;SubUrbia;120238;6.3;21;13;8;61;6.4;6;3;3;50;3.3;1247;66
1455;Hotel de Love;116565;5.1;8;2;6;25;0;3;0;3;0;3.7;121;67
1456;The Pest;119887;2.3;23;2;21;8;2.2;7;1;6;14;2.7;4963;63
1457;Fools Rush In;119141;4.8;27;9;18;33;5.1;7;2;5;28;3;9687;61
1458;Touch;120357;4.7;17;5;12;29;0;3;0;3;0;2.9;494;36
1459;Absolute Power;118548;5.5;41;19;22;46;6.2;10;5;5;50;3.2;6094;52
1460;That Darn Cat;120317;3.8;14;1;13;7;0;4;0;4;0;2.5;2029;30
1461;Vegas Vacation;120434;3.8;28;4;24;14;3.2;10;1;9;10;3;7915;55
1463;That Old Feeling;120318;5;15;6;9;40;0;4;2;2;50;3;901;57
1464;Lost Highway;116922;6.2;39;23;16;58;6;6;2;4;33;3.9;17451;87
1465;Rosewood;120036;7.1;47;40;7;85;7;11;8;3;72;3.7;1445;82
1466;Donnie Brasco;119008;7.8;54;47;7;87;7.1;16;12;4;75;3.7;40329;85
1468;Booty Call;118750;4.2;12;3;9;25;5.4;6;2;4;33;2.8;3264;56
1471;Boys Life 2;118762;6.7;5;4;1;80;0;2;2;0;100;3.3;79;64
1472;City of Industry;118859;5.2;13;6;7;46;4.7;6;1;5;16;2.9;791;31
1473;Children of Men;206634;8;208;193;15;92;7.8;41;37;4;90;3.7;127695;81
1474;Jungle 2 Jungle;119432;4;39;7;32;17;4.2;13;3;10;23;2.7;9218;44
1475;Kama Sutra: A Tale of Love;116743;5;18;7;11;38;5.9;5;2;3;40;3.5;1793;72
1476;Private Parts;119951;0;0;0;0;0;0;0;0;0;0;0;0;0
1477;Love Jones;119572;6.4;15;10;5;66;6.8;5;4;1;80;4.2;4854;96
1479;The Saint;120053;4.6;44;13;31;29;4.3;15;3;12;20;3.1;11647;62
1480;Smilla's Sense of Snow;120152;6;32;17;15;53;6.5;7;4;3;57;3.3;1224;59
1482;Van Helsing;338526;0;0;0;0;0;0;0;0;0;0;0;0;0
1483;Crash;375679;7.1;197;148;49;75;7.1;39;30;9;76;4;98746;89
1484;The Daytrippers;116041;6.4;22;16;6;72;0;4;3;1;75;3.5;621;67
1485;Liar Liar;119528;6.9;51;42;9;82;7.5;15;13;2;86;3.4;93496;72
1486;The Quiet Room;117422;0;4;3;1;75;0;0;0;0;0;0;0;0
1487;Selena;120094;6;38;24;14;63;6.2;9;6;3;66;3.2;17729;76
1488;The Devil's Own;118972;5.3;34;10;24;29;6.3;7;2;5;28;3;7624;46
1489;Cats Don't Dance;118829;6.5;15;10;5;66;0;4;3;1;75;3.5;2510;72
1490;B*A*P*S;118663;3;30;4;26;13;4.9;8;3;5;37;2.9;1372;57
1493;Love and Other Catastrophes;116931;5.5;13;6;7;46;0;3;0;3;0;3.8;270;75
1495;Turbo: A Power Rangers Movie;120389;3.8;17;3;14;17;3.8;8;2;6;25;2.7;1946;42
1496;Anna Karenina;26071;7.4;7;7;0;100;0;0;0;0;0;0;0;0
1497;Double Team;119013;3.8;19;2;17;10;4.8;5;0;5;0;2.2;4157;31
1498;Inventing the Abbotts;119381;5.4;25;8;17;32;5.4;7;2;5;28;3.2;2432;54
1499;Anaconda;118615;4.7;45;17;28;37;5.6;10;5;5;50;2.5;21526;32
1500;Grosse Pointe Blank;119229;7.1;57;44;13;77;6.5;15;11;4;73;3.7;17815;85
1501;Keys to Tulsa;116762;4.1;8;1;7;12;0;1;0;1;0;2.9;271;28
1502;KISS Meets the Phantom of the Park;77788;0;0;0;0;0;0;0;0;0;0;0;0;0
1503;8 Heads in a Duffel Bag;118541;3.3;18;2;16;11;0;4;0;4;0;2.6;2533;34
1504;Hollow Reed;113314;7.4;12;11;1;91;0;3;2;1;66;3.1;40;47
1507;Paradise Road;119859;6;20;10;10;50;5.8;7;2;5;28;3.6;918;75
1508;The Time Traveler's Wife;452694;5.1;151;56;95;37;4.8;34;10;24;29;2.9;189828;65
1509;Walk All Over Me;907680;0;4;2;2;50;0;1;0;1;0;3;609;37
1510;A Brother's Kiss;118783;0;4;4;0;100;0;2;2;0;100;2.9;289;44
1511;Shekvarebuli kulinaris ataserti retsepti;117050;6.4;10;6;4;60;0;3;1;2;33;3.5;32;50
1513;Romy and Michele's High School Reunion;120032;6.2;49;34;15;69;5.9;16;9;7;56;2.8;12541;60
1514;Feng yue;116295;6.4;13;8;5;61;6.2;5;2;3;40;3.5;585;67
1515;Volcano;120461;5;38;16;22;42;4.5;10;3;7;30;2.7;14505;43
1516;Children of the Revolution;115886;6.6;17;13;4;76;7;6;4;2;66;3.3;479;60
1517;Austin Powers: International Man of Mystery;118655;0;0;0;0;0;0;0;0;0;0;0;0;0
1518;Mujeres al borde de un ataque de nervios;95675;7.6;26;23;3;88;0;4;4;0;100;4;6254;88
1519;Broken English;772157;6.3;73;47;26;64;6.2;23;14;9;60;3.4;14630;61
1520;The Ten Commandments;49833;7.3;29;26;3;89;0;4;2;2;50;3.6;11440;83
1522;Ripe;117482;4;5;0;5;0;0;2;0;2;0;0;0;0
1523;Truth or Consequences, N.M.;120383;4.5;14;5;9;35;0;2;0;2;0;3.1;880;51
1525;Warriors of Virtue;120479;4;10;1;9;10;0;4;0;4;0;2.9;927;45
1526;Fathers' Day;119109;4;31;6;25;19;4.8;6;2;4;33;2.5;2603;31
1527;The Fifth Element;119116;6.3;53;38;15;71;5.2;10;4;6;40;3.7;84664;84
1528;Intimate Relations;116643;5.2;7;1;6;14;0;3;0;3;0;3.6;31;64
1529;Nirgendwo in Afrika;161860;7.5;97;83;14;85;7.6;30;25;5;83;4;1773;88
1531;Losing Chase;116920;0;4;2;2;50;0;0;0;0;0;0;0;0
1532;Sprung;120190;4.2;9;2;7;22;0;4;0;4;0;3.5;343;70
1533;La promesse;117398;7.7;19;18;1;94;7.7;8;8;0;100;3.9;599;85
1534;Le bonheur;58985;0;2;2;0;100;0;0;0;0;0;0;0;0
1535;Love! Valour! Compassion!;119578;6.1;20;13;7;65;6.5;7;5;2;71;3.6;899;70
1537;Shall we dansu?;117615;7.9;33;30;3;90;7.6;5;4;1;80;3.9;2687;86
1538;The Second Jungle Book: Mowgli & Baloo;120087;0;0;0;0;0;0;0;0;0;0;0;0;0
1539;Twin Town;120394;5.4;13;6;7;46;0;4;1;3;25;4.2;2298;90
1541;Addicted to Love;118556;5.6;30;17;13;56;6;5;3;2;60;2.8;4654;50
1542;Brassed Off;115744;6.6;28;22;6;78;6.4;6;4;2;66;3.5;2625;68
1543;The Designated Mourner;118964;6.2;16;11;5;68;6.6;5;4;1;80;3.6;50;71
1544;The Lost World: Jurassic Park;119567;5.6;59;29;30;49;5.1;13;6;7;46;3.2;46513;55
1545;Ponette;117359;8.1;21;19;2;90;0;3;3;0;100;4.1;956;89
1546;Schizopolis;117561;6.5;16;10;6;62;0;3;1;2;33;3.8;1164;79
1547;Saving Shiloh;472175;5.1;21;8;13;38;5.8;10;5;5;50;3.9;511;82
1548;The War at Home;460692;\N;\N;\N;\N;\N;\N;\N;\N;\N;\N;\N;\N;\N
1549;Rough Magic;114303;4.6;7;1;6;14;0;3;0;3;0;2.9;455;34
1550;Trial and Error;120373;5;29;12;17;41;7;6;3;3;50;2.7;602;27
1551;Buddy;118787;5.4;19;5;14;26;6.2;6;2;4;33;2.8;1106;37
1552;Con Air;118880;5.7;60;34;26;56;4.9;11;3;8;27;3.4;47142;77
1554;The Pillow Book;114134;6.7;26;20;6;76;0;3;3;0;100;3.8;4178;78
1555;En avoir (ou pas);112951;\N;\N;\N;\N;\N;\N;\N;\N;\N;\N;\N;\N;\N
1556;Speed 2: Cruise Control;120179;3.1;51;1;50;1;3.2;14;1;13;7;2.2;17521;28
1558;Sudden Manhattan;117775;5.6;6;4;2;66;0;0;0;0;0;0;0;0
1561;Wedding Bell Blues;118127;4;5;2;3;40;0;1;0;1;0;3.3;287;54
1562;Batman & Robin;118688;0;1;1;0;100;0;0;0;0;0;0;0;0
1563;Dream with the Fishes;119019;6.1;19;11;8;57;0;3;2;1;66;3.7;452;79
1564;Roseanna's Grave;120034;5.8;7;3;4;42;0;4;2;2;50;3.6;557;73
1565;Head Above Water;116502;0;0;0;0;0;0;0;0;0;0;0;0;0
1566;Hercules;119282;7;49;41;8;83;6.8;13;10;3;76;3.2;23787;68
1567;The Last Time I Committed Suicide;119502;0;3;1;2;33;0;0;0;0;0;0;0;0
1568;Murder Me, Murder You;85975;\N;\N;\N;\N;\N;\N;\N;\N;\N;\N;\N;\N;\N
1569;My Best Friend's Wedding;119738;6.5;54;39;15;72;5.9;17;10;7;58;3.3;64013;72
1570;Tetsuo II: Body Hammer;105569;0;3;2;1;66;0;1;1;0;100;3.4;1154;61
1571;Chacun cherche son chat;115856;7.3;16;14;2;87;0;3;3;0;100;3.8;726;76
1572;Le mépris;57345;8.4;35;33;2;94;8.1;8;7;1;87;4.1;3449;86
1573;Face/Off;119094;7.9;60;56;4;93;8.4;15;15;0;100;3.5;62348;81
1574;The Fall;460791;6.2;101;60;41;59;5.8;21;9;12;42;3.8;23397;85
1575;Gabbeh;116384;7.1;19;17;2;89;7.9;8;8;0;100;3.7;394;73
1580;Men in Black;119654;7.5;67;61;6;91;7.3;19;16;3;84;3.5;73637;73
1581;Out to Sea;119848;5.3;20;7;13;35;0;4;1;3;25;3;1331;53
1582;Wild America;120512;4.5;18;3;15;16;4.9;5;0;5;0;2.9;3839;58
1583;A Simple Wish;120133;4.6;15;4;11;26;0;3;0;3;0;2.7;4830;40
1584;Contact;118884;6.8;55;37;18;67;6.5;13;7;6;53;3.1;19572;74
1585;Love Serenade;116930;6.9;9;8;1;88;0;4;3;1;75;3.6;297;75
1586;G.I. Jane;119173;6;29;16;13;55;6.4;6;3;3;50;3;11537;58
1587;Conan the Barbarian;82198;6.4;25;19;6;76;0;3;2;1;66;3.1;17014;66
1588;George of the Jungle;119190;5.3;50;27;23;54;6.2;14;10;4;71;2.9;21989;47
1589;Cop Land;118887;6.5;59;42;17;71;6.1;18;13;5;72;3.1;8531;57
1590;Event Horizon;119081;4.3;33;7;26;21;5.2;5;1;4;20;3.2;15014;63
1591;Spawn;120177;4;40;8;32;20;4.2;9;2;7;22;2.8;18405;46
1592;Air Bud;118570;4.9;20;9;11;45;0;4;2;2;50;2.6;11606;42
1593;Picture Perfect;119896;5.4;40;19;21;47;5.2;9;3;6;33;2.7;4981;41
1594;In the Company of Men;119361;7.9;53;47;6;88;7.9;13;12;1;92;3.7;1900;80
1595;Free Willy 3: The Rescue;119152;4.7;15;6;9;40;0;2;2;0;100;2.8;7843;51
1596;Career Girls;118818;7.1;23;20;3;86;8.4;5;5;0;100;3.6;812;75
1597;Conspiracy Theory;118883;6.2;41;21;20;51;6.1;14;6;8;42;3.2;14632;66
1598;Desperate Measures;118966;4.1;29;5;24;17;3.8;6;0;6;0;2.9;1973;39
1599;Steel Magnolias;98384;5.8;18;12;6;66;0;1;1;0;100;3.6;26167;88
1600;She's So Lovely;120112;6;41;26;15;63;6.9;7;6;1;85;3.2;1353;56
1601;Hoodlum;119311;5.5;19;8;11;42;7.2;6;5;1;83;3.3;2875;63
1602;Leave It to Beaver;119509;4;27;5;22;18;4.4;10;2;8;20;2.6;1310;35
1603;Mimic;119675;6.3;30;17;13;56;6.3;6;3;3;50;2.7;5478;37
1604;Money Talks;119695;\N;\N;\N;\N;\N;\N;\N;\N;\N;\N;\N;\N;\N
1605;Excess Baggage;119086;4.5;30;10;20;33;4.7;5;1;4;20;2.5;3231;37
1606;Kull the Conqueror;119484;3.6;19;5;14;26;0;4;0;4;0;2.6;1819;35
1608;Air Force One;118571;7;50;39;11;78;7.1;18;15;3;83;3.2;26434;62
1609;One Eight Seven;118531;5.2;27;8;19;29;5.4;5;1;4;20;3.3;3318;68
1610;The Hunt for Red October;99810;7.8;42;40;2;95;0;4;3;1;75;3.6;18875;84
1611;My Own Private Idaho;102494;7;32;27;5;84;8.7;6;6;0;100;3.6;8810;79
1612;Kiss Me, Guido;119465;5.4;15;6;9;40;5.8;5;1;4;20;3.1;439;53
1613;Star Maps;120197;5;15;5;10;33;0;4;0;4;0;3.1;60;44
1614;In & Out;119360;6.9;28;20;8;71;8;5;5;0;100;2.9;4273;47
1615;The Edge;119051;6.3;46;27;19;58;6.4;11;6;5;54;3.2;5719;67
1616;The Peacemaker;119874;6;31;13;18;41;5.4;6;0;6;0;2.8;6439;41
1617;L.A. Confidential;119488;8.6;83;82;1;98;8.1;21;20;1;95;3.7;25453;90
1619;Seven Years in Tibet;120102;6.3;32;19;13;59;6.2;5;2;3;40;3.4;13241;71
1620;Kiss the Girls;119468;5.4;28;9;19;32;5.4;6;2;4;33;3.3;9940;68
1621;Soul Food;120169;6.3;41;33;8;80;6.4;13;10;3;76;3.6;3884;85
1622;Kicked in the Head;119457;4.1;9;1;8;11;0;4;0;4;0;3.1;226;45
1623;Wishmaster;120524;3.4;27;6;21;22;2.9;5;1;4;20;2.8;3480;48
1624;A Thousand Acres;120323;4.3;47;11;36;23;3.7;14;1;13;7;3;932;40
1625;The Game;119174;7.2;43;30;13;69;7.2;11;7;4;63;3.5;23139;82
1626;Fire Down Below;119123;3.3;26;3;23;11;3.3;7;1;6;14;2.6;3327;48
1627;U Turn;120399;6.1;48;28;20;58;5.2;13;6;7;46;3.1;5988;59
1628;The Day of the Locust;72848;6.8;8;5;3;62;0;1;1;0;100;3.6;582;75
1629;The MatchMaker;119632;5.6;26;14;12;53;0;4;2;2;50;3.3;1220;66
1631;The Assignment;118647;5.8;19;11;8;57;6.2;5;3;2;60;3.3;825;60
1632;A Smile Like Yours;120151;0;0;0;0;0;0;0;0;0;0;0;0;0
1633;Ulee's Gold;120402;8;48;45;3;93;7.9;13;12;1;92;3.4;607;67
1635;The Ice Storm;119349;7.6;56;46;10;82;7.3;13;10;3;76;3.6;7329;80
1636;Stag;120192;4.4;5;2;3;40;0;0;0;0;0;0;0;0
1639;Chasing Amy;118842;7.5;66;60;6;90;7.4;22;20;2;90;3.5;27129;81
1640;How to Be a Player;119326;3;7;1;6;14;0;1;0;1;0;3.4;1335;74
1641;The Full Monty;119164;7.6;41;39;2;95;7.6;7;7;0;100;3.3;12102;73
1642;Indian Summer;116631;6.7;6;5;1;83;0;2;2;0;100;3.2;492;45
1643;Mrs Brown;119280;7.3;39;36;3;92;7.6;8;7;1;87;3.7;2021;76
1644;I Know What You Did Last Summer;119345;5.3;39;14;25;35;5.7;11;5;6;45;2.8;30659;49
1645;The Devil's Advocate;118971;6.2;43;28;15;65;5.8;10;4;6;40;3.4;30966;78
1646;RocketMan;120029;3.9;15;4;11;26;5.7;5;2;3;40;3;3486;69
1647;Playing God;119906;4.1;28;4;24;14;4.7;7;2;5;28;2.9;2458;39
1648;The House of Yes;119324;5.9;35;22;13;62;6.3;8;5;3;62;3.7;1730;78
1649;Fast, Cheap & Out of Control;119107;8.1;29;27;2;93;0;3;3;0;100;3.9;980;82
1650;Washington Square;120481;7.2;27;22;5;81;7.6;6;4;2;66;3.4;579;58
1651;Telling Lies in America;120303;6.1;14;9;5;64;5.8;6;2;4;33;3;603;40
1652;Year of the Horse;120539;5.7;23;12;11;52;5.4;8;5;3;62;3.7;36;82
1653;Gattaca;119177;7.1;55;45;10;81;6.1;11;6;5;54;3.5;36666;82
1654;FairyTale: A True Story;119095;6.2;21;11;10;52;6.7;6;3;3;50;3.3;1880;63
1655;The Phantom of the Opera;293508;5;165;54;111;32;4.6;37;10;27;27;3.7;70849;86
1656;Swept from the Sea;120257;5.6;16;5;11;31;5;5;0;5;0;3.7;742;73
1657;Wonderland;335563;5;98;34;64;34;4.5;32;7;25;21;3.3;3666;67
1658;A Life Less Ordinary;119535;5.5;35;14;21;40;4.3;7;1;6;14;3.1;9301;57
1659;The Hurricane;174856;7;112;93;19;83;7.3;31;29;2;93;3.7;10473;84
1660;Eve's Bayou;119080;7.5;50;40;10;80;7.9;14;12;2;85;3.9;1799;87
1661;Switchback;119210;4.8;25;8;17;32;4.2;6;1;5;16;3;1273;45
1662;Gang Related;118900;5.6;15;9;6;60;0;3;1;2;33;3.6;1924;73
1663;Stripes;83131;6.6;33;29;4;87;0;4;3;1;75;0;0;0
1665;Bean;118689;5.3;30;12;18;40;5.9;8;3;5;37;2.9;16961;56
1666;Hugo Pool;119327;3.4;8;1;7;12;0;3;1;2;33;3;956;43
1667;Mad City;119592;5.3;27;10;17;37;4.9;6;1;5;16;2.9;2188;42
1668;One Night Stand;119832;5;28;8;20;28;6.1;7;3;4;42;2.9;964;43
1669;The Tango Lesson;120275;6;18;10;8;55;0;4;2;2;50;3.7;1178;73
1670;Welcome to Sarajevo;120490;6.9;25;19;6;76;7.6;5;4;1;80;3.5;985;75
1671;Deceiver;119527;5.4;26;12;14;46;6;7;4;3;57;3.2;586;53
1672;The Rainmaker;119978;6.9;44;37;7;84;7;11;9;2;81;3.3;5792;70
1673;Boogie Nights;118749;8.1;64;59;5;92;8.8;11;11;0;100;3.5;22528;84
1674;Witness;90329;8.1;31;29;2;93;0;3;2;1;66;3.5;7634;76
1675;Incognito;119365;5.1;9;3;6;33;0;0;0;0;0;0;0;0
1676;Starship Troopers;120201;6;55;33;22;60;6.3;14;8;6;57;3;24350;67
1677;Critical Care;118901;6.3;15;8;7;53;7.2;9;7;2;77;2.8;392;28
1678;The Joy Luck Club;107282;6.9;31;26;5;83;6.9;7;5;2;71;3.7;4795;87
1679;Chairman of the Board;118836;2.4;7;1;6;14;0;0;0;0;0;0;0;0
1680;Sliding Doors;120148;6.3;49;31;18;63;5.9;12;4;8;33;3.4;13328;74
1681;Mortal Kombat: Annihilation;119707;2.5;29;2;27;6;2.5;9;0;9;0;2.5;12426;36
1682;The Truman Show;120382;8.2;96;91;5;94;7.9;20;18;2;90;3.4;62890;82
1683;The Wings of the Dove;120520;7.8;28;24;4;85;9.1;7;7;0;100;3.7;1279;77
1684;Mrs Dalloway;119723;6.4;26;16;10;61;7.3;6;5;1;83;3.3;497;59
1685;I Love You, I Love You Not;116592;5.4;5;2;3;40;0;0;0;0;0;0;0;0
1686;Red Corner;119994;5.1;22;7;15;31;5;6;1;5;16;3;1935;49
1687;The Jackal;119395;4.2;25;3;22;12;0;4;0;4;0;3.1;12495;57
1688;Anastasia;118617;7.1;48;41;7;85;7.1;9;7;2;77;3.2;33076;70
1689;The Man Who Knew Too Little;120483;5.4;30;12;18;40;4.9;6;2;4;33;3;4269;64
1690;Alien³;103644;5;39;15;24;38;5.8;7;4;3;57;3.1;30526;55
1692;Alien Escape;112318;\N;\N;\N;\N;\N;\N;\N;\N;\N;\N;\N;\N;\N
1693;Amistad;118607;6.9;57;44;13;77;6.6;10;6;4;60;3.5;9716;75
1694;The Apostle;118632;8;44;40;4;90;8;10;9;1;90;3.6;2049;75
1695;Artemisia;123385;6.3;22;14;8;63;6.4;6;4;2;66;3.4;390;67
1696;Bent;118698;6.3;20;13;7;65;4.8;5;0;5;0;3.8;3465;79
1698;Les Boys;118764;0;0;0;0;0;0;0;0;0;0;0;0;0
1699;The Butcher Boy;118804;7.5;58;46;12;79;7.8;13;11;2;84;3.7;1377;81
1701;Deconstructing Harry;118954;7.2;33;23;10;69;7.5;6;4;2;66;3.6;5564;79
1702;Flubber;119137;3.7;29;5;24;17;4.3;6;1;5;16;2.8;23244;43
1703;For Richer or Poorer;119142;3.7;19;3;16;15;4.4;5;0;5;0;2.7;3367;47
1704;Good Will Hunting;119217;8;69;67;2;97;7.9;16;16;0;100;3.9;63868;92
1707;Home Alone 3;119303;4.3;21;5;16;23;5;6;2;4;33;2.6;22853;42
1708;Ill Gotten Gains;119352;0;0;0;0;0;0;0;0;0;0;0;0;0
1709;Legal Deceit;130073;\N;\N;\N;\N;\N;\N;\N;\N;\N;\N;\N;\N;\N
1710;Man of Her Dreams;116976;0;0;0;0;0;0;0;0;0;0;0;0;0
1711;Midnight in the Garden of Good and Evil;119668;6.2;30;15;15;50;6.4;6;2;4;33;3.3;7144;65
1713;Mousehunt;119715;5.3;28;12;16;42;4.8;7;1;6;14;2.8;9269;50
1714;Never Met Picasso;117167;0;0;0;0;0;0;0;0;0;0;0;0;0
1715;Office Killer;119819;3.2;16;2;14;12;0;3;0;3;0;3;371;44
1716;Other Voices, Other Rooms;119845;0;1;0;1;0;0;0;0;0;0;0;0;0
1717;Scream 2;120082;6.8;66;53;13;80;7.4;17;16;1;94;2.9;29170;54
1719;The Sweet Hereafter;120255;8.8;52;52;0;100;8.6;16;16;0;100;4;3068;86
1720;Time Tracers;128755;\N;\N;\N;\N;\N;\N;\N;\N;\N;\N;\N;\N;\N
1721;Titanic;120338;7.4;97;80;17;82;6.6;29;21;8;72;3.3;464576;68
1722;Tomorrow Never Dies;120347;5.9;55;30;25;54;4.8;12;4;8;33;3.1;19587;60
1723;Twisted;315297;2.9;132;2;130;1;3.2;36;0;36;0;2.8;2961;40
1725;The Education of Little Tree;119052;6.3;16;10;6;62;6.5;5;2;3;40;3.6;544;70
1726;The Postman;119925;3.8;31;3;28;9;3;6;0;6;0;2.8;8147;51
1727;The Horse Whisperer;119314;6.9;52;37;15;71;6.8;13;9;4;69;3.2;7903;71
1728;The Winter Guest;120521;6.5;24;15;9;62;7.2;5;3;2;60;3.6;994;69
1729;Jackie Brown;119396;7.3;68;58;10;85;6.3;18;11;7;61;3.5;36248;78
1730;Kundun;119485;7.3;58;44;14;75;6.7;15;10;5;66;3.7;3355;77
1731;Mr. Magoo;119718;2.3;26;1;25;3;2.3;8;0;8;0;2.3;2618;30
1732;The Big Lebowski;118715;7.1;74;58;16;78;6.1;13;8;5;61;4;82903;93
1733;Afterglow;118566;6.8;30;21;9;70;7.4;7;5;2;71;3;386;38
1734;Ma vie en rose;119590;7.4;20;18;2;90;7.6;5;5;0;100;4.1;3051;88
1735;Great Expectations;119223;5.4;32;12;20;37;5.4;7;3;4;42;3.4;10607;76
1739;3 Ninjas: High Noon at Mega Mountain;118539;0;4;0;4;0;0;1;0;1;0;2.5;7721;32
1740;Men of Means;119655;\N;\N;\N;\N;\N;\N;\N;\N;\N;\N;\N;\N;\N
1742;Caught Up;119988;4.1;7;0;7;0;0;3;0;3;0;3.1;627;45
1743;Arguing the World;129758;6.8;5;4;1;80;0;1;1;0;100;3.1;150;47
1744;Firestorm;120670;0;0;0;0;0;0;0;0;0;0;0;0;0
1746;Senseless;120820;3.4;14;1;13;7;0;3;0;3;0;2.8;1704;50
1747;Wag the Dog;120885;7.4;70;59;11;84;7.5;19;17;2;89;3.4;8216;72
1748;Dark City;118929;0;2;0;2;0;0;0;0;0;0;0;0;0
1749;The Leading Man;116845;6.4;8;5;3;62;0;2;2;0;100;3.6;534;71
1750;Star Kid;120478;5.3;12;4;8;33;0;3;1;2;33;2.5;863;32
1752;A Hard Rain's Gonna Fall;1216620;\N;\N;\N;\N;\N;\N;\N;\N;\N;\N;\N;\N;\N
1753;Half Baked;120693;4.2;24;7;17;29;0;2;0;2;0;3.4;26499;82
1754;Fallen;119099;5.3;54;22;32;40;5.1;13;5;8;38;3.4;9162;75
1755;Shooting Fish;120122;5.8;28;16;12;57;5.2;5;1;4;20;3.5;1362;72
1756;The Prophecy II;118643;4.7;6;2;4;33;0;0;0;0;0;0;0;0
1757;Duo luo tian shi;112913;7.9;19;18;1;94;0;4;4;0;100;4;4014;86
1759;O Que É Isso, Companheiro?;119815;6.2;15;8;7;53;6.2;5;2;3;40;3.5;524;70
1760;Spice World;120185;4.5;33;9;24;27;5.1;7;1;6;14;2.1;9540;39
1762;Deep Rising;118956;4.2;27;8;19;29;3.9;6;1;5;16;2.8;3617;42
1765;A Letter from Death Row;119521;0;0;0;0;0;0;0;0;0;0;0;0;0
1767;Music from Another Room;119734;5;6;2;4;33;0;0;0;0;0;0;0;0
1769;The Replacement Killers;120008;5.4;31;12;19;38;6;6;3;3;50;3;4222;51
1770;B. Monkey;120594;5.6;16;10;6;62;0;3;1;2;33;3.1;1126;49
1771;The Night Flier;119784;0;4;1;3;25;0;1;0;1;0;2.8;1507;37
1772;Blues Brothers 2000;118747;5.1;42;19;23;45;5.5;10;4;6;40;2.7;8002;42
1773;Tokyo Fist;114690;0;2;2;0;100;0;0;0;0;0;0;0;0
1774;Zardoz;70948;5.2;18;8;10;44;0;1;0;1;0;3.1;2696;51
1776;Joy Ride;206314;6.6;111;82;29;73;6.7;29;23;6;79;3.1;9370;63
1777;The Wedding Singer;120888;6.1;59;39;20;66;5.8;12;8;4;66;3.5;86088;76
1779;Sphere;120184;4;49;6;43;12;3.8;12;1;11;8;2.7;9112;38
1780;Ayn Rand: A Sense of Life;118662;5.8;11;6;5;54;0;3;1;2;33;3.4;268;58
1781;A Further Gesture;116379;0;4;3;1;75;0;0;0;0;0;0;0;0
1782;Little City;119548;0;3;1;2;33;0;0;0;0;0;0;0;0
1783;Palmetto;120782;5.1;31;11;20;35;5.2;6;1;5;16;2.7;679;28
1784;As Good as It Gets;119822;7.2;75;64;11;85;7.3;21;19;2;90;3.5;30872;81
1785;King of New York;99939;6;23;16;7;69;6.2;5;3;2;60;3.7;5329;77
1788;Men with Guns;119657;7.6;26;23;3;88;0;4;4;0;100;3.9;476;84
1789;The Sadness of Sex;114322;0;0;0;0;0;0;0;0;0;0;0;0;0
1791;Twilight;1099212;5.5;196;98;98;50;5.9;36;20;16;55;4.1;256646;82
1792;U.S. Marshals;120873;4.9;30;8;22;26;5;7;1;6;14;3.2;12491;59
1793;Welcome to Woop Woop;120491;3.8;17;5;12;29;0;2;0;2;0;3.4;280;65
1794;Love and Death on Long Island;119574;8;35;31;4;88;8.3;6;6;0;100;3.2;643;54
1795;El callejón de los milagros;112619;0;0;0;0;0;0;0;0;0;0;0;0;0
1796;In God's Hands;140282;2.9;6;0;6;0;0;0;0;0;0;0;0;0
1797;Everest;120661;7.7;13;12;1;92;0;1;1;0;100;3.5;699;71
1798;Hush;118744;3.4;37;4;33;10;3.2;8;0;8;0;2.9;1448;43
1799;Suicide Kings;120241;5.4;29;10;19;34;5.4;6;2;4;33;3.4;10831;72
1801;The Man in the Iron Mask;120744;5.4;35;11;24;31;6.2;7;2;5;28;3.1;24313;60
1804;The Newton Boys;120769;6.3;36;22;14;61;5.7;8;3;5;37;2.9;1826;43
1805;Where the Wild Things Are;386117;6.9;241;176;65;73;6.4;40;26;14;65;3.4;236581;59
1806;Paulie;125454;6.1;36;22;14;61;5.9;12;4;8;33;2.8;3810;51
1807;A Cool, Dry Place;120642;5.5;13;7;6;53;0;1;0;1;0;3.2;848;54
1809;Hana-bi;119250;8.2;18;17;1;94;0;2;2;0;100;4.3;3702;91
1810;Primary Colors;119942;7.2;74;59;15;79;6.7;21;14;7;66;3;3209;55
1811;Niagara;46126;6.2;10;8;2;80;0;0;0;0;0;0;0;0
1812;Wide Awake;120510;4.9;29;12;17;41;4.6;7;2;5;28;3.3;1235;65
1814;A Price Above Rubies;120793;5.9;27;15;12;55;5.7;5;2;3;40;3.1;429;51
1815;East of Eden;48028;8.2;30;26;4;86;0;3;2;1;66;4;5957;90
1816;Two Girls and a Guy;124179;5.6;57;30;27;52;6.4;18;10;8;55;2.8;1292;42
1817;No Looking Back;119560;5.3;21;8;13;38;5.4;5;1;4;20;3.5;561;66
1819;Storefront Hitchcock;120219;7.5;8;7;1;87;0;0;0;0;0;0;0;0
1820;The Proposition;421238;7.3;123;107;16;86;7.4;31;27;4;87;3.6;20228;77
1821;The Object of My Affection;120772;5.8;48;24;24;50;5.6;11;5;6;45;3;6363;54
1822;Meet the Deedles;120645;2.4;26;1;25;3;3;5;0;5;0;2.6;1774;39
1824;Homegrown;119305;5.9;15;7;8;46;0;3;2;1;66;3;1031;47
1825;The Players Club;119905;5;15;4;11;26;6.3;5;3;2;60;3.6;5665;82
1826;Barney's Great Adventure;120598;0;0;0;0;0;0;0;0;0;0;0;0;0
1827;Big;94737;7.9;52;50;2;96;6.8;5;4;1;80;3.4;33658;73
1829;Chinese Box;118851;6.4;21;13;8;61;6.6;5;3;2;60;3.3;700;57
1831;Lost in Space;120738;4.6;46;12;34;26;5.3;8;2;6;25;2.5;8293;30
1832;Heaven's Burning;119272;0;3;1;2;33;0;1;0;1;0;2.9;633;30
1833;Mercury Rising;120749;4.2;35;6;29;17;4.6;8;1;7;12;3;7388;49
1834;The Spanish Prisoner;120176;7.4;59;52;7;88;7.2;13;12;1;92;3.7;1863;80
1835;City of Angels;120632;0;0;0;0;0;0;0;0;0;0;0;0;0
1836;The Last Days of Disco;120728;6.3;51;34;17;66;7.4;11;9;2;81;3.2;1361;58
1837;The Odd Couple II;120773;4.4;27;6;21;22;4.1;7;0;7;0;3.1;1418;57
1839;My Giant;120765;4.8;26;5;21;19;4.5;6;0;6;0;2.6;1175;30
1840;He Got Game;124718;6.9;60;48;12;80;6.8;18;14;4;77;3.6;8293;81
1841;The Gingerbread Man;119196;6.2;40;24;16;60;6.9;11;8;3;72;2.8;1101;27
1842;Illtown;118229;5.3;11;6;5;54;0;1;0;1;0;3.2;34;75
1843;Slappy and the Stinkers;120213;0;4;0;4;0;0;0;0;0;0;0;0;0
1844;Carne trémula;118819;7.1;37;29;8;78;7.2;10;7;3;70;3.9;4009;86
1845;Zero Effect;120906;6.7;38;25;13;65;6.2;5;2;3;40;3.5;1908;74
1846;Nil by Mouth;119792;6.2;19;12;7;63;7.6;5;4;1;80;4;1783;88
1848;The Borrowers;118755;6.6;24;17;7;70;7.5;7;6;1;85;2.8;4043;48
1849;Prince Valiant;47365;0;0;0;0;0;0;0;0;0;0;0;0;0
1850;I Love You, Don't Touch Me!;130019;5.4;10;4;6;40;0;1;1;0;100;3.1;352;44
1851;Leather Jacket Love Story;119508;0;3;1;2;33;0;0;0;0;0;0;0;0
1853;An Alan Smithee Film: Burn Hollywood Burn;118577;2.8;36;3;33;8;2.7;6;1;5;16;2.2;601;21
1854;Kissing a Fool;120723;4.7;28;8;20;28;5.6;6;3;3;50;2.7;899;43
1855;Krippendorf's Tribe;120725;3.5;36;5;31;13;3.8;7;1;6;14;2.4;910;21
1856;Kurt & Courtney;138563;5.3;21;12;9;57;0;3;2;1;66;3.1;1391;48
1857;The Real Blonde;119987;5.4;26;9;17;34;6.2;6;3;3;50;2.9;430;39
1858;Yat goh hiu yan;117786;5.6;27;12;15;44;6;6;3;3;50;2.9;4726;52
1859;Ta'm e guilass;120265;7.3;30;25;5;83;7.6;10;9;1;90;4;1878;84
1860;Karakter;119448;7.3;25;23;2;92;7.9;6;6;0;100;4.1;754;89
1861;Budbringeren;118785;7.4;15;14;1;93;0;4;4;0;100;0;0;0
1862;Species II;120841;3.2;31;3;28;9;0;2;0;2;0;2.3;3562;26
1863;Major League: Back to the Minors;120742;3;19;4;15;21;0;4;1;3;25;2.6;1952;31
1864;Sour Grapes;120838;3.5;13;3;10;23;0;3;0;3;0;2.8;451;38
1865;Wild Man Blues;141986;7.2;37;32;5;86;7.4;9;8;1;88;3.4;581;61
1866;The Big Hit;120609;5.1;39;16;23;41;6;10;5;5;50;3.1;4322;60
1867;Tarzan and the Lost City;120856;2.2;18;1;17;5;2.2;5;0;5;0;2.6;985;35
1869;Black Dog;120610;3.1;19;2;17;10;0;3;0;3;0;3;3586;62
1870;Dancer, Texas Pop. 81;118925;6.6;15;12;3;80;0;3;2;1;66;3.3;531;62
1871;Priyatel pokoynika;119952;6.7;12;8;4;66;0;3;3;0;100;0;0;0
1872;Slumdog Millionaire;1010048;8.2;220;206;14;93;8.2;38;36;2;94;4;328969;90
1873;Les misérables;119683;6.9;41;31;10;75;6.6;11;6;5;54;3.6;7310;81
1874;Still Breathing;120211;5.6;13;8;5;61;5.5;5;3;2;60;3.6;699;71
1875;Clockwatchers;118866;6.9;24;20;4;83;6.6;5;4;1;80;3.2;947;56
1876;Deep Impact;120647;5.7;51;24;27;47;5.9;6;2;4;33;2.9;28624;51
1877;Little Men;145048;4.6;7;1;6;14;0;3;0;3;0;3.5;85;63
1878;Face/Off;119094;7.9;60;56;4;93;8.4;15;15;0;100;3.5;62348;81
1879;The Hanging Garden;125128;7.3;16;15;1;93;0;4;4;0;100;3.6;485;70
1880;Lawn Dogs;119506;6.5;18;13;5;72;0;4;1;3;25;3.8;1154;84
1881;Quest for Camelot;120800;5.3;21;7;14;33;5.9;6;2;4;33;3.1;4041;62
1882;Godzilla;120685;4.7;59;15;44;25;5.7;9;3;6;33;2.6;17658;38
1883;Bulworth;118798;7;61;46;15;75;7.6;10;8;2;80;3.1;3041;60
1884;Fear and Loathing in Las Vegas;120669;5.8;45;21;24;46;4.1;6;0;6;0;3.9;75860;90
1885;The Opposite of Sex;120777;7.1;40;33;7;82;6.9;7;4;3;57;3.1;3268;57
1886;I Got the Hook Up;131436;3;12;2;10;16;0;2;0;2;0;3.2;1133;68
1887;Almost Heroes;119053;2.3;21;3;18;14;0;3;0;3;0;2.9;4626;63
1888;Hope Floats;119313;4.9;31;7;24;22;4.8;7;0;7;0;3.3;12082;73
1889;Insomnia;278504;7.7;166;153;13;92;7.8;33;31;2;93;3.2;18085;66
1890;Little Boy Blue;119547;5;8;2;6;25;0;0;0;0;0;0;0;0
1891;Coyote Ugly;200550;3.9;94;20;74;21;3.6;27;5;22;18;3.2;65988;73
1892;A Perfect Murder;120787;6.2;49;27;22;55;6.2;14;8;6;57;3.1;9130;52
1893;Jenseits der Stille;116692;7.5;11;9;2;81;8;5;5;0;100;3.9;474;83
1894;Six Days Seven Nights;120828;5.4;38;14;24;36;5.4;6;0;6;0;2.7;10008;41
1895;Can't Hardly Wait;127723;5.4;45;20;25;44;5.4;12;5;7;41;3.1;11719;60
1896;Cousin Bette;118894;6;21;10;11;47;5.6;5;1;4;20;3;408;38
1897;High Art;139362;6.8;42;30;12;71;7.2;7;4;3;57;3.7;2153;76
1898;The Land Girls;119494;6.7;17;11;6;64;6.1;7;2;5;28;3.3;693;54
1899;Passion in the Desert;125980;6.1;20;13;7;65;0;4;1;3;25;3.2;162;55
1900;Bacheha-Ye aseman;118849;7.6;25;21;4;84;7.6;5;4;1;80;4.4;3834;94
1901;Dear Jesse;150290;6.8;6;5;1;83;0;1;1;0;100;3.8;29;100
1902;Dream for an Insomniac;116141;5;10;5;5;50;0;2;0;2;0;3.6;1167;74
1903;Hav Plenty;126938;5.2;21;8;13;38;6.6;6;4;2;66;3.9;465;80
1904;Henry Fool;122529;7.4;26;22;4;84;0;3;2;1;66;3.8;1375;78
1906;Mr. Jealousy;119717;6.5;12;8;4;66;0;4;2;2;50;3.3;437;59
1907;Mulan;120762;7.5;72;62;10;86;7;14;10;4;71;3.4;52938;78
1908;Resurrection Man;140508;0;3;0;3;0;0;0;0;0;0;0;0;0
1909;The X Files;120902;6;68;43;25;63;5.9;15;8;7;53;3.3;13283;69
1910;I Went Down;126344;7.2;19;16;3;84;0;4;2;2;50;4.2;202;88
1911;Doctor Dolittle;118998;5.2;49;21;28;42;5.5;8;4;4;50;2.8;23847;46
1912;Out of Sight;120780;7.9;69;64;5;92;8;14;13;1;92;3.2;11285;65
1913;Picnic at Hanging Rock;73540;8.3;29;27;2;93;9.7;5;5;0;100;4;3210;84
1914;Smoke Signals;120321;7.3;29;25;4;86;8.1;5;5;0;100;3.9;2767;83
1915;Viagem ao Princípio do Mundo;120443;6.2;5;3;2;60;0;0;0;0;0;0;0;0
1916;Buffalo '66;118789;7;40;31;9;77;7.1;7;5;2;71;3.8;7504;87
1917;Armageddon;120591;5.1;77;32;45;41;3.8;17;3;14;17;3.5;105398;77
1918;Lethal Weapon 4;122151;5.9;61;33;28;54;6.1;12;6;6;50;3.3;20840;70
1919;Madeline;123987;6.5;26;17;9;65;6.5;6;4;2;66;2.6;3549;45
1920;Small Soldiers;122718;6.2;41;19;22;46;6.8;12;6;6;50;2.8;9855;46
1921;Pi;138704;7.2;49;42;7;85;6.7;11;8;3;72;3.8;33850;86
1922;What Ever Happened to Baby Jane?;56687;7.6;37;33;4;89;0;3;2;1;66;3.9;7128;89
1923;There's Something About Mary;129387;0;2;0;2;0;0;1;0;1;0;3.1;233;47
1924;Plan 9 from Outer Space;52077;4.9;30;19;11;63;0;1;1;0;100;2.8;6105;46
1925;Der Himmel über Berlin;93191;8.5;39;38;1;97;7.5;6;5;1;83;4.4;9110;94
1926;The Broadway Melody;19729;5.4;16;6;10;37;0;4;2;2;50;2.9;515;31
1927;All Quiet on the Western Front;20629;8.6;32;31;1;96;7.8;5;5;0;100;3.8;3797;85
1928;Spirit: Stallion of the Cimarron;166813;6.4;125;86;39;68;6.9;29;23;6;79;3.3;8302;72
1929;Grand Hotel;22958;7.4;28;24;4;85;7.6;5;5;0;100;3.8;1661;77
1930;Cavalcade;23876;6.7;14;9;5;64;0;4;4;0;100;3;314;35
1931;Mutiny on the Bounty;26752;8.2;28;26;2;92;7.5;6;5;1;83;3.7;1846;79
1932;The Great Ziegfeld;27698;6;21;12;9;57;6;5;3;2;60;3.4;704;60
1933;The Life of Emile Zola;29146;7;20;14;6;70;7.2;5;4;1;80;3.6;620;72
1934;You Can't Take It with You;30993;7.3;27;26;1;96;0;4;4;0;100;4;2934;87
1935;How Green Was My Valley;33729;7.8;34;30;4;88;7.2;5;5;0;100;3.9;1995;83
1936;Mrs. Miniver;35093;7.6;22;19;3;86;8.2;5;5;0;100;3.9;1307;85
1937;Going My Way;36872;7;19;14;5;73;0;4;3;1;75;3.8;1251;80
1938;The Lost Weekend;37884;8.2;24;24;0;100;0;4;4;0;100;4;2562;86
1939;The Best Years of Our Lives;36868;8.6;35;34;1;97;8.1;8;8;0;100;4.2;3330;91
1940;Gentleman's Agreement;39416;7;30;25;5;83;6.8;5;4;1;80;3.8;1308;79
1941;Hamlet;116477;8.2;54;51;3;94;7.2;14;11;3;78;3.8;5816;86
1942;All the King's Men;405676;0;0;0;0;0;0;0;0;0;0;0;0;0
1943;The Greatest Show on Earth;44672;0;0;0;0;0;0;0;0;0;0;0;0;0
1944;From Here to Eternity;45793;8;40;35;5;87;7.9;7;6;1;85;3.9;4410;83
1945;On the Waterfront;47296;9;49;49;0;100;8.9;10;10;0;100;4.2;11904;94
1946;Back to the Future;88763;8.4;54;52;2;96;7.3;6;5;1;83;3.8;126816;88
1947;West Side Story;55614;8.1;49;45;4;91;8;7;6;1;85;3.5;18648;82
1948;Tom Jones;57590;7.8;26;21;5;80;0;4;3;1;75;3.3;1389;60
1949;A Man for All Seasons;60665;7.8;27;23;4;85;0;4;3;1;75;4;2887;86
1950;In the Heat of the Night;61811;8.1;28;27;1;96;0;4;4;0;100;3.9;4274;90
1951;Oliver!;63385;7.7;25;21;4;84;0;4;3;1;75;3.4;9490;72
1952;Midnight Cowboy;64665;8.3;49;44;5;89;6.8;6;5;1;83;3.9;8994;87
1953;The French Connection;67116;8.5;45;44;1;97;8.2;6;6;0;100;3.8;8751;86
1954;Rocky;75148;8.1;41;38;3;92;7.6;5;4;1;80;3.2;165793;65
1955;Kramer vs. Kramer;79417;7.9;34;30;4;88;7.4;6;5;1;83;3.7;9401;85
1956;Ordinary People;81283;7.9;32;29;3;90;7.5;6;5;1;83;3.8;5284;86
1957;Chariots of Fire;82158;7.4;36;31;5;86;7.4;6;5;1;83;3.6;7456;77
1958;Terms of Endearment;86425;7.4;35;31;4;88;7.1;5;4;1;80;3.7;7594;82
1959;Out of Africa;89755;6.2;32;20;12;62;6.5;6;4;2;66;3.7;10166;84
1960;The Last Emperor;93389;7.9;44;40;4;90;7.6;9;7;2;77;3.7;7466;86
1961;Rain Man;95953;7.6;54;47;7;87;4.5;7;2;5;28;3.8;42473;88
1962;Driving Miss Daisy;97239;7;41;32;9;78;7.9;8;8;0;100;3.4;7698;79
1963;Take the Money and Run;65063;6.9;13;12;1;92;0;1;0;1;0;0;0;0
1964;Klute;67309;8;27;26;1;96;0;3;2;1;66;3.7;1593;78
1965;Repo Man;87995;7.9;37;36;1;97;0;4;4;0;100;3.4;5166;75
1966;Metropolitan;100142;7.4;25;22;3;88;6.5;6;4;2;66;3.9;1143;83
1967;Labyrinth;91369;6;32;19;13;59;6.2;6;3;3;50;3.8;81222;85
1968;The Breakfast Club;88847;7.5;42;38;4;90;6.2;6;4;2;66;3.9;93109;90
1969;A Nightmare on Elm Street Part 2: Freddy's Revenge;89686;4.8;23;10;13;43;0;2;2;0;100;3;19841;55
1970;A Nightmare on Elm Street 3: Dream Warriors;93629;5.9;31;22;9;70;0;4;1;3;25;3.1;21954;68
1971;A Nightmare on Elm Street 4: The Dream Master;95742;5.3;25;14;11;56;0;4;2;2;50;3;19043;60
1972;A Nightmare on Elm Street: The Dream Child;97981;4.1;27;8;19;29;0;4;1;3;25;2.9;17837;56
1973;Freddy's Dead: The Final Nightmare;101917;3.9;25;5;20;20;0;4;3;1;75;3;12382;54
1974;Friday the 13th;80761;5.6;45;27;18;60;0;4;2;2;50;3.2;25534;66
1975;Friday the 13th Part 2;82418;4.4;30;10;20;33;0;1;0;1;0;3.1;13685;58
1976;Friday the 13th Part III;83972;3.5;22;3;19;13;0;0;0;0;0;0;0;0
1977;Friday the 13th: The Final Chapter;87298;4.3;21;5;16;23;0;0;0;0;0;0;0;0
1978;Friday the 13th: A New Beginning;89173;3.3;17;3;14;17;0;0;0;0;0;0;0;0
1979;Jason Lives: Friday the 13th Part VI;91080;5.1;24;13;11;54;0;0;0;0;0;0;0;0
1980;Friday the 13th Part VII: The New Blood;95179;4.5;16;4;12;25;0;0;0;0;0;0;0;0
1981;Friday the 13th Part VIII: Jason Takes Manhattan;97388;2.9;20;2;18;10;0;1;0;1;0;2.8;9749;45
1982;Halloween;373883;4.1;101;26;75;25;3.9;19;3;16;15;3.3;79946;64
1983;Halloween II;82495;4.3;30;8;22;26;4.4;5;1;4;20;3.3;16555;67
1984;Halloween III: Season of the Witch;85636;4.2;15;5;10;33;0;2;1;1;50;2.2;7355;28
1985;Halloween 4: The Return of Michael Myers;95271;3.8;22;5;17;22;0;4;0;4;0;3.1;13190;61
1986;Halloween 5;97474;3.6;21;3;18;14;0;2;1;1;50;3;11908;55
1987;Prom Night;926129;2.8;60;5;55;8;2.4;9;1;8;11;3;51435;46
1988;Hello Mary Lou: Prom Night II;93176;4;8;3;5;37;0;0;0;0;0;0;0;0
1989;Prom Night III: The Last Kiss;98136;0;3;0;3;0;0;0;0;0;0;0;0;0
1990;Prom Night IV: Deliver Us from Evil;105179;2.1;5;0;5;0;0;0;0;0;0;0;0;0
1991;Bride of Chucky;144120;5.3;30;13;17;43;0;4;1;3;25;2.6;20874;52
1992;Child's Play 2;99253;4.2;13;5;8;38;0;1;1;0;100;2.8;13499;52
1993;Child's Play 3;103956;4.3;11;3;8;27;0;1;0;1;0;2.8;12064;47
1994;Poltergeist;84516;7.1;49;42;7;85;0;4;3;1;75;3.4;15891;74
1995;Poltergeist II: The Other Side;91778;4.7;17;7;10;41;0;1;0;1;0;0;0;0
1996;Poltergeist III;95889;3.6;14;2;12;14;0;0;0;0;0;0;0;0
1997;The Exorcist;70047;7.7;43;36;7;83;6.6;7;5;2;71;3.7;49968;83
1998;Exorcist II: The Heretic;76009;3.6;17;4;13;23;0;0;0;0;0;0;0;0
1999;The Exorcist III;99528;5.4;27;16;11;59;0;1;0;1;0;2.9;4879;55
2000;Lethal Weapon;93409;7.3;40;36;4;90;7.4;8;7;1;87;3.6;33975;81
2001;Lethal Weapon;93409;7.3;40;36;4;90;7.4;8;7;1;87;3.6;33975;81
2002;Lethal Weapon 3;104714;5.6;39;22;17;56;4.7;8;3;5;37;3.2;20151;68
2003;Gremlins;87363;6.8;41;32;9;78;5;5;2;3;40;3.4;31525;70
2004;Gremlins 2: The New Batch;99700;6.4;34;22;12;64;6.4;6;4;2;66;3;18308;58
2005;The Goonies;89218;5.9;39;25;14;64;0;3;2;1;66;3.8;89625;88
2006;The Mask of Zorro;120746;7.1;66;54;12;81;6.5;13;10;3;76;3.3;31107;70
2007;Polish Wedding;119910;4.9;35;15;20;42;5.5;9;4;5;44;3;896;51
2008;This World, Then the Fireworks;117898;3.7;5;1;4;20;0;0;0;0;0;0;0;0
2009;Soylent Green;70723;6;31;22;9;70;0;3;0;3;0;3.5;5747;71
2010;Metropolis;17136;8.9;98;97;1;98;8.8;23;23;0;100;4.1;17640;90
2011;Back to the Future Part II;96874;6;40;26;14;65;4.2;6;2;4;33;3.5;73208;80
2012;Back to the Future Part III;99088;6.3;38;27;11;71;5.5;7;3;4;42;3.4;66354;74
2013;The Poseidon Adventure;69113;6.8;23;18;5;78;0;1;0;1;0;3.3;7876;72
2014;Freaky Friday;322330;7;140;123;17;87;7;34;29;5;85;2.9;73112;60
2015;The AbsentMinded Professor;54594;7.2;20;16;4;80;0;2;2;0;100;3.2;1425;61
2016;The Apple Dumpling Gang Rides Again;78790;0;3;0;3;0;0;0;0;0;0;0;0;0
2017;Babes in Toyland;24852;8.4;12;12;0;100;0;2;2;0;100;3.6;865;78
2018;Bambi;34492;8;38;34;4;89;0;4;4;0;100;3.4;39873;68
2019;Shichinin no samurai;47478;9.2;49;49;0;100;8.6;10;10;0;100;4.5;29509;97
2020;Dangerous Liaisons;94947;7.7;27;25;2;92;6.5;6;5;1;83;3.7;11359;84
2021;Dune;87182;6.1;26;16;10;61;0;2;0;2;0;3.4;17715;67
2022;The Last Temptation of Christ;95497;7.3;46;38;8;82;7.5;7;6;1;85;3.7;7365;83
2023;The Godfather: Part III;99674;6.4;53;35;18;66;6.9;8;6;2;75;3.7;68556;79
2024;The Rapture;102757;6.5;24;16;8;66;0;2;1;1;50;3.2;627;61
2025;Lolita;56193;8;38;37;1;97;0;2;2;0;100;3.7;11593;80
2026;Disturbing Behavior;134619;4.4;33;10;23;30;5.2;6;2;4;33;2.7;4794;43
2027;Jane Austen's Mafia!;120741;4;42;6;36;14;4.4;7;0;7;0;2.7;1995;47
2028;Saving Private Ryan;120815;8.2;92;84;8;91;8.1;19;17;2;89;4;139463;92
2029;Billy's Hollywood Screen Kiss;137386;6.5;20;13;7;65;0;4;0;4;0;3.4;686;59
2030;Dong gong xi gong;119007;6.3;5;3;2;60;0;0;0;0;0;0;0;0
2031;The Million Dollar Duck;66728;3.5;5;0;5;0;0;1;0;1;0;0;0;0
2032;The Barefoot Executive;66811;0;4;4;0;100;0;0;0;0;0;0;0;0
2033;The Black Cauldron;88814;5.8;27;16;11;59;6.2;5;3;2;60;3.1;5461;53
2034;The Black Hole;78869;5.1;26;11;15;42;0;3;2;1;66;3;2357;45
2035;Blackbeard's Ghost;62737;5.6;9;7;2;77;0;1;1;0;100;3.3;1038;69
2036;Blank Check;109287;2.6;7;1;6;14;0;0;0;0;0;0;0;0
2037;Candleshoe;75807;0;1;1;0;100;0;0;0;0;0;0;0;0
2038;The Cat from Outer Space;77305;0;4;1;3;25;0;0;0;0;0;0;0;0
2039;Cheetah;97053;5.5;7;3;4;42;0;1;1;0;100;3.3;357;59
2040;The Computer Wore Tennis Shoes;65566;5.6;5;3;2;60;0;0;0;0;0;0;0;0
2041;Condorman;82199;3.9;12;3;9;25;0;1;1;0;100;2.9;1334;49
2042;D2: The Mighty Ducks;109520;3.8;13;2;11;15;0;1;0;1;0;2.9;13731;55
2043;Darby O'Gill and the Little People;52722;6.9;13;13;0;100;0;1;1;0;100;3.5;2183;71
2044;The Devil and Max Devlin;82263;3.9;8;1;7;12;0;0;0;0;0;0;0;0
2045;A Far Off Place;106868;4.9;9;3;6;33;0;2;0;2;0;3.3;2508;62
2046;Flight of the Navigator;91059;5.7;7;5;2;71;0;0;0;0;0;0;0;0
2047;The Gnome-Mobile;61715;0;1;1;0;100;0;1;1;0;100;3.4;654;62
2048;The Great Mouse Detective;91149;6.8;15;12;3;80;0;2;2;0;100;3.3;8687;70
2049;The Happiest Millionaire;61749;0;4;2;2;50;0;1;0;1;0;3.8;694;78
2050;Herbie Goes Bananas;80861;0;4;1;3;25;0;1;1;0;100;2.9;2642;53
2051;Herbie Goes to Monte Carlo;76137;5;8;5;3;62;0;0;0;0;0;0;0;0
2052;Hocus Pocus;107120;4.1;21;6;15;28;0;3;0;3;0;3.1;21690;67
2053;Honey I Blew Up the Kid;104437;4.9;16;7;9;43;0;2;1;1;50;2.5;10297;32
2054;Honey, I Shrunk the Kids;97523;6.1;30;22;8;73;0;4;3;1;75;2.9;22644;47
2055;Hot Lead and Cold Feet;77698;0;1;1;0;100;0;0;0;0;0;0;0;0
2056;In Search of the Castaways;56095;0;4;3;1;75;0;0;0;0;0;0;0;0
2057;Homeward Bound: The Incredible Journey;107131;6.5;22;19;3;86;6.9;8;7;1;87;3.2;15019;66
2058;The Negotiator;120768;0;0;0;0;0;0;0;0;0;0;0;0;0
2059;The Parent Trap;120783;7;34;27;7;79;6.5;7;4;3;57;3.1;41455;67
2060;BASEketball;131857;5;49;20;29;40;4.5;13;3;10;23;3.2;19777;74
2061;Full Tilt Boogie;119165;0;0;0;0;0;0;0;0;0;0;0;0;0
2062;The Governess;120687;6.4;33;22;11;66;7;6;4;2;66;3.2;534;49
2063;Le septième ciel;124115;5.3;7;4;3;57;0;1;1;0;100;3.4;192;62
2064;Roger & Me;98213;8.8;27;27;0;100;0;0;0;0;0;0;0;0
2065;The Purple Rose of Cairo;89853;7.7;29;26;3;89;0;0;0;0;0;0;0;0
2066;Out of the Past;39689;8.6;25;24;1;96;8.6;5;5;0;100;4.2;2206;91
2067;Doctor Zhivago;59113;7.2;32;27;5;84;6;5;3;2;60;3.8;11535;85
2068;Fanny och Alexander;83922;8.9;33;33;0;100;8.4;11;11;0;100;4.4;5627;93
2069;The Trip to Bountiful;90203;7.2;7;7;0;100;0;1;1;0;100;4;434;82
2070;Tender Mercies;86423;7.3;20;17;3;85;0;0;0;0;0;0;0;0
2071;And the Band Played On;106273;7.3;8;8;0;100;0;0;0;0;0;0;0;0
2072;The 'burbs;96734;5.2;13;6;7;46;0;2;1;1;50;3.3;10248;68
2073;Fandango;89126;6.3;6;3;3;50;0;0;0;0;0;0;0;0
2074;Il portiere di notte;71910;5.6;20;13;7;65;0;4;1;3;25;3.6;1475;73
2075;Mephisto;82736;6.9;16;11;5;68;5.5;5;2;3;40;3.9;757;86
2076;Blue Velvet;90756;8.4;33;30;3;90;0;4;2;2;50;4;25218;88
2077;The Journey of Natty Gann;89385;6.7;13;12;1;92;0;3;3;0;100;3.5;1251;73
2078;The Jungle Book;61852;7.3;27;24;3;88;0;2;1;1;50;3.5;35715;70
2079;Kidnap;1034449;0;0;0;0;0;0;0;0;0;0;0;0;0
2080;Lady and the Tramp;48280;7.4;31;27;4;87;0;4;1;3;25;3.5;37042;73
2081;The Little Mermaid;97757;8;51;46;5;90;7.3;7;6;1;85;3.6;80670;83
2082;The Mighty Ducks;104868;3.8;25;2;23;8;3.2;5;0;5;0;3.1;14328;64
2083;The Muppet Christmas Carol;104940;6;30;20;10;66;4.4;7;3;4;42;0;0;0
2084;Newsies;104990;4.5;23;7;16;30;3.6;7;1;6;14;3.8;10436;88
2085;One Hundred and One Dalmatians;55254;8;37;36;1;97;7.6;5;5;0;100;3.3;29711;63
2086;One Magic Christmas;89731;5.4;9;5;4;55;0;1;0;1;0;3.4;844;66
2087;Peter Pan;316396;6.8;132;100;32;75;6.3;33;23;10;69;3.3;47413;68
2088;Popeye;81353;5.8;27;15;12;55;0;4;2;2;50;2.6;6384;39
2089;The Rescuers Down Under;100477;6;22;14;8;63;6.5;5;3;2;60;3.2;8757;62
2090;The Rescuers;76618;6.6;25;21;4;84;0;3;3;0;100;3.2;7689;66
2091;Race to Witch Mountain;1075417;5.1;145;61;84;42;5.3;29;13;16;44;3.2;150558;50
2092;The Return of Jafar;107952;3.6;9;2;7;22;0;0;0;0;0;0;0;0
2093;Return to Oz;89908;5.7;20;11;9;55;0;3;1;2;33;3.1;14348;62
2094;The Rocketeer;102803;5.8;50;30;20;60;5.8;9;5;4;55;2.9;8053;54
2095;The Shaggy D.A.;75200;5.4;8;4;4;50;0;1;0;1;0;3.2;263;55
2096;Sleeping Beauty;53285;7.8;32;29;3;90;0;4;3;1;75;3.4;42607;75
2097;Something Wicked This Way Comes;86336;6.1;23;13;10;56;0;4;3;1;75;3.4;2097;64
2098;Son of Flubber;57518;6.2;6;5;1;83;0;0;0;0;0;0;0;0
2099;Song of the South;38969;5.6;7;3;4;42;0;2;0;2;0;3.6;1559;77
2100;Splash;88161;6.9;35;32;3;91;5.6;5;3;2;60;3;12492;52
2101;Squanto: A Warrior's Tale;111271;5.6;9;5;4;55;0;2;0;2;0;3.3;515;62
2102;Steamboat Willie;19422;0;0;0;0;0;0;0;0;0;0;0;0;0
2103;Tall Tale;111359;5.5;9;4;5;44;0;1;1;0;100;0;0;0
2104;Tex;84783;6.9;11;9;2;81;0;3;2;1;66;3.5;695;66
2105;TRON;84827;6;37;25;12;67;0;4;1;3;25;3.3;14666;69
2106;Swing Kids;108265;4.6;12;4;8;33;0;3;1;2;33;3.5;4819;79
2107;Halloween H20: 20 Years Later;120694;5.5;54;28;26;51;5.9;10;5;5;50;2.8;14935;57
2108;L.A. Story;102250;7.4;32;30;2;93;7.8;7;7;0;100;3.2;3117;70
2109;The Jerk;79367;6.5;30;25;5;83;0;4;2;2;50;3.6;10847;83
2110;Dead Men Don't Wear Plaid;83798;6.5;22;17;5;77;0;0;0;0;0;0;0;0
2111;The Man with Two Brains;85894;6;20;14;6;70;0;1;0;1;0;3;4360;57
2112;Grand Canyon;101969;6.9;24;18;6;75;0;2;2;0;100;3.4;1857;65
2113;Graveyard Shift;99697;3.8;8;1;7;12;0;0;0;0;0;0;0;0
2114;The Outsiders;86066;6.1;31;20;11;64;4.7;7;2;5;28;3.6;24069;81
2115;Indiana Jones and the Temple of Doom;87469;7.2;59;50;9;84;6.5;7;4;3;57;3.7;87518;80
2116;The Lord of the Rings: The Return of the King;167260;8.6;239;225;14;94;8.6;43;42;1;97;3.7;288649;83
2117;Nineteen Eighty-Four;87803;6.4;14;11;3;78;0;1;1;0;100;3.5;17133;70
2118;The Dead Zone;281432;\N;\N;\N;\N;\N;\N;\N;\N;\N;\N;\N;\N;\N
2119;Maximum Overdrive;91499;2.9;11;2;9;18;0;0;0;0;0;0;0;0
2120;Needful Things;107665;4;22;6;16;27;0;3;0;3;0;3;2983;48
2121;Cujo;85382;5.6;27;16;11;59;0;0;0;0;0;0;0;0
2122;Children of the Corn;87050;4.1;22;8;14;36;0;0;0;0;0;0;0;0
2123;All Dogs Go to Heaven;96787;5.2;9;4;5;44;0;1;1;0;100;3.2;20551;60
2124;The Addams Family;101272;5.6;39;23;16;58;4.1;7;1;6;14;3.2;28704;65
2125;Ever After;120631;7.5;61;55;6;90;6.8;17;13;4;76;3.5;71637;81
2126;Snake Eyes;120832;5.2;64;26;38;40;4.9;14;6;8;42;2.8;8922;40
2127;First Love, Last Rites;128214;6.1;8;3;5;37;0;0;0;0;0;0;0;0
2128;Safe Men;120813;6;19;11;8;57;0;3;0;3;0;3.4;851;60
2129;Die Salzmänner von Tibet;120056;0;0;0;0;0;0;0;0;0;0;0;0;0
2130;Atlantic City;80388;8.7;19;19;0;100;0;0;0;0;0;0;0;0
2131;Höstsonaten;77711;8;19;18;1;94;0;1;1;0;100;4.1;2226;90
2132;Who's Afraid of Virginia Woolf?;61184;8.6;31;30;1;96;0;4;3;1;75;4.1;5164;91
2133;Adventures in Babysitting;92513;6.2;21;16;5;76;0;1;0;1;0;3.2;12565;64
2134;Weird Science;90305;5.6;25;14;11;56;0;3;1;2;33;3.2;14712;69
2135;Doctor Dolittle;118998;5.2;49;21;28;42;5.5;8;4;4;50;2.8;23847;46
2136;The Nutty Professor;117218;6;51;34;17;66;6.7;15;13;2;86;2.9;25286;50
2137;Charlotte's Web;413895;7;142;111;31;78;6.9;35;25;10;71;3.3;39179;67
2138;Watership Down;78480;7;27;22;5;81;0;2;1;1;50;3.6;5277;82
2139;The Secret of NIMH;84649;6.8;18;17;1;94;6.5;5;4;1;80;3.5;7964;79
2140;The Dark Crystal;83791;6.1;30;21;9;70;0;2;1;1;50;3.6;35382;78
2141;An American Tail;90633;6.2;24;15;9;62;4.8;6;2;4;33;3.3;13516;68
2142;An American Tail: Fievel Goes West;101329;5.4;9;3;6;33;0;2;1;1;50;3.2;16427;58
2143;Legend;89469;5.4;21;11;10;52;0;1;0;1;0;3.5;26271;73
2144;Sixteen Candles;88128;7;31;27;4;87;6.2;5;3;2;60;3.7;44572;84
2145;Pretty in Pink;91790;6.3;30;24;6;80;0;4;3;1;75;3.5;37255;81
2146;St. Elmo's Fire;90060;4.7;29;13;16;44;0;0;0;0;0;0;0;0
2147;The Clan of the Cave Bear;90848;3.7;8;1;7;12;0;1;0;1;0;2.9;1148;48
2148;House M.D.;412142;\N;\N;\N;\N;\N;\N;\N;\N;\N;\N;\N;\N;\N
2149;House II: The Second Story;93220;3;9;0;9;0;0;0;0;0;0;0;0;0
2150;The Gods Must Be Crazy;80801;7.4;19;18;1;94;0;1;1;0;100;3.5;7965;78
2151;The Gods Must Be Crazy II;97443;5.1;11;6;5;54;0;2;1;1;50;3.4;2600;69
2152;Air Bud: Golden Receiver;140796;4;17;1;16;5;0;3;0;3;0;2.7;7798;41
2154;How Stella Got Her Groove Back;120703;5.5;47;23;24;48;5.8;12;7;5;58;3.1;4439;72
2155;Slums of Beverly Hills;120831;6.9;58;46;12;79;7.3;13;12;1;92;3.3;1834;64
2156;Il testimone dello sposo;133413;5.7;7;4;3;57;0;2;1;1;50;2.7;49;38
2157;La femme de chambre du Titanic;129923;6.5;16;13;3;81;0;1;1;0;100;0;0;0
2158;Henry: Portrait of a Serial Killer, Part 2;116516;0;0;0;0;0;0;0;0;0;0;0;0;0
2159;Henry: Portrait of a Serial Killer;99763;7.3;41;36;5;87;6.5;7;6;1;85;3.6;2890;72
2160;Rosemary's Baby;63522;0;0;0;0;0;0;0;0;0;0;0;0;0
2161;The Neverending Story III;110647;0;3;1;2;33;0;0;0;0;0;0;0;0
2162;The Neverending Story II: The Next Chapter;100240;3.3;6;0;6;0;0;0;0;0;0;0;0;0
2163;Attack of the Killer Tomatoes!;80391;3.9;11;3;8;27;0;0;0;0;0;0;0;0
2164;Surf Nazis Must Die;94077;0;4;0;4;0;0;0;0;0;0;0;0;0
2165;Your Friends & Neighbors;119517;7;55;42;13;76;6.4;20;13;7;65;3.3;1418;60
2166;Return to Paradise;124595;6.6;44;31;13;70;6.8;11;8;3;72;3.5;1723;76
2167;Blade;120611;5.7;83;46;37;55;4.6;24;7;17;29;3.6;87683;78
2168;Dance with Me;120576;5.4;40;19;21;47;5.2;11;5;6;45;3.2;7621;68
2169;Dead Man on Campus;118301;3.6;34;5;29;14;2.8;11;0;11;0;2.7;3796;50
2170;Wrongfully Accused;120901;3.8;31;7;24;22;2.9;6;0;6;0;2.8;2483;56
2171;Next Stop Wonderland;119778;6.8;41;30;11;73;5.7;7;3;4;42;3.5;910;70
2172;Strike!;120692;6.8;12;8;4;66;0;3;1;2;33;3.5;2267;69
2173;The Navigator: A Mediaeval Odyssey;95709;6.5;5;4;1;80;0;0;0;0;0;0;0;0
2174;Beetle Juice;94721;7;42;34;8;80;6.4;7;5;2;71;3.4;84134;77
2175;Deja Vu;453467;0;0;0;0;0;0;0;0;0;0;0;0;0
2176;Rope;40746;7.8;31;30;1;96;0;2;1;1;50;4;9199;89
2177;Family Plot;74512;7;20;19;1;95;0;2;2;0;100;3.3;1981;57
2178;Frenzy;68611;7.4;30;26;4;86;0;2;2;0;100;3.6;3790;74
2179;Topaz;65112;6.4;17;12;5;70;0;1;1;0;100;3;1779;39
2180;Torn Curtain;61107;6.5;16;13;3;81;0;1;0;1;0;3.3;2910;55
2181;Marnie;58329;6.8;19;16;3;84;0;1;0;1;0;0;0;0
2182;The Wrong Man;51207;8.3;18;16;2;88;0;1;0;1;0;3.6;2616;72
2183;The Man Who Knew Too Much;49470;7.7;28;25;3;89;0;3;2;1;66;0;0;0
2184;The Trouble with Harry;48750;7.4;19;17;2;89;0;1;1;0;100;3.6;3827;73
2185;I Confess;45897;7.2;20;17;3;85;0;3;2;1;66;3.6;2474;70
2186;Strangers on a Train;44079;8.7;40;39;1;97;7.3;5;4;1;80;4;9106;91
2187;Stage Fright;42994;7;16;14;2;87;0;3;2;1;66;3.4;2015;61
2188;54;120577;4.1;62;8;54;12;3.4;14;1;13;7;2.8;4129;45
2189;I Married a Strange Person!;119346;6.1;9;7;2;77;0;1;1;0;100;3.8;688;80
2190;Why Do Fools Fall in Love;123324;5.8;54;29;25;53;6.5;19;13;6;68;3.5;1989;73
2191;Keep the Aspidistra Flying;119453;7;21;18;3;85;0;4;4;0;100;3.2;753;50
2192;Regarde la mer;139564;7.3;8;8;0;100;0;2;2;0;100;3.4;370;61
2193;Willow;96446;5.4;26;12;14;46;0;4;0;4;0;3.4;36518;76
2194;The Untouchables;94226;7.2;42;34;8;80;7.9;7;6;1;85;3.8;40677;87
2195;Dirty Work;120654;3.9;30;5;25;16;3.5;7;0;7;0;3.1;3838;66
2196;Knock Off;120724;2.9;38;3;35;7;3.6;9;2;7;22;2.6;1992;32
2197;Firelight;119125;5.2;13;6;7;46;0;3;2;1;66;3.8;672;81
2199;Griffin & Phoenix;460812;0;0;0;0;0;0;0;0;0;0;0;0;0
2200;Under Capricorn;42004;5.9;6;4;2;66;0;2;1;1;50;3;851;37
2201;The Paradine Case;39694;6.2;8;6;2;75;0;1;1;0;100;3.2;1208;46
2202;Lifeboat;37017;7.8;20;19;1;95;0;3;2;1;66;3.8;2621;84
2203;Shadow of a Doubt;36342;8.9;30;30;0;100;0;4;4;0;100;4;5376;89
2204;Saboteur;35279;6.7;14;11;3;78;0;1;0;1;0;3.6;2467;72
2205;Mr. & Mrs. Smith;356910;6;202;116;86;57;5.6;39;18;21;46;3.4;230941;63
2206;Guilty by Suspicion;101984;6.2;16;11;5;68;0;2;1;1;50;3.2;728;51
2207;Jamaica Inn;31505;5.5;10;7;3;70;0;1;0;1;0;3;1259;38
2208;The Lady Vanishes;30341;8.3;33;32;1;96;0;3;3;0;100;4;4078;87
2209;Young and Innocent;29811;7.5;13;13;0;100;0;2;2;0;100;3.4;889;61
2210;Sabotage;28212;7.3;7;7;0;100;0;1;1;0;100;3.5;1459;68
2211;Secret Agent;28231;7.6;10;10;0;100;0;0;0;0;0;0;0;0
2212;The Man Who Knew Too Much;49470;7.7;28;25;3;89;0;3;2;1;66;0;0;0
2214;Number Seventeen;23285;0;2;0;2;0;0;0;0;0;0;0;0;0
2215;Rich and Strange;23395;6.4;10;7;3;70;0;1;1;0;100;0;0;0
2216;The Skin Game;22395;0;3;0;3;0;0;2;0;2;0;2.7;145;27
2218;Juno and the Paycock;21015;5.1;7;4;3;57;0;2;0;2;0;0;0;0
2219;A Perfect Murder;120787;6.2;49;27;22;55;6.2;14;8;6;57;3.1;9130;52
2220;The Manxman;20142;0;2;2;0;100;0;1;1;0;100;3.1;502;37
2221;Blackmail;19702;6.7;9;8;1;88;0;1;1;0;100;3.4;1310;63
2222;Champagne;18756;0;1;0;1;0;0;0;0;0;0;0;0;0
2223;The Farmer's Wife;18876;0;0;0;0;0;0;0;0;0;0;0;0;0
2225;Easy Virtue;808244;5.8;120;63;57;52;5.8;26;13;13;50;3.1;16900;48
2226;The Ring;298130;6.6;169;120;49;71;6.3;32;18;14;56;3;146246;50
2227;The Lodger;851530;3.6;23;4;19;17;2.5;6;0;6;0;2.9;1023;36
2229;The Pleasure Garden;16230;0;1;1;0;100;0;0;0;0;0;0;0;0
2231;Rounders;128442;6.2;76;49;27;64;5;19;8;11;42;3.7;21780;86
2232;Cube;123755;6.1;33;20;13;60;6;6;3;3;50;3.5;22869;75
2233;Digging to China;118980;4.4;7;3;4;42;0;1;0;1;0;3.7;506;70
2234;Kinsey;362269;7.6;187;168;19;89;7.9;39;36;3;92;3.4;6162;72
2235;One Man's Hero;120775;4.8;8;3;5;37;0;1;0;1;0;3.1;305;48
2236;Simon Birch;124879;5.8;32;14;18;43;5.4;6;2;4;33;3.4;8747;76
2237;Without Limits;119934;6.5;37;29;8;78;6.8;15;13;2;86;4;1947;88
2238;Pasqualino Settebellezze;75040;8.2;9;8;1;88;0;1;1;0;100;4;557;87
2239;Travolti da un insolito destino nell'azzurro mare d'agosto;73817;5.9;16;11;5;68;0;2;2;0;100;3.7;857;77
2240;My Bodyguard;81207;6.5;25;21;4;84;0;4;3;1;75;3.4;1236;67
2241;Class;85346;4.7;12;3;9;25;0;2;1;1;50;3;1523;47
2242;Grandview, U.S.A.;87359;0;1;0;1;0;0;0;0;0;0;0;0;0
2243;Broadcast News;92699;8.1;38;37;1;97;7.8;7;7;0;100;3.5;2524;71
2244;The Allnighter;92537;2.5;7;0;7;0;0;3;0;3;0;2.9;329;39
2245;Working Girl;96463;6.7;36;30;6;83;7.2;7;6;1;85;3.1;6043;61
2246;Stars and Bars;96166;0;1;1;0;100;0;0;0;0;0;0;0;0
2247;Married to the Mob;95593;7.2;22;19;3;86;0;0;0;0;0;0;0;0
2248;Say Anything...;98258;8.1;38;38;0;100;7.9;6;6;0;100;3.6;20891;82
2249;My Blue Heaven;100212;5.5;16;11;5;68;0;1;1;0;100;3;2634;54
2250;Men Don't Leave;100134;6.6;16;12;4;75;0;2;1;1;50;3.4;202;54
2251;The Cabinet of Dr. Ramirez;101530;\N;\N;\N;\N;\N;\N;\N;\N;\N;\N;\N;\N;\N
2252;Heroes;813715;0;0;0;0;0;0;0;0;0;0;0;0;0
2253;Toys;105629;4.1;22;6;16;27;0;3;0;3;0;2.6;6312;39
2255;Young Doctors in Love;84938;4.2;6;0;6;0;0;1;0;1;0;2.7;366;33
2256;Parasite;84472;2.2;5;0;5;0;0;0;0;0;0;0;0;0
2257;No Small Affair;87810;5.7;6;4;2;66;0;0;0;0;0;0;0;0
2258;Shao Lin san shi liu fang;78243;0;1;0;1;0;0;0;0;0;0;0;0;0
2259;Blame It on Rio;86973;2.9;22;2;20;9;0;3;0;3;0;2.8;1097;36
2260;Filth and Wisdom;1042499;3.9;58;15;43;25;4.2;23;7;16;30;3;1070;42
2261;One Crazy Summer;91680;5.6;15;9;6;60;0;2;1;1;50;3.3;3309;62
2262;Last Night;156729;7.2;49;41;8;83;7.1;9;7;2;77;3.8;1691;84
2263;The Seventh Sign;96073;3.7;16;3;13;18;0;1;0;1;0;3.1;3031;55
2264;We're No Angels;98625;5.1;18;9;9;50;0;1;1;0;100;2.9;2176;43
2265;Nothing But Trouble;102558;2.2;10;1;9;10;0;1;0;1;0;0;0;0
2266;The Butcher's Wife;101523;3.8;13;3;10;23;0;2;0;2;0;2.7;1218;30
2267;Mortal Thoughts;102469;5.6;13;8;5;61;0;2;1;1;50;2.9;1404;33
2268;A Few Good Men;104257;6.8;42;35;7;83;7.5;8;8;0;100;3.6;26934;83
2269;Indecent Proposal;107211;4.7;35;13;22;37;0;3;1;2;33;2.9;7358;50
2270;A Century of Cinema;109390;\N;\N;\N;\N;\N;\N;\N;\N;\N;\N;\N;\N;\N
2271;Permanent Midnight;120788;5.7;51;30;21;58;6.4;11;7;4;63;3.2;1302;55
2272;One True Thing;120776;7.2;60;53;7;88;6.7;18;15;3;83;3.4;2813;65
2273;Rush Hour;120812;6;62;37;25;59;5.5;14;7;7;50;3.4;73231;79
2275;Six-String Samurai;118736;6;20;12;8;60;0;1;0;1;0;3.7;2140;75
2276;A Soldier's Daughter Never Cries;120835;7;24;19;5;79;7.3;7;5;2;71;3.4;482;62
2278;Ronin;122690;6.3;60;41;19;68;5.8;14;8;6;57;3.5;26379;76
2279;Urban Legend;146336;4.3;48;10;38;20;4.1;12;2;10;16;2.7;15231;46
2280;Clay Pigeons;118863;6.2;51;32;19;62;5;10;2;8;20;3.4;2336;67
2281;Snitch;119802;7;19;17;2;89;0;4;4;0;100;3.3;386;58
2282;Pecker;126604;5.7;43;23;20;53;4.7;6;1;5;16;3.2;3201;63
2283;The Sheltering Sky;100594;5.2;22;10;12;45;5;7;3;4;42;3.8;1679;79
2284;Bandit Queen;109206;7.5;25;25;0;100;7.6;10;10;0;100;3.6;1049;72
2285;If....;63850;7.9;30;29;1;96;0;4;3;1;75;4.1;2971;88
2286;The Fiendish Plot of Dr. Fu Manchu;80731;3.6;10;2;8;20;0;1;0;1;0;3;277;45
2287;Ils;465203;6;50;30;20;60;6;12;6;6;50;3.4;4393;62
2288;The Thing;84787;0;0;0;0;0;0;0;0;0;0;0;0;0
2289;The Player;105151;0;0;0;0;0;0;0;0;0;0;0;0;0
2290;Stardust Memories;81554;6.6;24;17;7;70;0;4;1;3;25;3.8;2789;80
2291;Edward Scissorhands;99487;7.6;53;48;5;90;6.8;9;7;2;77;3.8;145994;88
2292;Overnight Delivery;117276;4.9;7;3;4;42;0;0;0;0;0;0;0;0
2293;Shadrach;144604;5.8;16;8;8;50;5;5;0;5;0;3.6;134;59
2294;Antz;120587;7.7;86;82;4;95;7.5;24;23;1;95;2.9;33465;47
2295;Impostor;160399;3.9;91;19;72;20;3.6;25;4;21;16;3;1418;46
2296;A Night at the Roxbury;120770;3.4;54;6;48;11;2.6;11;0;11;0;3.1;27913;67
2297;What Dreams May Come;120889;5.7;66;36;30;54;5.8;16;9;7;56;3.6;31618;85
2298;Strangeland;124102;2.3;16;1;15;6;0;2;0;2;0;3.5;4041;65
2299;The Battle of the Sexes;52607;0;1;1;0;100;0;0;0;0;0;0;0;0
2300;The Producers;395251;5.8;150;76;74;50;5;36;10;26;27;3.1;31343;63
2301;History of the World: Part I;82517;5.6;25;15;10;60;0;0;0;0;0;0;0;0
2302;My Cousin Vinny;104952;6.9;38;33;5;86;7;8;6;2;75;0;0;0
2303;Nashville;73440;8.6;39;37;2;94;9;5;5;0;100;4.1;3090;84
2304;Love Is the Devil: Study for a Portrait of Francis Bacon;119577;0;0;0;0;0;0;0;0;0;0;0;0;0
2305;Slam;139615;6.8;21;13;8;61;7.2;8;5;3;62;3.9;549;80
2306;Holy Man;120701;3.6;49;6;43;12;3.8;12;1;11;8;2.4;3310;30
2307;One Tough Cop;122642;4.2;20;5;15;25;4;6;1;5;16;2.8;405;28
2308;Detroit 9000;69966;5.4;6;1;5;16;0;2;0;2;0;2.9;572;48
2310;The Mighty Ducks;104868;3.8;25;2;23;8;3.2;5;0;5;0;3.1;14328;64
2311;2010;86837;5.7;25;16;9;64;0;2;2;0;100;3.2;5956;58
2312;Children of a Lesser God;90830;7.1;24;20;4;83;0;1;1;0;100;3.6;2089;76
2313;The Elephant Man;80678;8.2;33;30;3;90;0;4;2;2;50;3.9;16869;90
2314;Beloved;120603;7.1;66;51;15;77;7.3;24;20;4;83;3.3;2521;68
2315;Bride of Chucky;144120;5.3;30;13;17;43;0;4;1;3;25;2.6;20874;52
2316;Practical Magic;120791;4.4;54;11;43;20;3.7;15;1;14;6;3.2;24912;73
2317;Life During Wartime;119534;5.6;11;6;5;54;0;1;0;1;0;0;0;0
2318;Happiness;147612;7.9;44;37;7;84;7.8;9;7;2;77;4;11088;88
2319;Reach the Rock;119986;4.5;8;3;5;37;0;1;0;1;0;3.4;22;60
2320;Apt Pupil;118636;6;55;29;26;52;5.5;14;7;7;50;3.1;5334;57
2321;Pleasantville;120789;7.5;82;70;12;85;6.9;22;16;6;72;3.3;22512;73
2322;Soldier;120157;3.5;50;5;45;10;3.6;15;2;13;13;2.8;5503;46
2323;Valkyrie;985699;6;185;113;72;61;6;37;22;15;59;3.5;113378;66
2324;La vita è bella;118799;7.5;84;66;18;78;5.7;16;9;7;56;4.3;65601;96
2325;Orgazmo;124819;5.1;32;15;17;46;4.1;7;1;6;14;3.2;9287;66
2326;Shattered Image;143874;4.8;14;4;10;28;0;4;0;4;0;0;0;0
2327;Tales from the Darkside: The Movie;100740;4.5;14;5;9;35;0;3;1;2;33;3.1;2283;49
2328;Interview with the Vampire: The Vampire Chronicles;110148;5.8;45;26;19;57;4.6;10;4;6;40;3.7;77706;85
2329;American History X;120586;7.2;72;60;12;83;6.6;21;15;6;71;4.2;140060;96
2330;Hands on a Hard Body: The Documentary;116481;7.1;19;16;3;84;6.8;6;6;0;100;4.1;320;89
2331;Living Out Loud;120722;6.3;31;18;13;58;5.8;7;3;4;42;3.4;845;60
2332;Belly;158493;3.9;15;2;13;13;0;2;0;2;0;3.9;6432;86
2333;Gods and Monsters;120684;8.4;48;46;2;95;8.5;9;8;1;88;3.7;3109;80
2334;The Siege;133952;5.8;59;26;33;44;5;13;4;9;30;3.1;8405;56
2335;The Waterboy;120484;4.6;72;23;49;31;3.8;17;4;13;23;3.4;79240;74
2336;Elizabeth;127536;7.3;47;38;9;80;8.3;9;9;0;100;3.8;19341;86
2337;Velvet Goldmine;120879;6.5;38;21;17;55;5.7;5;1;4;20;3.7;10467;80
2338;I Still Know What You Did Last Summer;130018;3.3;53;4;49;7;3.9;11;2;9;18;2.6;19948;42
2339;I'll Be Home for Christmas;155753;3.9;40;7;33;17;3.5;16;2;14;12;2.6;3438;46
2340;Meet Joe Black;119643;5.6;36;18;18;50;5.6;5;2;3;40;3.4;38972;80
2341;Dancing at Lughnasa;120643;6.1;31;20;11;64;6.5;5;2;3;40;3.4;869;59
2342;Hard Core Logo;116488;6.4;12;8;4;66;0;4;4;0;100;0;0;0
2343;The Naked Man;120767;4.9;5;1;4;20;0;0;0;0;0;0;0;0
2344;Runaway Train;89941;7.1;27;23;4;85;0;4;3;1;75;3.5;1615;71
2345;Desert Bloom;90934;7;9;7;2;77;0;1;0;1;0;0;0;0
2346;The Stepford Wives;327162;4.7;163;43;120;26;4.9;37;11;26;29;2.6;14476;36
2347;The Pope of Greenwich Village;87932;7.4;9;8;1;88;0;1;1;0;100;3.5;970;68
2348;Sid and Nancy;91954;7.3;31;28;3;90;7.4;7;6;1;85;3.5;6365;75
2349;Mona Lisa Smile;304415;4.9;147;51;96;34;5.2;41;18;23;43;3.1;23577;61
2350;Heart Condition;99750;3.3;7;0;7;0;0;2;0;2;0;2.9;842;43
2351;Le notti di Cabiria;50783;8.7;35;34;1;97;8.4;11;11;0;100;4.4;3465;94
2352;The Big Chill;85244;6.1;31;21;10;67;5.5;6;3;3;50;3.6;4386;79
2353;Enemy of the State;120660;6.4;81;57;24;70;6.2;20;13;7;65;3.5;34766;76
2354;The Rugrats Movie;134067;5.8;47;27;20;57;6.4;11;7;4;63;2.8;6870;42
2355;A Bug's Life;120623;7.9;80;73;7;91;7.5;18;17;1;94;3.3;64405;61
2356;Celebrity;120533;5.6;37;15;22;40;5.6;5;1;4;20;3;3241;42
2357;Central do Brasil;140888;7.9;48;45;3;93;8.1;13;12;1;92;4.2;3839;93
2358;Savior;120070;6.8;8;5;3;62;0;2;1;1;50;3.7;947;78
2359;Waking Ned;166396;7;57;47;10;82;7;13;11;2;84;3.6;4612;85
2360;Festen;154420;8;36;33;3;91;8.3;5;5;0;100;4.3;5434;95
2361;Pink Flamingos;69089;6.6;35;28;7;80;0;4;2;2;50;3.6;4901;74
2362;Glen or Glenda;45826;3.6;22;7;15;31;0;1;0;1;0;2.6;1851;35
2363;Gojira;47034;7.6;57;53;4;92;7.5;17;15;2;88;4.1;2309;86
2364;Godzilla;120685;4.7;59;15;44;25;5.7;9;3;6;33;2.6;17658;38
2365;Kingu Kongu tai Gojira;56142;4.4;11;4;7;36;0;1;0;1;0;3.1;2636;49
2366;King Kong;360717;7.7;242;202;40;83;7.6;39;30;9;76;2.8;207337;52
2367;King Kong;360717;7.7;242;202;40;83;7.6;39;30;9;76;2.8;207337;52
2368;King Kong Lives;91344;1.6;9;0;9;0;0;2;0;2;0;2.7;5069;37
2369;Desperately Seeking Susan;89017;6.7;23;20;3;86;0;3;3;0;100;2.8;3449;55
2370;The Emerald Forest;89087;7.2;15;13;2;86;0;0;0;0;0;0;0;0
2371;Fletch;89155;6.4;28;21;7;75;0;4;3;1;75;3.3;6895;78
2372;Fletch Lives;97366;4.1;13;4;9;30;0;1;0;1;0;2.9;2636;53
2373;Red Sonja;800175;0;0;0;0;0;0;0;0;0;0;0;0;0
2374;Gung Ho;91159;5.3;14;6;8;42;0;1;0;1;0;3;1121;45
2375;The Money Pit;91541;4.8;19;9;10;47;0;1;0;1;0;3;7189;59
2376;A View to a Kill;90264;4.8;41;16;25;39;3.6;5;0;5;0;3.1;12502;49
2377;Lifeforce;89489;5.4;14;8;6;57;0;0;0;0;0;0;0;0
2378;Police Academy;87928;4.6;15;7;8;46;0;0;0;0;0;0;0;0
2379;Police Academy 2: Their First Assignment;89822;3.1;13;3;10;23;0;0;0;0;0;0;0;0
2380;Police Academy 3: Back in Training;91777;4.2;10;4;6;40;0;1;1;0;100;2.8;6533;49
2381;Police Academy 4: Citizens on Patrol;93756;2.4;18;0;18;0;0;3;0;3;0;2.7;6328;46
2382;Police Academy 5: Assignment: Miami Beach;95882;0;2;0;2;0;0;0;0;0;0;0;0;0
2383;Police Academy 6: City Under Siege;98105;1.2;7;0;7;0;0;0;0;0;0;0;0;0
2384;Babe: Pig in the City;120595;6.2;58;35;23;60;5.8;14;8;6;57;2.8;9741;45
2385;Home Fries;119304;4.8;35;11;24;31;4.4;6;1;5;16;2.5;4100;34
2386;Ringmaster;165494;3;23;5;18;21;0;4;1;3;25;2.1;443;19
2387;Very Bad Things;124198;5.6;50;22;28;44;5.1;12;3;9;25;3;5484;57
2388;Hamam;119248;6.3;16;13;3;81;6.4;5;3;2;60;3.7;781;75
2389;Psycho;54215;8.9;67;66;1;98;7.5;8;7;1;87;3.9;32475;90
2390;Little Voice;147004;7.2;35;29;6;82;7.3;7;5;2;71;3.4;2979;68
2391;A Simple Plan;120324;8.1;51;46;5;90;8.2;8;7;1;87;3.4;7546;74
2392;Jack Frost;141109;3.8;47;7;40;14;4;14;3;11;21;2.8;6973;48
2393;Star Trek: Insurrection;120844;5.8;64;35;29;54;6.7;12;9;3;75;3.1;13225;53
2394;The Prince of Egypt;120794;7;82;64;18;78;6.7;25;18;7;72;3.1;16105;67
2395;Rushmore;128445;7.8;82;71;11;86;7.4;17;13;4;76;3.7;34168;91
2396;Shakespeare in Love;138097;8.1;101;94;7;93;8;25;23;2;92;3.3;30161;76
2397;Mass Appeal;87688;0;2;2;0;100;0;0;0;0;0;0;0;0
2398;Miracle on 34th Street;39628;8;31;29;2;93;0;2;2;0;100;3.5;5409;81
2399;Santa Claus;89961;4.1;17;3;14;17;0;1;0;1;0;3.1;2513;66
2400;Prancer;98115;6;16;11;5;68;0;3;2;1;66;3;1515;53
2401;Pale Rider;89767;7.3;24;22;2;91;0;4;3;1;75;3.6;8286;78
2402;Rambo: First Blood Part II;89880;4.1;30;9;21;30;0;2;0;2;0;3.1;18865;63
2403;First Blood;83944;7.1;35;30;5;85;6.2;5;4;1;80;3.5;23595;81
2404;Rambo III;95956;4.6;28;10;18;35;0;4;2;2;50;2.9;16200;51
2405;The Jewel of the Nile;89370;4.9;19;9;10;47;0;1;1;0;100;3;7338;45
2406;Romancing the Stone;88011;7;42;36;6;85;0;4;1;3;25;3.2;14494;62
2407;Cocoon;88933;6.1;23;18;5;78;0;4;3;1;75;3.1;7543;55
2408;Cocoon: The Return;94890;4.6;10;3;7;30;0;1;0;1;0;2.7;2029;37
2409;Rocky II;79817;6.4;23;16;7;69;0;3;2;1;66;3.4;51625;79
2410;Rocky III;84602;5.4;29;18;11;62;0;2;1;1;50;3.3;48532;74
2411;Rocky IV;89927;4.7;34;15;19;44;0;4;0;4;0;3.4;53876;79
2412;Rocky V;100507;4;29;7;22;24;3.9;5;2;3;40;2.8;34216;53
2413;Clue;88930;6.2;19;14;5;73;0;2;0;2;0;3.6;16850;85
2414;Young Sherlock Holmes;90357;5.6;19;12;7;63;0;1;1;0;100;3.3;2485;63
2415;Violets Are Blue...;92173;5.3;7;4;3;57;0;1;1;0;100;3.4;93;39
2416;Back to School;90685;6.8;24;21;3;87;0;3;3;0;100;2.9;3814;60
2417;Heartburn;91188;5.7;11;7;4;63;0;1;0;1;0;3.2;1466;52
2418;Nothing in Common;91653;5.8;18;10;8;55;0;1;0;1;0;2.8;1198;38
2419;Extremities;91024;5.9;7;4;3;57;0;0;0;0;0;0;0;0
2420;The Karate Kid;87538;6.9;41;37;4;90;6.9;5;4;1;80;3.3;20688;71
2421;The Karate Kid, Part II;91326;4.8;20;8;12;40;0;0;0;0;0;0;0;0
2422;The Karate Kid, Part III;97647;4.1;17;4;13;23;0;2;0;2;0;2.8;9109;46
2423;Christmas Vacation;97958;6.2;34;21;13;61;6;5;2;3;40;3.5;21650;83
2424;You've Got Mail;128853;6.2;75;51;24;68;6.4;20;15;5;75;3.1;60706;70
2425;The General;17925;8.9;38;35;3;92;0;4;2;2;50;4.4;3785;93
2426;The Theory of Flight;120861;5.6;19;10;9;52;5.1;5;1;4;20;3.5;345;63
2427;The Thin Red Line;120863;7.1;80;63;17;78;7.5;22;21;1;95;3.4;27248;75
2428;The Faculty;133751;5.6;37;19;18;51;0;3;0;3;0;2.9;14071;55
2429;Mighty Joe Young;120751;5.8;42;22;20;52;7.2;5;4;1;80;2.8;10755;48
2430;Mighty Joe Young;120751;5.8;42;22;20;52;7.2;5;4;1;80;2.8;10755;48
2431;Patch Adams;129290;4;55;13;42;23;3.8;16;4;12;25;3.3;20869;77
2432;Stepmom;120686;5.1;53;23;30;43;5.3;17;8;9;47;3.3;22696;75
2433;A Civil Action;120633;6.4;66;40;26;60;5.8;13;7;6;53;3.1;3573;53
2434;Down in the Delta;142231;6.8;22;17;5;77;7.4;6;5;1;83;3.6;434;68
2435;Hurlyburly;119336;5.9;34;20;14;58;5.2;6;2;4;33;3.2;1455;56
2436;Tea with Mussolini;120857;6.4;33;22;11;66;6.3;6;3;3;50;3.5;1769;72
2437;Wilde;120514;\N;\N;\N;\N;\N;\N;\N;\N;\N;\N;\N;\N;\N
2439;Affliction;118564;7.6;44;38;6;86;8.8;7;7;0;100;3.4;1078;69
2440;Another Day in Paradise;127722;5.7;46;26;20;56;6.1;12;7;5;58;3.2;1703;57
2441;The Hi-Lo Country;120699;5.4;34;19;15;55;4.9;15;6;9;40;3.1;620;43
2442;Hilary and Jackie;150915;7.5;43;38;5;88;7.9;13;12;1;92;3.7;1702;81
2443;Playing by Heart;145734;6;51;32;19;62;6;12;6;6;50;3.6;5334;76
2444;24 7: Twenty Four Seven;120391;5.7;20;7;13;35;5.6;5;1;4;20;3.9;451;84
2445;At First Sight;132512;5.2;36;12;24;33;5.4;6;1;5;16;2.9;2599;48
2446;Requiem for a Dream;180093;7.4;127;99;28;77;6.6;32;21;11;65;4.1;103666;93
2447;Varsity Blues;139699;5;51;20;31;39;5;13;5;8;38;3.2;17053;75
2448;Virus;120458;3.2;44;4;40;9;2.8;13;1;12;7;2.4;2719;26
2449;The Garbage Pail Kids Movie;93072;1.9;11;0;11;0;0;1;0;1;0;2.6;1589;37
2450;Howard the Duck;91225;2.5;32;5;27;15;0;3;0;3;0;2.6;7309;43
2451;The Ninth Gate;142688;4.9;85;35;50;41;4;24;6;18;25;3.2;23993;60
2452;The Gate II: Trespassers;99636;0;0;0;0;0;0;0;0;0;0;0;0;0
2453;The Boy Who Could Fly;90768;5.9;16;11;5;68;0;1;1;0;100;3.2;1754;63
2454;The Fly;91064;8;44;40;4;90;0;3;1;2;33;3.3;14099;74
2455;The Fly;91064;8;44;40;4;90;0;3;1;2;33;3.3;14099;74
2456;The Fly II;97368;4.4;15;4;11;26;0;0;0;0;0;0;0;0
2457;Running Scared;404390;4.5;128;51;77;39;4.4;31;10;21;32;3.6;35992;77
2458;Armed and Dangerous;90660;3;7;1;6;14;0;0;0;0;0;0;0;0
2459;The Texas Chainsaw Massacre;324216;4.8;152;55;97;36;4.2;33;6;27;18;3.2;36030;67
2460;The Texas Chainsaw Massacre 2;92076;4.6;21;9;12;42;0;2;0;2;0;2.9;8495;51
2461;Leatherface: Texas Chainsaw Massacre III;99994;3.4;14;2;12;14;0;1;0;1;0;2.9;6411;52
2462;The Return of the Texas Chainsaw Massacre;110978;3.2;28;4;24;14;0;4;0;4;0;2.4;5539;34
2463;Ruthless People;91877;6.7;21;19;2;90;0;1;1;0;100;3.1;3852;62
2464;Trick 'r Treat;862856;7.5;20;17;3;85;0;1;1;0;100;3.5;15410;67
2465;Deadly Friend;90917;3.7;6;0;6;0;0;0;0;0;0;0;0;0
2466;Belizaire the Cajun;90710;6.2;6;4;2;66;0;1;1;0;100;3.6;147;63
2467;Der Name der Rose;91605;6.2;18;13;5;72;0;1;0;1;0;3.6;8830;83
2468;Jumpin' Jack Flash;91306;3.9;18;5;13;27;0;1;0;1;0;2.8;4253;55
2469;Peggy Sue Got Married;91738;6.8;24;21;3;87;6.8;7;5;2;71;2.9;5428;47
2470;Crocodile Dundee;90555;6.6;26;23;3;88;0;2;1;1;50;3;11828;55
2471;'Crocodile' Dundee II;92493;3.6;21;3;18;14;0;0;0;0;0;0;0;0
2472;Tough Guys Don't Dance;94169;4.9;18;7;11;38;0;4;2;2;50;3.3;251;49
2473;Soul Man;91991;3;22;3;19;13;0;4;1;3;25;2.6;1023;37
2474;The Color of Money;90863;7.3;34;31;3;91;6.8;8;6;2;75;3.3;8226;65
2475;52 Pick-Up;90567;5.8;10;5;5;50;0;1;1;0;100;3.1;248;48
2476;Heartbreak Ridge;91187;6.7;13;11;2;84;0;1;1;0;100;3.5;4368;73
2477;Firewalker;91055;3;10;0;10;0;0;4;0;4;0;2.8;1109;41
2478;¡Three Amigos!;92086;5.2;17;9;8;52;0;1;0;1;0;3.1;12978;65
2479;Gloria;120683;4.1;27;5;22;18;5.1;6;1;5;16;2.7;660;31
2480;Nettoyage à sec;119773;6.6;15;12;3;80;0;2;2;0;100;3.1;198;46
2481;My Name Is Joe;151691;7.3;23;20;3;86;8.1;5;5;0;100;3.8;1146;81
2482;Still Crazy;149151;6.5;25;18;7;72;7;6;4;2;66;3.8;1495;81
2483;El día de la bestia;112922;6.7;9;7;2;77;0;0;0;0;0;0;0;0
2485;She's All That;160862;4.9;55;21;34;38;4.8;12;3;9;25;3;53730;60
2486;The 24 Hour Woman;138279;5.8;14;8;6;57;0;4;3;1;75;3.4;50;50
2487;Blood, Guts, Bullets and Octane;163984;5.4;22;10;12;45;0;3;0;3;0;2.9;645;40
2488;Peeping Tom;54167;8.2;31;29;2;93;7.2;7;5;2;71;4;3195;85
2489;Spanish Fly;73407;\N;\N;\N;\N;\N;\N;\N;\N;\N;\N;\N;\N;\N
2490;Payback;120784;5.8;70;36;34;51;5;19;8;11;42;3.2;12940;67
2491;Simply Irresistible;145893;4;29;4;25;13;4.9;5;1;4;20;2.9;6203;55
2492;20 Dates;138987;4.8;31;12;19;38;3.1;10;0;10;0;0;0;0
2493;Comedian Harmonists;128133;7;35;28;7;80;7.3;11;9;2;81;3.8;302;84
2494;Last Days;403217;5.9;111;64;47;57;6;35;23;12;65;3.1;5692;53
2495;La planète sauvage;70544;7.1;22;19;3;86;0;2;1;1;50;4;2423;86
2496;Blast from the Past;124298;6.1;35;21;14;60;6.7;5;4;1;80;2.9;12330;54
2497;Message in a Bottle;139462;5.2;35;11;24;31;6;5;3;2;60;3.2;17649;67
2498;My Favorite Martian;56775;\N;\N;\N;\N;\N;\N;\N;\N;\N;\N;\N;\N;\N
2499;God Said, 'Ha!';119207;6.9;21;18;3;85;7.6;5;5;0;100;3.4;398;67
2500;Jawbreaker;155776;3.3;57;4;53;7;3;19;0;19;0;2.8;8386;54
2501;October Sky;132477;7.6;70;63;7;90;7.2;14;12;2;85;3.6;12678;84
2502;Office Space;151804;6.8;88;70;18;79;6.4;24;17;7;70;4;78802;92
2503;Sib;156901;7;20;16;4;80;8.2;5;5;0;100;3.7;409;77
2504;200 Cigarettes;137338;4.5;57;17;40;29;3.9;19;5;14;26;3;5146;54
2505;8MM;134273;4.2;78;17;61;21;3.1;21;2;19;9;3;14973;56
2506;The Other Sister;123209;4.7;48;14;34;29;4.6;13;4;9;30;3.3;8954;68
2507;Breakfast of Champions;120618;4.2;44;11;33;25;3.4;13;1;12;7;2.5;1509;31
2508;The Break-Up;452594;5;187;62;125;33;4.5;40;8;32;20;3.1;107481;52
2509;Eight Days a Week;119054;3.8;9;2;7;22;0;0;0;0;0;0;0;0
2510;Just the Ticket;134948;4.5;10;2;8;20;0;3;0;3;0;3;410;41
2511;The Long Goodbye;70334;8.2;24;23;1;95;0;2;2;0;100;4;2667;88
2512;Narayama-bushi kô;84390;8.2;9;9;0;100;0;1;1;0;100;4.3;634;91
2513;Pet Sematary;98084;5.2;18;9;9;50;0;0;0;0;0;0;0;0
2514;Pet Sematary II;105128;4;16;5;11;31;0;0;0;0;0;0;0;0
2515;Children of the Corn II: The Final Sacrifice;106557;2.3;8;2;6;25;0;1;0;1;0;2.8;2650;39
2516;Children of the Corn III: Urban Harvest;109415;0;1;0;1;0;0;0;0;0;0;0;0;0
2517;Christine;85333;5.7;21;14;7;66;0;4;1;3;25;3.2;10394;63
2518;Night Shift;84412;6.4;19;17;2;89;0;2;1;1;50;3.2;1720;55
2519;House on Haunted Hill;185371;4.4;53;13;40;24;3.5;11;2;9;18;2.9;13288;49
2520;Airport;65377;5.9;13;9;4;69;0;1;0;1;0;3.1;2253;48
2521;Airport 1975;71110;4.8;12;4;8;33;0;1;0;1;0;2.9;1688;36
2522;Airport '77;75648;0;0;0;0;0;0;0;0;0;0;0;0;0
2523;Rollercoaster;76636;6;6;3;3;50;0;0;0;0;0;0;0;0
2524;The Towering Inferno;72308;6.4;19;15;4;78;0;1;1;0;100;3.3;4474;67
2525;Albino Alligator;115495;5.5;17;8;9;47;5.4;6;2;4;33;3;1198;42
2526;Meteor;79550;3.6;11;1;10;9;0;0;0;0;0;0;0;0
2527;Westworld;70909;7.1;30;27;3;90;0;3;3;0;100;3.5;4334;68
2528;Logan's Run;74812;6.2;27;19;8;70;0;3;2;1;66;3.3;9250;65
2529;Planet of the Apes;63442;7.4;44;39;5;88;5.5;5;3;2;60;3.4;12844;80
2530;Beneath the Planet of the Apes;65462;5.3;22;9;13;40;0;1;0;1;0;3;4261;46
2531;Battle for the Planet of the Apes;69768;4.7;24;9;15;37;0;2;0;2;0;2.9;3262;38
2532;Conquest of the Planet of the Apes;68408;5.5;18;8;10;44;0;2;1;1;50;3;3697;49
2533;Escape from the Planet of the Apes;67065;5.7;23;18;5;78;0;2;2;0;100;3;3852;49
2534;Avalanche Alley;289079;0;0;0;0;0;0;0;0;0;0;0;0;0
2535;10.5;364146;0;0;0;0;0;0;0;0;0;0;0;0;0
2536;The Concorde... Airport '79;78740;4.3;5;1;4;20;0;2;1;1;50;2.5;369;23
2537;Beyond the Poseidon Adventure;78856;0;2;0;2;0;0;1;0;1;0;2.7;1212;33
2538;Dancemaker;175550;7.9;10;9;1;90;0;2;2;0;100;0;0;0
2539;Analyze This;122933;6.4;101;69;32;68;6;22;14;8;63;3.1;15881;57
2540;The Corruptor;142192;5.3;46;22;24;47;5.7;15;8;7;53;3;2255;43
2541;Cruel Intentions;139134;5.3;76;36;40;47;4.7;24;9;15;37;3.4;56824;79
2542;Lock, Stock and Two Smoking Barrels;120735;6.8;51;37;14;72;5.9;14;8;6;57;4;81696;92
2543;Six Ways to Sunday;127288;4.8;10;4;6;40;0;1;0;1;0;3.3;459;58
2544;L'école de la chair;157208;6.1;18;13;5;72;0;4;4;0;100;3.5;272;59
2545;Relax... It's Just Sex;159696;5.9;16;8;8;50;0;3;2;1;66;3.4;732;64
2546;The Deep End of the Ocean;120646;5.8;33;14;19;42;5.2;7;1;6;14;3.2;2998;62
2548;The Rage: Carrie 2;144814;0;0;0;0;0;0;0;0;0;0;0;0;0
2549;Wing Commander;131646;2.8;46;5;41;10;2.2;11;0;11;0;2.2;2768;26
2550;The Haunting;171363;3.7;87;15;72;17;3.1;24;3;21;12;2.7;10812;42
2551;Dead Ringers;94964;7.7;35;29;6;82;5.7;6;3;3;50;3.6;4690;80
2552;My Boyfriend's Back;107626;3.4;10;1;9;10;0;2;0;2;0;2.7;1035;43
2553;Village of the Damned;114852;4;30;9;21;30;4.2;5;2;3;40;2.7;4194;36
2554;Children of the Damned;56931;5.6;12;9;3;75;0;0;0;0;0;0;0;0
2555;Baby Geniuses;118665;1.9;43;1;42;2;2.1;10;0;10;0;2.5;8215;32
2556;Telling You;120859;5.6;5;1;4;20;0;0;0;0;0;0;0;0
2557;Seul contre tous;157016;7.7;20;17;3;85;0;2;2;0;100;3.9;1587;82
2558;Forces of Nature;141098;5.3;63;29;34;46;4.7;18;6;12;33;2.6;7489;37
2559;The King and I;49408;8.2;19;19;0;100;0;1;1;0;100;3.6;12939;79
2560;Ravenous;129332;5.5;36;14;22;38;5.2;6;2;4;33;3.6;4588;78
2561;True Crime;139668;6;38;20;18;52;6.8;6;5;1;83;3.2;2873;51
2562;Bandits;219965;6.1;136;86;50;63;5.9;34;20;14;58;3.1;9238;56
2563;Dangerous Beauty;118892;6.4;26;18;8;69;6.8;7;5;2;71;4.1;2764;87
2565;The King and I;49408;8.2;19;19;0;100;0;1;1;0;100;3.6;12939;79
2566;Doug's 1st Movie;187819;4.6;32;8;24;25;4.4;9;3;6;33;2.9;1446;43
2567;Edtv;131369;6.3;42;26;16;61;6.2;7;3;4;42;2.6;8130;31
2568;The Mod Squad;120757;3;51;2;49;3;3.4;13;1;12;7;2.4;1890;21
2569;Among Giants;122906;5.5;19;11;8;57;0;4;2;2;50;3.2;111;33
2570;A Walk on the Moon;120613;6.7;35;25;10;71;6.6;6;4;2;66;3.4;2848;67
2571;The Matrix;133093;7.4;125;108;17;86;6.2;28;19;9;67;3.6;207333;81
2572;10 Things I Hate About You;147800;6;58;34;24;58;6.3;12;7;5;58;3.3;207830;69
2573;Tango;120274;6.8;20;14;6;70;8.5;5;4;1;80;3.9;767;82
2574;The Out-of-Towners;129280;5;34;8;26;23;4.9;5;1;4;20;2.6;2186;33
2575;La vie rêvée des anges;120449;7.6;42;39;3;92;8;13;13;0;100;3.9;1181;83
2576;Love, etc.;116932;0;4;2;2;50;0;1;1;0;100;3.2;217;54
2577;Metroland;119665;6.4;27;17;10;62;0;4;3;1;75;3.3;1014;55
2578;The Sticky Fingers of Time;127302;6.2;5;4;1;80;0;2;2;0;100;3;247;48
2579;Following;154506;7.1;21;16;5;76;0;3;1;2;33;3.8;7121;85
2580;Go;139239;7.6;72;66;6;91;7;19;15;4;78;3.2;8608;72
2581;Never Been Kissed;151738;5.7;79;44;35;55;5.4;25;12;13;48;3.3;53088;70
2582;Shuang long hui;105399;5.1;37;16;21;43;4.5;7;3;4;42;3.1;3144;55
2583;Cookie's Fortune;126250;7.5;55;47;8;85;7.4;12;11;1;91;3.2;1364;57
2584;Foolish Wives;13140;9;7;7;0;100;0;0;0;0;0;0;0;0
2585;Los amantes del Círculo Polar;133363;7;23;19;4;82;0;4;4;0;100;4.3;3613;92
2586;Goodbye Lover;119219;4.7;33;10;23;30;3.6;10;1;9;10;2.9;457;35
2587;Waking Life;243017;7.4;137;109;28;79;7.6;32;26;6;81;4;17715;87
2589;Friends & Lovers;143261;0;0;0;0;0;0;0;0;0;0;0;0;0
2590;Hideous Kinky;136244;5.9;34;21;13;61;0;4;3;1;75;3.3;2069;56
2591;Jeanne et le garçon formidable;123923;5.8;5;3;2;60;0;2;2;0;100;3.3;323;55
2593;Il mostro;110570;5.8;10;4;6;40;0;1;0;1;0;3.8;1005;78
2594;Abre los ojos;125659;7.4;45;38;7;84;6.9;8;6;2;75;3.9;11790;85
2595;Fotoamator;188996;\N;\N;\N;\N;\N;\N;\N;\N;\N;\N;\N;\N;\N
2596;SLC Punk!;133189;5.6;31;19;12;61;6.2;5;3;2;60;3.8;9837;89
2597;Lost & Found;120836;3.6;52;7;45;13;2.8;18;0;18;0;2.5;1416;30
2598;Pushing Tin;120797;5.6;65;32;33;49;5.5;16;8;8;50;2.9;5381;43
2599;Election;126886;7.8;101;93;8;92;7.7;23;21;2;91;3.3;11134;72
2600;eXistenZ;120907;6.7;62;44;18;70;5.7;10;5;5;50;3.2;10592;65
2601;A Little Bit of Soul;119546;0;4;2;2;50;0;0;0;0;0;0;0;0
2602;Xing xing wang;76164;0;0;0;0;0;0;0;0;0;0;0;0;0
2603;Revolutionary Road;959337;6.7;194;133;61;68;6.9;36;25;11;69;3.5;46044;70
2604;Let It Come Down: The Life of Paul Bowles;168950;0;3;3;0;100;0;2;2;0;100;3;172;45
2605;Entrapment;137494;5.2;80;30;50;37;4.7;18;7;11;38;3;17343;57
2606;Idle Hands;138510;3.4;53;8;45;15;3;17;1;16;5;2.9;8232;57
2607;Get Real;162973;6.4;45;35;10;77;6.4;13;10;3;76;3.8;2164;79
2609;Bian Lian;115669;7.4;18;16;2;88;7.7;5;5;0;100;4.1;775;88
2610;Three Seasons;138874;6.7;30;24;6;80;0;4;4;0;100;0;0;0
2611;The Winslow Boy;155388;7.9;35;34;1;97;8.2;6;6;0;100;3.6;768;70
2612;Mildred Pierce;37913;7.6;30;26;4;86;0;2;2;0;100;4.1;2165;90
2613;Night of the Comet;87799;6.5;20;17;3;85;0;2;2;0;100;3.3;2733;57
2614;Chopping Mall;90837;4.4;5;2;3;40;0;0;0;0;0;0;0;0
2615;My Science Project;89652;3.2;5;1;4;20;0;0;0;0;0;0;0;0
2616;Dick Tracy;99422;5.7;43;28;15;65;4.6;8;3;5;37;2.8;10803;44
2617;The Mummy;120616;5.7;81;44;37;54;5.1;17;7;10;41;3.4;79634;75
2618;The Castle;118826;6.9;33;29;4;87;6.6;6;5;1;83;4.1;3419;91
2619;Mascara;93504;0;0;0;0;0;0;0;0;0;0;0;0;0
2620;This Is My Father;120865;6.7;27;20;7;74;6;5;4;1;80;3.9;442;79
2621;Tian yu;115005;8;24;23;1;95;9;5;5;0;100;3.8;593;81
2622;A Midsummer Night's Dream;140379;0;0;0;0;0;0;0;0;0;0;0;0;0
2623;Trippin';160298;4.2;12;1;11;8;0;4;0;4;0;3.8;73;62
2624;Wandâfuru raifu;165078;6.9;22;18;4;81;0;4;4;0;100;4.1;1840;90
2625;Hak hap;115693;4.9;28;14;14;50;0;1;0;1;0;0;0;0
2626;Edge of Seventeen;138414;0;0;0;0;0;0;0;0;0;0;0;0;0
2627;The Endurance: Shackleton's Legendary Antarctic Expedition;264578;7.7;65;62;3;95;7.9;24;24;0;100;3.8;415;79
2628;Star Wars: Episode I - The Phantom Menace;120915;0;0;0;0;0;0;0;0;0;0;0;0;0
2629;The Love Letter;166252;0;0;0;0;0;0;0;0;0;0;0;0;0
2630;Besieged;149723;7;46;34;12;73;6.7;12;7;5;58;3.7;762;80
2631;Frogs for Snakes;120680;4.4;10;3;7;30;0;2;0;2;0;3.4;141;50
2632;Rekopis znaleziony w Saragossie;59643;7.3;10;9;1;90;0;2;2;0;100;4.2;509;90
2633;The Mummy;120616;5.7;81;44;37;54;5.1;17;7;10;41;3.4;79634;75
2634;The Mummy;120616;5.7;81;44;37;54;5.1;17;7;10;41;3.4;79634;75
2635;The Mummy's Curse;37098;6.2;7;4;3;57;0;0;0;0;0;0;0;0
2636;The Mummy's Ghost;37099;0;4;2;2;50;0;0;0;0;0;0;0;0
2637;The Mummy's Hand;32818;6.1;7;5;2;71;0;0;0;0;0;0;0;0
2638;The Mummy: Tomb of the Dragon Emperor;859163;3.7;161;21;140;13;3.7;32;3;29;9;3;79989;40
2639;Mommie Dearest;82766;5.6;30;17;13;56;4.8;5;2;3;40;3.6;3417;78
2640;Superman;78346;8;52;49;3;94;7.4;6;5;1;83;3.5;39510;77
2641;Superman II;81573;7.4;41;36;5;87;8.4;5;5;0;100;3.2;30072;66
2642;Superman III;86393;4.4;40;9;31;22;0;3;0;3;0;2.7;17727;39
2643;Superman IV: The Quest for Peace;94074;2.8;30;3;27;10;3.2;5;1;4;20;2.5;13076;30
2644;Dracula;21814;7.7;42;39;3;92;7.7;6;6;0;100;3.6;8598;76
2646;House of Dracula;37793;5.7;7;4;3;57;0;1;0;1;0;3.1;1009;41
2647;House of Frankenstein;36931;5.6;10;6;4;60;0;0;0;0;0;0;0;0
2648;Frankenstein;21884;8.5;38;38;0;100;7.8;5;5;0;100;3.6;7211;81
2649;Son of Frankenstein;31951;7.3;18;17;1;94;0;2;2;0;100;0;0;0
2650;The Ghost of Frankenstein;34786;6.3;8;7;1;87;0;0;0;0;0;0;0;0
2651;Frankenstein Meets the Wolf Man;35899;5.2;10;3;7;30;0;0;0;0;0;0;0;0
2652;The Curse of Frankenstein;50280;7.6;7;7;0;100;0;0;0;0;0;0;0;0
2653;Son of Dracula;36376;\N;\N;\N;\N;\N;\N;\N;\N;\N;\N;\N;\N;\N
2654;The Wolf Man;34398;7.7;31;29;2;93;0;3;2;1;66;3.7;2541;77
2655;Howling II: Stirba - Werewolf Bitch;89308;3.1;6;1;5;16;0;1;0;1;0;2.5;1403;27
2656;Tarantula;48696;6.3;11;10;1;90;0;0;0;0;0;0;0;0
2657;The Rocky Horror Picture Show;73629;6.5;35;27;8;77;0;3;0;3;0;3.6;49873;85
2659;It Came from Hollywood;84156;0;0;0;0;0;0;0;0;0;0;0;0;0
2660;The Thing from Another World;44121;7.7;26;23;3;88;0;2;1;1;50;3.6;2130;71
2661;It Came from Outer Space;45920;6.8;26;21;5;80;0;3;2;1;66;3.1;796;51
2662;War of the Worlds;407304;7;244;178;66;72;6.7;42;28;14;66;2.9;162092;45
2663;It Came from Beneath the Sea;48215;6;7;5;2;71;0;0;0;0;0;0;0;0
2664;Invasion of the Body Snatchers;49366;8.9;36;36;0;100;0;2;2;0;100;3.6;3820;81
2665;Earth vs. the Flying Saucers;49169;5.7;13;9;4;69;0;0;0;0;0;0;0;0
2666;It Conquered the World;49370;5.6;5;4;1;80;0;0;0;0;0;0;0;0
2667;The Mole People;49516;0;4;1;3;25;0;0;0;0;0;0;0;0
2668;Swamp Thing;84745;5.8;26;18;8;69;0;3;1;2;33;2.7;3423;34
2669;Pork Chop Hill;53183;0;4;4;0;100;0;0;0;0;0;0;0;0
2670;Run Silent Run Deep;52151;7;7;7;0;100;0;0;0;0;0;0;0;0
2671;Notting Hill;125439;7.1;97;80;17;82;6.8;28;21;7;75;3.3;85951;74
2672;The Thirteenth Floor;139809;4.5;61;17;44;27;3.8;18;3;15;16;3;5631;61
2673;Mia aioniotita kai mia mera;156794;7.2;21;20;1;95;7.2;6;5;1;83;4.3;1029;91
2674;The Loss of Sexual Innocence;126859;4.8;29;13;16;44;7;5;4;1;80;3.3;449;60
2675;The Man with Rain in His Shoes;138590;4.8;21;6;15;28;0;3;1;2;33;3.3;477;55
2676;Instinct;128278;4.3;66;18;48;27;3.7;15;3;12;20;3.2;4403;67
2677;Buena Vista Social Club;186508;7.5;41;37;4;90;8.2;7;6;1;85;4;2963;88
2678;Desert Blue;126261;5.1;18;7;11;38;0;4;1;3;25;3.2;414;49
2679;Finding North;124555;4.7;9;4;5;44;0;1;0;1;0;2.9;277;33
2681;Free Enterprise;141105;\N;\N;\N;\N;\N;\N;\N;\N;\N;\N;\N;\N;\N
2682;Limbo;164085;7;39;28;11;71;6.9;6;3;3;50;3.5;169;75
2683;Austin Powers: The Spy Who Shagged Me;145660;6;85;44;41;51;5.6;20;11;9;55;3.3;70870;73
2685;Le nain rouge;156820;\N;\N;\N;\N;\N;\N;\N;\N;\N;\N;\N;\N;\N
2686;Le violon rouge;120802;7.1;39;28;11;71;7.4;6;5;1;83;3.9;7025;91
2687;Tarzan;120855;7.6;101;89;12;88;7.3;27;23;4;85;3.2;30231;63
2688;The General's Daughter;144214;4.3;87;19;68;21;3.5;23;3;20;13;3;6034;55
2689;Get Smart's Bruce and Lloyd Out of Control;1018723;0;2;1;1;50;0;0;0;0;0;0;0;0
2690;An Ideal Husband;122541;7.4;63;54;9;85;7.4;15;14;1;93;3.4;2877;66
2691;La leggenda del pianista sull'oceano;120731;6.2;35;19;16;54;6;5;2;3;40;4.2;5983;92
2692;Lola rennt;130827;7.7;78;72;6;92;7.5;20;19;1;95;3.8;33702;88
2693;Trekkies;120370;7.3;41;35;6;85;6.9;6;4;2;66;3.4;1371;67
2694;Big Daddy;142342;0;0;0;0;0;0;0;0;0;0;0;0;0
2695;The Lost Boys;93437;6.3;40;30;10;75;0;4;2;2;50;3.7;48695;85
2696;Le dîner de cons;119038;6.8;44;32;12;72;7.7;11;10;1;90;4.1;5214;90
2697;My Son the Fanatic;119743;6.9;27;21;6;77;7.4;6;4;2;66;3.5;322;73
2699;Arachnophobia;99052;6.6;26;22;4;84;0;2;2;0;100;2.8;10804;43
2700;South Park: Bigger Longer & Uncut;158983;7;92;74;18;80;6.7;24;20;4;83;3.7;46689;86
2701;Wild Wild West;120891;3.9;102;21;81;20;3.7;24;4;20;16;2.7;31689;39
2702;Summer of Sam;162677;0;0;0;0;0;0;0;0;0;0;0;0;0
2703;Broken Vessels;149964;5.7;14;9;5;64;0;3;2;1;66;0;0;0
2704;Les amants du Pont-Neuf;101318;7.1;14;11;3;78;0;2;2;0;100;4;1699;86
2705;Fin août, début septembre;167925;6.7;22;18;4;81;7.6;7;7;0;100;3.5;332;61
2706;American Pie;163651;5.7;115;67;48;58;5.5;25;13;12;52;3.4;203348;63
2707;Arlington Road;137363;6.1;86;52;34;60;5.7;19;9;10;47;3.3;6430;72
2708;Conte d'automne;137439;7.8;32;30;2;93;8.3;11;11;0;100;3.8;273;81
2709;Muppets from Space;158811;6.2;53;33;20;62;5.6;20;10;10;50;3;4740;55
2710;The Blair Witch Project;185937;7.5;125;106;19;84;7.2;28;25;3;89;2.5;23900;47
2711;My Life So Far;120899;6.3;25;18;7;72;6.2;5;3;2;60;3.1;618;41
2712;Eyes Wide Shut;120663;7.3;119;93;26;78;6.7;26;18;8;69;2.9;26285;66
2713;Lake Placid;139414;5;68;26;42;38;4;17;4;13;23;2.6;12183;40
2714;The Wood;161100;6;56;34;22;60;5.7;17;10;7;58;3.9;6421;90
2715;The Velocity of Gary* *(Not His Real Name);120878;4.1;17;4;13;23;0;1;0;1;0;3.1;516;49
2716;Ghost Busters;87332;7.6;46;43;3;93;6.2;5;3;2;60;3.6;65639;81
2717;Ghostbusters II;97428;5.2;34;18;16;52;5.4;5;3;2;60;3.2;30085;62
2718;Drop Dead Gorgeous;157503;\N;\N;\N;\N;\N;\N;\N;\N;\N;\N;\N;\N;\N
2719;The Haunting;171363;3.7;87;15;72;17;3.1;24;3;21;12;2.7;10812;42
2720;Inspector Gadget;141369;4;61;13;48;21;3.9;21;4;17;19;2.3;11127;26
2721;Trick;162710;6.8;22;17;5;77;6.8;6;4;2;66;3.7;1364;80
2722;Deep Blue Sea;149261;5.7;89;51;38;57;5.8;22;14;8;63;2.8;26286;44
2723;Mystery Men;132347;5.7;100;60;40;60;5.7;28;17;11;60;2.8;14333;52
2724;Runaway Bride;163187;5.3;82;37;45;45;4.8;27;10;17;37;3;48629;57
2725;Twin Falls Idaho;162830;7.3;44;34;10;77;7.6;7;6;1;85;3.8;751;82
2726;The Killing;49406;8.3;26;25;1;96;0;3;3;0;100;4;5595;90
2727;Killer's Kiss;48254;6.8;17;14;3;82;0;3;3;0;100;3.3;2112;56
2728;Spartacus;54331;8.1;45;43;2;95;0;4;3;1;75;3.7;25019;79
2729;Lolita;56193;8;38;37;1;97;0;2;2;0;100;3.7;11593;80
2730;Barry Lyndon;72684;7.8;49;46;3;93;7.5;7;7;0;100;4.1;12262;90
2731;Les quatre cents coups;53198;9.3;48;48;0;100;8.8;8;8;0;100;4.4;9787;95
2732;Jules et Jim;55032;8.9;31;30;1;96;0;4;4;0;100;4.2;6006;89
2733;Vibes;96378;2.8;7;0;7;0;0;1;0;1;0;3.3;404;59
2734;The Mosquito Coast;91557;6.4;20;15;5;75;0;1;0;1;0;3.2;3391;55
2735;The Golden Child;91129;3.9;19;5;14;26;0;2;1;1;50;2.9;9053;49
2736;Brighton Beach Memoirs;90774;5.7;9;6;3;66;0;1;0;1;0;3.4;596;69
2737;The Assassination of Jesse James by the Coward Robert Ford;443680;7.1;162;121;41;74;6.6;36;22;14;61;3.7;57534;73
2738;Crimes of the Heart;90886;7.6;14;14;0;100;0;1;1;0;100;3.3;602;53
2739;The Color Purple;88939;6.7;24;21;3;87;0;1;1;0;100;3.9;30970;93
2741;No Mercy;91637;3.4;13;2;11;15;4.4;5;2;3;40;2.8;740;32
2742;Tenue de soirée;92068;0;4;3;1;75;0;1;1;0;100;3.8;345;75
2743;Native Son;91613;6;9;5;4;55;0;4;1;3;25;3.4;71;61
2744;Otello;256244;\N;\N;\N;\N;\N;\N;\N;\N;\N;\N;\N;\N;\N
2745;The Mission;91530;6.4;16;11;5;68;0;2;1;1;50;3.8;11307;83
2746;The Little Shop of Horrors;54033;6.2;11;10;1;90;0;0;0;0;0;0;0;0
2747;The Little Shop of Horrors;54033;6.2;11;10;1;90;0;0;0;0;0;0;0;0
2748;Allan Quatermain and the Lost City of Gold;92534;0;3;2;1;66;0;0;0;0;0;0;0;0
2749;The Morning After;91554;5.8;15;11;4;73;0;1;1;0;100;2.9;557;33
2750;Radio Days;93818;7.9;21;20;1;95;0;1;1;0;100;3.8;3253;82
2751;From the Hip;93051;4.7;6;1;5;16;0;1;0;1;0;3.2;411;59
2752;Outrageous Fortune;93690;5;20;10;10;50;5;5;2;3;40;3;1206;54
2753;The Bedroom Window;92627;6;14;12;2;85;0;0;0;0;0;0;0;0
2754;Deadtime Stories;92850;0;3;0;3;0;0;0;0;0;0;0;0;0
2755;Light of Day;93415;5.2;12;7;5;58;0;1;1;0;100;3.1;311;41
2756;Wanted: Dead or Alive;94293;4.1;8;2;6;25;0;1;0;1;0;2.9;934;43
2757;Frances;83967;7.6;15;14;1;93;0;1;1;0;100;3.8;713;78
2758;Plenty;89816;7.3;7;5;2;71;0;1;1;0;100;3.4;613;54
2759;Dick;144168;6.3;70;49;21;70;6.6;26;19;7;73;2.7;3840;45
2761;The Iron Giant;129167;8;111;108;3;97;7.7;31;30;1;96;3.3;17836;72
2762;The Sixth Sense;167404;7.4;126;107;19;84;6.8;28;22;6;78;3.8;100968;87
2763;The Thomas Crown Affair;155267;6.4;88;59;29;67;6.6;25;18;7;72;3.3;15699;71
2764;The Thomas Crown Affair;155267;6.4;88;59;29;67;6.6;25;18;7;72;3.3;15699;71
2765;The Acid House;122515;5.8;19;9;10;47;0;2;1;1;50;3.5;2715;68
2766;The Adventures of Sebastian Cole;168449;5.7;22;9;13;40;6.6;5;4;1;80;0;0;0
2767;Illuminata;120709;5.6;23;9;14;39;5.5;7;3;4;42;3.4;320;64
2768;Stiff Upper Lips;120210;4.8;7;2;5;28;0;0;0;0;0;0;0;0
2769;The Whole Ten Yards;327247;2.8;116;5;111;4;3.3;31;2;29;6;3;11437;51
2770;Bowfinger;131325;7.1;107;85;22;79;7.3;26;23;3;88;2.8;8721;49
2771;Brokedown Palace;120620;4.7;34;10;24;29;6;5;3;2;60;3.2;4980;66
2772;Detroit Rock City;165710;5.4;36;17;19;47;4.6;5;1;4;20;3.5;9815;80
2773;Alice et Martin;176422;6.3;42;26;16;61;6.6;13;10;3;76;3.4;246;51
2774;Better Than Chocolate;168987;5.8;21;8;13;38;0;4;1;3;25;3.8;3884;78
2775;Gegen die Wand;347048;0;0;0;0;0;0;0;0;0;0;0;0;0
2776;Marcello Mastroianni: mi ricordo, sì, io mi ricordo;119614;7.8;7;7;0;100;0;1;1;0;100;3;175;48
2777;Cobra;90859;2.5;14;1;13;7;0;3;1;2;33;2.7;5821;43
2778;Never Talk to Strangers;113965;3.6;20;3;17;15;5;5;2;3;40;2.8;1191;41
2779;Heaven Can Wait;35979;7.8;9;8;1;88;0;0;0;0;0;0;0;0
2780;The Raven;57449;6.4;9;8;1;88;0;0;0;0;0;0;0;0
2781;The Tingler;53363;5.9;14;10;4;71;0;0;0;0;0;0;0;0
2782;Pit and the Pendulum;55304;6.4;14;11;3;78;0;0;0;0;0;0;0;0
2783;The Tomb of Ligeia;59821;6.4;6;5;1;83;0;0;0;0;0;0;0;0
2784;The Masque of the Red Death;58333;5.9;12;7;5;58;0;0;0;0;0;0;0;0
2785;Tales of Terror;56552;6.1;10;6;4;60;0;0;0;0;0;0;0;0
2786;Haunted Honeymoon;91178;3.5;8;2;6;25;0;0;0;0;0;0;0;0
2787;Cat's Eye;88889;5.5;23;15;8;65;0;3;2;1;66;3.1;5931;52
2788;And Now for Something Completely Different;66765;6.9;19;17;2;89;0;2;1;1;50;3.8;16003;85
2789;Damien: Omen II;77394;0;0;0;0;0;0;0;0;0;0;0;0;0
2790;Earth: Final Conflict;123816;\N;\N;\N;\N;\N;\N;\N;\N;\N;\N;\N;\N;\N
2791;Airplane!;80339;8.3;49;48;1;97;7.8;5;5;0;100;3.6;31137;85
2792;Airplane II: The Sequel;83530;5.2;18;7;11;38;0;1;0;1;0;2.9;10524;52
2793;An American Werewolf in Paris;118604;3.7;25;2;23;8;4.5;6;1;5;16;2.8;10235;38
2794;European Vacation;89670;4.8;20;8;12;40;0;0;0;0;0;0;0;0
2795;Vacation;85995;7.3;34;32;2;94;0;3;3;0;100;3.5;11330;80
2796;Funny Farm;95188;5.2;17;11;6;64;0;1;1;0;100;2.9;2927;51
2797;Big;94737;7.9;52;50;2;96;6.8;5;4;1;80;3.4;33658;73
2798;Problem Child 2;102719;2.6;12;2;10;16;0;1;0;1;0;0;0;0
2799;Problem Child 2;102719;2.6;12;2;10;16;0;1;0;1;0;0;0;0
2800;Little Nemo: Adventures in Slumberland;104740;0;0;0;0;0;0;0;0;0;0;0;0;0
2801;Oscar and Lucinda;119843;6.6;31;20;11;64;7.8;7;6;1;85;0;0;0
2802;Tequila Sunrise;96244;5.1;18;9;9;50;0;3;0;3;0;2.9;3959;44
2803;The Pelican Brief;107798;5.5;47;25;22;53;5.5;7;3;4;42;3.2;12632;62
2804;A Christmas Story;85334;8.3;43;38;5;88;0;3;2;1;66;3.7;23109;82
2805;Mickey Blue Eyes;130121;5.4;72;32;40;44;5.1;22;8;14;36;2.7;6320;39
2806;Teaching Mrs. Tingle;133046;4;68;13;55;19;4;24;5;19;20;2.5;4339;34
2807;Universal Soldier: The Return;176269;2.8;51;3;48;5;3.6;17;3;14;17;2.4;4533;35
2808;Universal Soldier;105698;4.2;23;5;18;21;4.3;7;2;5;28;2.8;9415;48
2809;Love Stinks;188863;3.5;47;9;38;19;3.8;16;3;13;18;3.2;1225;66
2810;Perfect Blue;156887;6.4;22;14;8;63;0;2;1;1;50;3.9;4350;86
2811;With Friends Like These...;119692;5.4;14;7;7;50;4.7;5;2;3;40;2.6;46;33
2812;In Too Deep;160401;4.9;55;20;35;36;5.8;20;10;10;50;3.6;1315;76
2813;The Source;181833;0;0;0;0;0;0;0;0;0;0;0;0;0
2814;The Vampire Bat;24727;0;4;2;2;50;0;0;0;0;0;0;0;0
2815;Iron Eagle;91278;3.6;5;2;3;40;0;0;0;0;0;0;0;0
2816;Iron Eagle II;95382;0;1;0;1;0;0;0;0;0;0;0;0;0
2817;Aces: Iron Eagle III;103617;2.2;6;0;6;0;0;1;0;1;0;2.5;1084;27
2818;Iron Eagle IV;113438;0;0;0;0;0;0;0;0;0;0;0;0;0
2819;Three Days of the Condor;73802;7;37;32;5;86;0;4;2;2;50;3.8;3200;83
2820;Hamlet;116477;8.2;54;51;3;94;7.2;14;11;3;78;3.8;5816;86
2821;Male and Female;10418;0;0;0;0;0;0;0;0;0;0;0;0;0
2822;Medicine Man;104839;3.9;18;4;14;22;0;2;0;2;0;2.9;3697;51
2823;Die Spinnen, 1. Teil - Der Goldene See;10726;0;3;3;0;100;0;0;0;0;0;0;0;0
2824;On the Ropes;181733;7.6;13;12;1;92;0;3;3;0;100;3.3;155;63
2825;Ring Around the Rosie;331488;0;3;0;3;0;0;0;0;0;0;0;0;0
2826;The 13th Warrior;120657;4.6;86;28;58;32;4.9;18;7;11;38;3.2;24204;66
2827;The Astronaut's Wife;138304;4.2;57;9;48;15;4.6;18;5;13;27;2.8;11206;42
2829;The Muse;164108;5.9;76;39;37;51;5.6;23;10;13;43;2.6;1169;29
2830;Bure baruta;169145;7.8;13;11;2;84;0;4;4;0;100;3.8;311;78
2831;A Dog of Flanders;160216;4.5;23;4;19;17;0;3;0;3;0;3.7;259;76
2832;The Lost Son;144286;0;3;2;1;66;0;0;0;0;0;0;0;0
2833;Lucie Aubrac;119586;7;22;17;5;77;7;7;5;2;71;3.6;169;67
2834;Martha - Meet Frank, Daniel and Laurence;120747;5.1;8;3;5;37;0;1;0;1;0;3.3;1423;59
2835;Chill Factor;163579;3.3;72;5;67;6;3;23;0;23;0;2.7;2079;36
2836;Outside Providence;125971;5.6;74;37;37;50;6.2;24;15;9;62;3.2;1355;60
2837;Bedrooms and Hallways;126810;6.3;13;9;4;69;0;1;1;0;100;3.6;615;70
2839;West Beyrouth (À l'abri les enfants);157183;7.2;15;14;1;93;0;1;1;0;100;4.3;382;92
2840;Stigmata;145531;4;88;19;69;21;3.2;24;3;21;12;3.1;12281;65
2841;Stir of Echoes;164181;6.4;103;69;34;66;6.4;25;18;7;72;3.4;14833;69
2842;Best Laid Plans;133412;5.8;20;9;11;45;0;4;2;2;50;3.1;1229;43
2843;Crna macka, beli macor;118843;6.9;18;16;2;88;0;2;2;0;100;4.4;6471;94
2844;The Minus Man;151582;5.9;34;20;14;58;6.7;8;6;2;75;3;1065;43
2845;Whiteboyz;178988;4;15;2;13;13;0;3;0;3;0;2.6;58;27
2846;Koneko monogatari;97050;6.6;9;7;2;77;0;0;0;0;0;0;0;0
2847;Only Angels Have Wings;31762;8.4;11;11;0;100;0;1;1;0;100;3.8;1509;78
2848;Othello;114057;6.3;38;26;12;68;6.1;11;7;4;63;3.3;2018;66
2849;Queens Logic;102741;5.2;7;3;4;42;0;2;0;2;0;2.9;360;29
2850;Wayne's World;105793;6.8;45;38;7;84;6.4;7;5;2;71;3.4;45784;80
2851;Saturn 3;79285;3.8;7;1;6;14;0;1;0;1;0;0;0;0
2852;A Soldier's Story;88146;7.2;16;14;2;87;0;2;0;2;0;3.7;1759;80
2853;Communion;76150;0;3;2;1;66;0;0;0;0;0;0;0;0
2854;The Forgotten;69994;0;4;0;4;0;0;0;0;0;0;0;0;0
2855;The Power of Nightmares: The Rise of the Politics of Fear;430484;8.1;7;6;1;85;8;5;4;1;80;4.5;575;96
2856;I Saw What You Did;59297;0;1;0;1;0;0;0;0;0;0;0;0;0
2857;Yellow Submarine;63823;7.6;36;34;2;94;7.2;8;7;1;87;3.6;7369;82
2858;American Beauty;169547;8;151;134;17;88;7.8;32;29;3;90;3.8;115181;90
2859;Stop Making Sense;88178;8.8;29;28;1;96;0;3;3;0;100;4.4;1700;95
2860;Blue Streak;181316;4.8;68;24;44;35;4.4;20;6;14;30;3;13413;65
2861;For Love of the Game;126916;6.3;55;35;20;63;6;8;4;4;50;3.3;6328;74
2862;Caligola;80491;2.9;28;6;22;21;0;3;0;3;0;2.8;3230;42
2863;A Hard Day's Night;58182;8.2;72;72;0;100;7.9;22;22;0;100;3.9;9274;87
2864;American Splendor;305206;8.3;178;167;11;93;8.6;42;42;0;100;3.7;9157;85
2865;Sugar Town;173390;6.2;24;16;8;66;5.9;6;3;3;50;3;177;41
2866;The Buddy Holly Story;77280;7.3;15;15;0;100;0;0;0;0;0;0;0;0
2867;Fright Night;89175;7.3;27;25;2;92;0;3;2;1;66;3.3;7746;70
2868;Fright Night Part 2;97390;4.7;6;2;4;33;0;0;0;0;0;0;0;0
2869;La séparation;111342;\N;\N;\N;\N;\N;\N;\N;\N;\N;\N;\N;\N;\N
2870;Barefoot in the Park;61385;6.4;13;11;2;84;0;1;0;1;0;3.7;3074;77
2871;Deliverance;68473;8.5;50;47;3;94;5.8;5;2;3;40;3.6;10182;79
2872;Excalibur;82348;7.3;25;20;5;80;0;3;1;2;33;3.4;11195;74
2873;Lulu on the Bridge;125879;3.6;8;0;8;0;0;1;0;1;0;0;0;0
2874;The Pajama Game;50814;7.4;10;9;1;90;0;0;0;0;0;0;0;0
2875;Sommersby;108185;5.9;23;14;9;60;7;6;5;1;83;3.1;2582;55
2876;Thumbelina;111419;5.2;8;2;6;25;0;2;1;1;50;3.1;9634;64
2877;Tommy;73812;7.1;15;13;2;86;0;1;1;0;100;3.4;5178;71
2878;Hell Night;82511;4.5;6;3;3;50;0;1;0;1;0;3;927;45
2879;Fei ying gai wak;99558;6.4;32;22;10;68;6.5;13;11;2;84;3.2;3303;65
2880;Long xiong hu di;91431;6.6;8;6;2;75;0;0;0;0;0;0;0;0
2881;Double Jeopardy;150377;4.4;83;21;62;25;4.1;21;4;17;19;3.2;12512;68
2882;Jakob the Liar;120716;4.7;71;21;50;29;4.9;22;7;15;31;3.2;3128;63
2883;Mumford;140397;5.9;76;42;34;55;6.7;21;14;7;66;3.2;1155;62
2884;Dog Park;129884;4.5;24;8;16;33;4.6;5;1;4;20;2.7;600;30
2885;Guinevere;160338;6.8;33;28;5;84;7.9;8;8;0;100;3;490;45
2886;The Adventures of Elmo in Grouchland;159421;6.7;42;32;10;76;6.3;11;7;4;63;3.2;1136;60
2887;Simon Sez;168172;1.9;18;0;18;0;2.4;5;0;5;0;2.2;603;21
2888;She Drives Me Crazy;1073656;\N;\N;\N;\N;\N;\N;\N;\N;\N;\N;\N;\N;\N
2889;Mystery, Alaska;134618;4.9;78;29;49;37;5.1;26;11;15;42;3.2;4196;66
2890;Three Kings;120188;7.8;126;118;8;93;7.5;28;25;3;89;3.3;21498;70
2891;Happy, Texas;162360;6.7;50;41;9;82;7.4;11;11;0;100;3.1;1535;53
2892;New Rose Hotel;133122;4.2;16;3;13;18;0;2;0;2;0;2.9;682;40
2893;Plunkett & Macleane;134033;4.7;27;7;20;25;4.4;7;1;6;14;3.3;1388;66
2894;Romance;194314;5.1;31;14;17;45;5.2;8;4;4;50;3;1725;46
2895;Napoleon and Samantha;68990;0;3;2;1;66;0;0;0;0;0;0;0;0
2896;Alvarez Kelly;60095;0;3;2;1;66;0;0;0;0;0;0;0;0
2897;E la nave va;87188;6.8;9;8;1;88;0;2;1;1;50;0;0;0
2898;The Dark Half;106664;5.8;17;10;7;58;0;3;0;3;0;3;2007;43
2899;Gulliver's Travels;31397;6.6;10;7;3;70;0;0;0;0;0;0;0;0
2900;Monkey Shines;95652;5.4;26;13;13;50;5.4;5;2;3;40;2.9;1393;41
2901;Phantasm;79714;6.2;35;22;13;62;0;3;3;0;100;3.4;4777;68
2902;American Psycho II: All American Girl;283877;3.1;9;1;8;11;0;0;0;0;0;0;0;0
2903;Psycho III;91799;5.2;17;10;7;58;0;4;2;2;50;2.6;2593;31
2904;Singin' in the Rain;45152;9.2;44;44;0;100;8.8;9;9;0;100;3.9;28033;91
2905;Tsubaki Sanjûrô;56443;8.3;15;15;0;100;0;1;1;0;100;4.2;4523;94
2906;Random Hearts;156934;4;87;13;74;14;4.1;26;4;22;15;2.7;2118;28
2907;Superstar;167427;4.5;72;24;48;33;4.1;21;6;15;28;2.9;11034;63
2908;Boys Don't Cry;171804;7.9;73;64;9;87;7.9;22;19;3;86;3.7;16491;85
2910;L'ennui;168740;5.5;13;7;6;53;0;2;1;1;50;3;60;50
2911;El abuelo;176415;\N;\N;\N;\N;\N;\N;\N;\N;\N;\N;\N;\N;\N
2912;The Limey;165854;7.4;79;72;7;91;7.7;24;23;1;95;3.6;4089;76
2913;The Mating Habits of the Earthbound Human;165874;4.3;12;4;8;33;0;1;0;1;0;3.5;709;72
2914;The Haunting of Molly Hartley;1045655;2.9;34;1;33;2;3.8;8;1;7;12;2.6;18564;23
2915;Risky Business;86200;7.4;43;42;1;97;7.7;6;6;0;100;3.2;11638;61
2916;Total Recall;100802;7.2;42;34;8;80;6.8;8;6;2;75;3.3;25031;70
2917;Body Heat;82089;8;36;35;1;97;8.4;5;5;0;100;3.5;2581;74
2918;Ferris Bueller's Day Off;91042;7.4;46;37;9;80;0;4;1;3;25;3.8;77618;89
2919;The Year of Living Dangerously;86617;7.4;25;22;3;88;0;1;0;1;0;3.5;2161;73
2920;Les enfants du paradis;37674;9;21;20;1;95;8.6;5;5;0;100;4.4;2292;94
2921;High Plains Drifter;68699;7.7;23;22;1;95;0;3;2;1;66;3.7;6781;83
2922;Hang 'Em High;61747;6.5;14;13;1;92;0;1;1;0;100;3.5;5541;71
2923;Handle with Care;76123;0;4;4;0;100;0;0;0;0;0;0;0;0
2924;Jui kuen II;111512;7;74;61;13;82;7.1;24;20;4;83;3.6;7905;83
2925;Il conformista;65571;8.8;40;40;0;100;8.4;9;9;0;100;4.3;2418;92
2926;Hairspray;427327;7.7;205;186;19;90;8;41;40;1;97;3.9;382832;84
2927;Brief Encounter;37558;8.1;29;25;4;86;0;3;2;1;66;4.2;3485;91
2928;The Razor's Edge;87980;5.4;15;8;7;53;0;1;0;1;0;3.7;879;77
2929;Trois couleurs: Rouge;111495;8.5;40;40;0;100;8.2;10;10;0;100;4.2;9557;94
2930;Return with Honor;176093;\N;\N;\N;\N;\N;\N;\N;\N;\N;\N;\N;\N;\N
2931;Dom za vesanje;97223;7.1;5;5;0;100;0;2;2;0;100;4.5;2705;96
2932;Days of Heaven;77405;7.9;36;33;3;91;7.3;7;5;2;71;4.2;4575;89
2933;Le feu follet;57058;7.7;10;9;1;90;0;3;3;0;100;4.3;616;90
2934;El amor brujo;90636;0;2;2;0;100;0;0;0;0;0;0;0;0
2935;The Lady Eve;33804;8.6;28;28;0;100;0;4;4;0;100;4.1;2031;89
2936;Sullivan's Travels;34240;8.7;29;29;0;100;0;2;2;0;100;4.2;2289;90
2937;The Palm Beach Story;35169;8.6;21;21;0;100;0;3;3;0;100;3.9;975;83
2938;Hombre mirando al sudeste;91214;0;4;4;0;100;0;0;0;0;0;0;0;0
2939;Niagara;46126;6.2;10;8;2;80;0;0;0;0;0;0;0;0
2940;Gilda;38559;7.7;15;14;1;93;0;0;0;0;0;0;0;0
2941;South Pacific;52225;6.7;8;7;1;87;0;0;0;0;0;0;0;0
2942;Flashdance;85549;4.7;34;10;24;29;4.6;5;1;4;20;3.2;16331;63
2943;Indochine;104507;6.3;17;12;5;70;0;2;1;1;50;3.9;1905;84
2944;The Dirty Dozen;61578;7.9;21;20;1;95;0;2;2;0;100;3.8;7219;86
2945;Mike's Murder;87722;0;4;2;2;50;0;0;0;0;0;0;0;0
2946;Help!;59260;7.3;22;20;2;90;0;2;1;1;50;3.8;5947;85
2947;Goldfinger;58150;8.4;48;46;2;95;7.9;6;5;1;83;3.6;22155;83
2948;From Russia with Love;57076;7.9;45;43;2;95;7.8;5;5;0;100;3.6;17619;79
2949;Dr. No;55928;7.6;42;41;1;97;0;4;4;0;100;3.5;19811;78
2950;The Blue Lagoon;80453;2.7;17;2;15;11;0;4;1;3;25;2.8;7063;55
2951;Per un pugno di dollari;58461;8.1;35;34;1;97;0;3;3;0;100;3.8;21677;87
2952;Sydney;119256;6.9;32;26;6;81;7.1;11;9;2;81;3.7;3180;81
2953;Home Alone 2: Lost in New York;104431;3.6;24;5;19;20;0;2;1;1;50;3;41991;62
2954;Penitentiary;79709;0;1;0;1;0;0;0;0;0;0;0;0;0
2955;Penitentiary II;84485;0;1;0;1;0;0;0;0;0;0;0;0;0
2956;Someone to Watch Over Me;94008;6.2;17;14;3;82;0;1;0;1;0;3;863;38
2958;Naturally Native;133117;0;0;0;0;0;0;0;0;0;0;0;0;0
2959;Fight Club;137523;7.3;149;120;29;80;5.9;27;17;10;62;4.2;268913;95
2960;Beefcake;187712;5.4;7;4;3;57;0;2;1;1;50;3.4;279;63
2961;The Story of Us;160916;4.5;81;23;58;28;4.1;25;4;21;16;3;5089;57
2962;Fever Pitch;332047;6.2;172;110;62;63;6;38;19;19;50;3;14004;62
2963;Joe the King;160672;6;24;15;9;62;5.8;5;1;4;20;3.5;396;67
2964;Julien Donkey-Boy;192194;4.6;33;8;25;24;5.4;6;3;3;50;3.6;1576;73
2965;The Omega Code;203408;3;24;2;22;8;4.2;6;2;4;33;2.6;796;40
2966;The Straight Story;166896;8.1;86;82;4;95;8;26;25;1;96;4;7407;89
2967;The Bad Seed;48977;7.6;15;13;2;86;0;0;0;0;0;0;0;0
2968;Time Bandits;81633;8;36;34;2;94;6.9;5;4;1;80;3.5;9753;74
2969;Un homme et une femme;61138;6.3;12;9;3;75;0;3;1;2;33;4;1548;86
2970;Fitzcarraldo;83946;7.6;22;18;4;81;0;3;2;1;66;4.3;4213;93
2971;All That Jazz;78754;7.4;30;26;4;86;0;4;2;2;50;3.9;3397;84
2972;Hong gao liang;93206;7.6;7;7;0;100;0;1;1;0;100;0;0;0
2973;Crimes and Misdemeanors;97123;7.9;38;35;3;92;7.3;5;4;1;80;4;6179;90
2974;The Vampire Bat;24727;0;4;2;2;50;0;0;0;0;0;0;0;0
2975;The Best Man;430919;0;1;1;0;100;0;0;0;0;0;0;0;0
2976;Bringing Out the Dead;163988;6.7;105;75;30;71;6.6;25;18;7;72;3.2;7444;65
2977;Crazy in Alabama;142201;4.5;55;17;38;30;4.7;20;6;14;30;3.1;1384;55
2978;Three to Tango;144640;4.3;64;18;46;28;4.5;18;7;11;38;2.7;3780;46
2979;Body Shots;172627;4;28;3;25;10;5.5;6;2;4;33;2.5;624;27
2981;Brother Can You Spare a Dime;72742;0;0;0;0;0;0;0;0;0;0;0;0;0
2982;The Guardian;406816;5.2;143;54;89;37;5.2;34;11;23;32;3.7;58919;83
2983;The Ipcress File;59319;7.7;23;23;0;100;0;3;3;0;100;3.8;1386;83
2984;On Any Sunday;67527;0;3;2;1;66;0;1;1;0;100;4.4;129;91
2985;RoboCop;93870;7.7;42;37;5;88;7.3;7;6;1;85;3.1;18381;71
2986;RoboCop 2;100502;4.5;31;11;20;35;4;5;1;4;20;2.7;9580;38
2987;Who Framed Roger Rabbit;96438;8.3;42;41;1;97;7.7;8;7;1;87;3.5;33318;75
2988;Melvin and Howard;81150;8.2;16;16;0;100;0;1;1;0;100;3.4;453;61
2989;For Your Eyes Only;82398;6.2;35;25;10;71;6;5;3;2;60;3.3;10042;64
2990;Licence to Kill;97742;5.8;35;25;10;71;5.5;8;4;4;50;3.1;12088;56
2991;Live and Let Die;70328;5.9;36;23;13;63;4.1;6;1;5;16;3.3;13025;66
2992;Rawhead Rex;91829;4.4;5;2;3;40;0;0;0;0;0;0;0;0
2993;Thunderball;59800;7;33;30;3;90;6.2;5;4;1;80;3.4;12807;70
2994;City Lights;21749;9;37;37;0;100;8.8;8;8;0;100;4.3;7937;94
2995;House on Haunted Hill;185371;4.4;53;13;40;24;3.5;11;2;9;18;2.9;13288;49
2996;Music of the Heart;166943;6.6;75;51;24;68;6.1;19;12;7;63;3.5;3231;68
2997;Being John Malkovich;120601;8;116;107;9;92;7.7;26;24;2;92;3.6;52443;85
2998;Dreaming of Joseph Lees;144178;4.8;13;4;9;30;0;4;3;1;75;3.5;62;58
2999;Man of the Century;138537;6.6;16;12;4;75;5.7;5;2;3;40;3.7;246;74
3000;Mononoke-hime;119698;7.7;83;77;6;92;7.7;24;23;1;95;4.1;44616;94
3001;The Suburbans;157075;3;10;0;10;0;0;2;0;2;0;2.5;700;23
3002;Mein liebster Feind - Klaus Kinski;200849;7;24;19;5;79;6.8;5;4;1;80;4;1638;90
3003;Train de vie;170705;6.4;18;12;6;66;0;4;2;2;50;4.3;854;93
3004;The Bachelor;120596;3.5;66;6;60;9;3.4;20;1;19;5;2.5;3470;34
3005;The Bone Collector;145681;4.7;84;23;61;27;4.7;23;7;16;30;3.3;26317;68
3006;Inside Man;454848;7.3;195;168;27;86;7.5;40;35;5;87;3.7;84980;81
3007;American Movie;181288;8.3;46;43;3;93;8.9;7;7;0;100;4;3544;87
3008;Last Night;156729;7.2;49;41;8;83;7.1;9;7;2;77;3.8;1691;84
3010;Rosetta;200071;7.2;22;19;3;86;8.7;5;5;0;100;3.9;880;82
3011;They Shoot Horses, Don't They?;65088;7.3;23;19;4;82;0;3;3;0;100;3.9;1522;87
3012;Battling Butler;16630;6;5;4;1;80;0;1;0;1;0;3.7;249;75
3013;Bride of Re-Animator;99180;5.2;15;7;8;46;0;3;1;2;33;3.1;1904;51
3014;Bustin' Loose;82121;0;4;3;1;75;0;0;0;0;0;0;0;0
3015;Coma;77355;6.6;21;16;5;76;0;3;1;2;33;3.2;1526;55
3016;Creepshow;83767;6;27;18;9;66;0;4;2;2;50;3.3;6768;67
3017;Creepshow 2;92796;3.7;19;5;14;26;0;4;2;2;50;3;3260;49
3018;Re-Animator;89885;7.7;38;35;3;92;0;4;3;1;75;3.6;7434;78
3019;Drugstore Cowboy;97240;8;27;27;0;100;9;6;6;0;100;3.7;4507;82
3020;Falling Down;106856;6.6;44;33;11;75;6.4;8;5;3;62;3.5;19292;79
3021;The Funhouse;82427;5.6;12;7;5;58;0;0;0;0;0;0;0;0
3022;The General;17925;8.9;38;35;3;92;0;4;2;2;50;4.4;3785;93
3024;Piranha;78087;6.4;22;15;7;68;0;0;0;0;0;0;0;0
3025;Rough Night in Jericho;62218;0;3;1;2;33;0;1;0;1;0;3.1;322;34
3026;Slaughterhouse-Five;69280;7.4;13;10;3;76;0;0;0;0;0;0;0;0
3027;Slaughterhouse-Five;69280;7.4;13;10;3;76;0;0;0;0;0;0;0;0
3028;The Taming of the Shrew;61407;0;0;0;0;0;0;0;0;0;0;0;0;0
3029;Nighthawks;82817;6.2;14;10;4;71;0;2;2;0;100;3.1;1535;52
3030;Yôjinbô;55630;8.8;34;33;1;97;8;5;4;1;80;4.4;10522;96
3031;Repo! The Genetic Opera;963194;4.5;54;18;36;33;3.6;14;2;12;14;3.7;8433;74
3032;The Omega Man;67525;5.6;32;19;13;59;0;4;2;2;50;3.3;5147;56
3033;Spaceballs;94012;6.3;23;15;8;65;0;1;0;1;0;3.5;54973;80
3034;Robin Hood: Prince of Thieves;102798;5.2;27;15;12;55;0;2;1;1;50;3.4;30722;72
3035;Mister Roberts;48380;7.5;17;17;0;100;0;0;0;0;0;0;0;0
3036;La guerre du feu;82484;7;14;11;3;78;0;1;1;0;100;3.5;2238;71
3037;Little Big Man;65988;7.9;25;24;1;96;0;2;2;0;100;3.8;3720;84
3038;A Face in the Crowd;50371;7.8;21;19;2;90;0;3;3;0;100;4.2;1221;93
3039;Trading Places;86465;7.2;36;32;4;88;6.8;5;4;1;80;3.5;12785;82
3040;Meatballs;79540;6.2;28;20;8;71;0;3;2;1;66;3;3676;54
3041;Meatballs Part II;87700;0;0;0;0;0;0;0;0;0;0;0;0;0
3042;Meatballs III: Summer Job;93516;0;0;0;0;0;0;0;0;0;0;0;0;0
3043;Meatballs 4;104837;0;2;0;2;0;0;0;0;0;0;0;0;0
3044;Dead Again;101669;7.3;37;31;6;83;7;5;3;2;60;3.6;2979;75
3045;Peter's Friends;105130;6.3;25;19;6;76;0;2;1;1;50;3.6;1706;73
3046;The Incredibly True Adventure of Two Girls in Love;113416;6.5;9;6;3;66;0;3;1;2;33;3.5;1299;70
3047;Experience Preferred... But Not Essential;83911;\N;\N;\N;\N;\N;\N;\N;\N;\N;\N;\N;\N;\N
3048;Under the Rainbow;83254;0;4;0;4;0;0;2;0;2;0;3.1;194;46
3049;How I Won the War;61789;5.7;12;7;5;58;0;4;0;4;0;3.3;537;58
3050;Light It Up;172726;4.9;47;18;29;38;5.3;17;8;9;47;3.6;1219;76
3051;Anywhere But Here;149691;6.4;86;55;31;63;6.7;23;15;8;65;3;4760;52
3052;Dogma;120655;6.3;126;85;41;67;5.8;28;14;14;50;3.6;61754;84
3053;Joan of Arc;151137;4.5;72;22;50;30;3.4;21;1;20;4;3.1;8110;57
3054;Pokémon: The First Movie;190641;3.6;75;11;64;14;3.7;22;3;19;13;2.8;10617;55
3055;Felicia's Journey;165773;7.4;40;35;5;87;7.8;8;8;0;100;3.4;694;66
3056;Oxygen;160620;6.5;10;7;3;70;0;0;0;0;0;0;0;0
3057;Where's Marlowe?;118150;4.4;11;2;9;18;0;3;0;3;0;3;183;46
3058;Planet of the Apes;63442;7.4;44;39;5;88;5.5;5;3;2;60;3.4;12844;80
3060;The Commitments;101605;7.5;38;34;4;89;6.5;9;7;2;77;3.7;4765;88
3061;Holiday Inn;34862;7.1;20;20;0;100;0;3;3;0;100;4;3215;87
3062;The Longest Day;56197;7.5;12;11;1;91;0;0;0;0;0;0;0;0
3063;Poison Ivy;105156;5;26;11;15;42;4.2;6;1;5;16;2.7;5842;40
3064;Poison Ivy: The New Seduction;119908;0;3;0;3;0;0;0;0;0;0;0;0;0
3065;Nothing to Lose;119807;5.1;23;6;17;26;5.7;5;1;4;20;3.1;5245;67
3066;Tora! Tora! Tora!;66473;6.3;17;12;5;70;0;2;1;1;50;3.6;3254;79
3067;Mujeres al borde de un ataque de nervios;95675;7.6;26;23;3;88;0;4;4;0;100;4;6254;88
3068;The Verdict;84855;7.8;24;23;1;95;0;3;2;1;66;3.8;2332;85
3069;The Effect of Gamma Rays on Man-in-the-Moon Marigolds;68528;0;0;0;0;0;0;0;0;0;0;0;0;0
3070;The Adventures of Buckaroo Banzai Across the 8th Dimension;86856;6.4;34;23;11;67;0;3;2;1;66;3.4;3969;69
3071;Stand and Deliver;94027;6;14;9;5;64;0;1;0;1;0;3.6;2645;78
3072;Moonstruck;93565;7.7;36;33;3;91;7.3;6;5;1;83;3.4;7943;77
3073;The Sandpiper;59674;0;0;0;0;0;0;0;0;0;0;0;0;0
3074;Jeremiah Johnson;68762;7.1;14;13;1;92;0;2;2;0;100;3.9;3595;85
3075;Repulsion;59646;8.8;44;44;0;100;8.3;6;6;0;100;4;4466;87
3076;Irma la Douce;57187;7.4;13;11;2;84;0;2;1;1;50;3.7;1630;76
3077;42: Forty Two Up;164312;7.8;31;28;3;90;7.8;8;7;1;87;4;803;88
3078;Liberty Heights;165859;7.3;45;39;6;86;7.8;11;11;0;100;3.4;1048;71
3079;Mansfield Park;178737;6.9;66;50;16;75;6.3;18;10;8;55;3.6;6288;77
3081;Sleepy Hollow;162661;6.3;124;84;40;67;6.2;30;20;10;66;3.5;93949;79
3082;The World Is Not Enough;143145;0;1;0;1;0;0;0;0;0;0;0;0;0
3083;Todo sobre mi madre;185125;8;80;78;2;97;8;23;22;1;95;4.2;16912;93
3085;La morte vivante;84357;0;2;1;1;50;0;0;0;0;0;0;0;0
3086;Babes in Toyland;24852;8.4;12;12;0;100;0;2;2;0;100;3.6;865;78
3087;Scrooged;96061;5.8;38;24;14;63;3.8;6;1;5;16;3.3;11201;68
3088;Last Chance Harvey;1046947;6.2;146;102;44;69;6.1;27;19;8;70;3.2;14302;52
3089;Ladri di biciclette;40522;8.8;47;45;2;95;8.8;7;7;0;100;4.3;8603;94
3090;Matewan;93509;8.3;17;17;0;100;0;0;0;0;0;0;0;0
3091;Kagemusha;80979;7.5;19;16;3;84;0;2;1;1;50;4.2;4005;91
3092;Chûshingura;55850;0;1;0;1;0;0;0;0;0;0;0;0;0
3093;McCabe & Mrs. Miller;67411;8.4;35;31;4;88;6.3;5;3;2;60;4;2372;85
3094;Maurice;93512;7;10;9;1;90;0;1;1;0;100;3.9;2148;82
3095;The Grapes of Wrath;32551;8.9;36;36;0;100;8;5;5;0;100;3.8;4868;85
3096;My Man Godfrey;28010;8.4;26;26;0;100;8;6;6;0;100;4.1;1791;90
3097;The Shop Around the Corner;33045;8.4;20;20;0;100;0;4;4;0;100;4.1;3559;89
3098;The Natural;87781;7;31;25;6;80;5.8;5;2;3;40;3.7;6978;86
3099;Shampoo;73692;6.1;28;17;11;60;5;5;1;4;20;3.2;1397;52
3100;A River Runs Through It;105265;6.8;38;31;7;81;7.4;9;8;1;88;3.5;13036;79
3101;Fatal Attraction;93010;6.8;42;34;8;80;6.7;7;5;2;71;3.2;8130;67
3102;Jagged Edge;89360;6.7;26;22;4;84;6.2;5;3;2;60;3.2;969;54
3103;Stanley & Iris;100680;4;14;4;10;28;0;4;1;3;25;3.1;683;44
3104;Midnight Run;95631;7.7;26;25;1;96;0;2;1;1;50;3.6;5155;82
3105;Awakenings;99077;6.7;28;25;3;89;0;1;1;0;100;3.6;10377;85
3106;Come See the Paradise;99291;5.5;9;6;3;66;0;2;1;1;50;3.5;180;61
3107;Backdraft;101393;6;39;28;11;71;4.4;7;3;4;42;3.3;17142;73
3108;The Fisher King;101889;7;50;43;7;86;6.8;8;6;2;75;3.6;8960;83
3109;Frozen River;978759;7.3;125;109;16;87;7.9;26;24;2;92;3.2;9338;71
3110;North Country;395972;6.7;166;114;52;68;6.8;38;26;12;68;3.5;14739;72
3111;Places in the Heart;87921;8;20;20;0;100;0;3;3;0;100;3.7;1290;80
3112;'night, Mother;90556;0;1;1;0;100;0;0;0;0;0;0;0;0
3113;End of Days;146675;3.7;98;11;87;11;3.3;24;1;23;4;2.8;14087;41
3114;Toy Story;114709;9;73;73;0;100;8.5;17;17;0;100;3.7;102338;81
3115;Flawless;780516;5.7;90;50;40;55;6;17;12;5;70;3.3;5982;56
3116;Miss Julie;189744;5.6;21;8;13;38;5.2;6;1;5;16;3.2;300;57
3117;Ride with the Devil;134154;6.2;64;40;24;62;5.9;18;10;8;55;3.3;1734;62
3118;Tumbleweeds;161023;7;64;54;10;84;7.1;22;19;3;86;3.5;368;66
3119;Reazione a catena;67656;7.5;9;8;1;88;0;0;0;0;0;0;0;0
3120;The Distinguished Gentleman;104114;4;14;2;12;14;0;2;0;2;0;2.8;1961;40
3121;The Hitch-Hiker;45877;7.6;5;5;0;100;0;0;0;0;0;0;0;0
3122;Santa Fe Trail;33021;0;3;3;0;100;0;0;0;0;0;0;0;0
3124;Agnes Browne;160509;5.3;26;10;16;38;5.8;6;2;4;33;3.5;307;70
3125;The End of the Affair;172396;6.6;66;44;22;66;6.5;16;9;7;56;3.6;3227;73
3126;The End of the Affair;172396;6.6;66;44;22;66;6.5;16;9;7;56;3.6;3227;73
3127;Holy Smoke;144715;5.6;73;32;41;43;5.4;22;8;14;36;3;2300;46
3128;A Map of the World;160513;6.4;54;35;19;64;6.6;17;12;5;70;3.2;587;51
3129;Sweet and Lowdown;158371;6.8;59;46;13;77;6.5;16;11;5;68;3.6;3877;76
3130;The Bonfire of the Vanities;99165;3.8;30;7;23;23;0;2;0;2;0;2.6;3216;28
3131;Broadway Damage;118780;3.5;7;2;5;28;0;1;0;1;0;3;241;43
3132;Daddy Long Legs;47969;0;1;1;0;100;0;0;0;0;0;0;0;0
3133;Go West;32536;6.5;9;8;1;88;0;0;0;0;0;0;0;0
3134;La grande illusion;28950;9.2;34;33;1;97;0;4;4;0;100;4.3;2864;93
3135;The Great Santini;79239;7.8;17;16;1;94;0;1;1;0;100;3.6;592;74
3136;The James Dean Story;50558;0;1;1;0;100;0;0;0;0;0;0;0;0
3137;The Sea Wolves;81470;\N;\N;\N;\N;\N;\N;\N;\N;\N;\N;\N;\N;\N
3138;Stealing Home;96171;3.4;9;2;7;22;0;1;0;1;0;3.5;936;71
3139;Tarzan the Fearless;24645;0;1;1;0;100;0;0;0;0;0;0;0;0
3140;Three Ages;14538;7.4;7;7;0;100;0;0;0;0;0;0;0;0
3141;The Two Jakes;100828;5.4;16;10;6;62;0;2;2;0;100;2.9;1401;37
3142;U2: Rattle and Hum;96328;5.7;12;8;4;66;0;0;0;0;0;0;0;0
3143;Hell in the Pacific;63056;6.8;10;8;2;80;0;0;0;0;0;0;0;0
3144;The Glass Bottom Boat;60463;5.6;6;3;3;50;0;0;0;0;0;0;0;0
3145;Cradle Will Rock;150216;6.2;66;42;24;63;5.9;14;10;4;71;3.4;1693;65
3146;Deuce Bigalow: Male Gigolo;205000;4;73;17;56;23;3.2;18;1;17;5;2.9;18036;55
3147;The Green Mile;120689;6.8;128;99;29;77;6.2;32;23;9;71;4.1;124792;93
3148;The Cider House Rules;124315;6.6;109;77;32;70;6.5;25;17;8;68;3.4;9660;75
3149;Diamonds;167423;4;34;9;25;26;3.8;10;3;7;30;2.7;365;32
3150;Punisher: War Zone;450314;4.2;96;25;71;26;3.7;21;1;20;4;3;29393;47
3151;The Bat Whispers;20668;0;4;2;2;50;0;1;0;1;0;3.4;96;67
3152;The Last Picture Show;67328;8.6;33;33;0;100;8.5;5;5;0;100;4;3677;88
3153;The 7th Voyage of Sinbad;51337;7.5;14;14;0;100;0;1;1;0;100;3.5;2006;68
3154;Blood on the Sun;37547;0;3;3;0;100;0;0;0;0;0;0;0;0
3155;Anna and the King;166485;5.9;97;49;48;50;5.3;28;10;18;35;3.2;10877;63
3156;Bicentennial Man;182789;4.8;93;35;58;37;4.6;23;6;17;26;3;22610;58
3157;Stuart Little 2;243585;6.9;114;95;19;83;6.9;29;26;3;89;2.7;10893;44
3158;Jing Ke ci Qin Wang;162866;7.4;34;29;5;85;7.2;5;3;2;60;3.7;1522;76
3159;Fantasia/2000;120910;7;78;64;14;82;5.9;22;14;8;63;3.3;9364;67
3160;Magnolia;175880;7.5;138;114;24;82;6.8;32;25;7;78;3.7;39673;88
3161;Onegin;119079;5.5;20;8;12;40;0;4;1;3;25;3.6;1473;69
3162;Simpatico;174204;4.6;59;14;45;23;4.3;18;3;15;16;2.4;294;18
3163;Topsy-Turvy;151568;7.8;83;74;9;89;7.9;19;18;1;94;3.6;1113;73
3165;3-4 x jûgatsu;98967;6.8;7;6;1;85;0;1;1;0;100;3.5;702;66
3166;Brenda Starr;96978;0;0;0;0;0;0;0;0;0;0;0;0;0
3167;Carnal Knowledge;66892;7.7;26;23;3;88;0;4;3;1;75;3.5;1350;70
3168;Easy Rider;64276;7.9;37;32;5;86;0;4;2;2;50;3.7;13558;81
3169;The Falcon and the Snowman;87231;7.3;15;13;2;86;0;1;1;0;100;3.3;1167;62
3171;Room at the Top;53226;8.3;10;10;0;100;0;0;0;0;0;0;0;0
3172;Ulisse;47630;0;2;2;0;100;0;0;0;0;0;0;0;0
3173;Any Given Sunday;146838;5.5;118;58;60;49;5.5;30;16;14;53;3.3;21068;70
3174;Man on the Moon;125664;6.2;117;73;44;62;5.3;31;16;15;51;3.3;15027;74
3175;Galaxy Quest;177789;7.2;111;99;12;89;6.9;27;22;5;81;3;19804;67
3176;The Talented Mr. Ripley;134119;7.3;125;103;22;82;6.9;31;24;7;77;3.3;18951;75
3177;Next Friday;195945;3.9;62;13;49;20;4.1;21;5;16;23;3.2;25065;77
3178;The Hurricane;29030;0;1;1;0;100;0;0;0;0;0;0;0;0
3179;Angela's Ashes;145653;5.7;84;44;40;52;5.3;26;10;16;38;3.6;4588;79
3180;Play It to the Bone;196857;4;78;9;69;11;3.9;24;4;20;16;2.7;1727;29
3181;Titus;120866;6.5;74;50;24;67;6;21;12;9;57;3.7;4498;83
3182;Mr. Death: The Rise and Fall of Fred A. Leuchter, Jr.;192335;8.4;38;38;0;100;9.2;5;5;0;100;3.8;935;85
3183;The Third Miracle;174268;6.2;33;22;11;66;7.6;5;5;0;100;3.2;499;54
3184;Scarface;86250;7.5;50;44;6;88;8;5;4;1;80;4.1;121090;93
3185;Snow Falling on Cedars;120834;5.2;88;35;53;39;4.6;26;7;19;26;3.4;2061;67
3186;Girl, Interrupted;172493;5.7;111;59;52;53;5.1;30;12;18;40;3.5;36814;83
3188;The Life and Times of Hank Greenberg;208261;7.4;45;43;2;95;7.4;9;8;1;88;3.5;218;69
3189;My Dog Skip;156812;6.7;80;58;22;72;6.6;24;17;7;70;3.1;5324;63
3190;Supernova;134983;3.2;60;6;54;10;3.2;18;3;15;16;2.4;3150;21
3191;The Quarry;169156;4.5;5;1;4;20;0;0;0;0;0;0;0;0
3192;Theeviravaathi: The Terrorist;169302;\N;\N;\N;\N;\N;\N;\N;\N;\N;\N;\N;\N;\N
3193;Heavenly Creatures;110005;8.3;41;39;2;95;7.8;9;9;0;100;3.7;8208;82
3194;The Way We Were;70903;6;19;12;7;63;0;3;1;2;33;3.7;5344;82
3195;Tess of the Storm Country;13662;0;0;0;0;0;0;0;0;0;0;0;0;0
3196;Stalag 17;46359;8.3;28;27;1;96;8.1;6;6;0;100;4.2;3492;92
3197;The Presidio;95897;4.8;13;6;7;46;0;1;0;1;0;3;1838;39
3198;Papillon;70511;7.7;13;12;1;92;0;2;1;1;50;0;0;0
3199;Pal Joey;50815;6.5;7;5;2;71;0;0;0;0;0;0;0;0
3200;The Last Detail;70290;7.8;24;22;2;91;0;3;3;0;100;3.9;1988;85
3201;Five Easy Pieces;65724;8.2;30;25;5;83;6.5;5;3;2;60;3.9;4148;85
3202;Auch Zwerge haben klein angefangen;65436;7.9;8;8;0;100;0;2;2;0;100;3.8;1310;76
3203;Dead Calm;97162;7.5;21;20;1;95;0;1;1;0;100;3.1;4726;57
3204;The Boys from Brazil;77269;6.2;26;17;9;65;0;2;0;2;0;3.5;1963;68
3205;La maschera del demonio;54067;7.2;15;12;3;80;0;1;0;1;0;3.8;1726;79
3206;Against All Odds;86859;5.6;9;6;3;66;0;1;1;0;100;3;1230;46
3207;The Snows of Kilimanjaro;45162;0;4;4;0;100;0;0;0;0;0;0;0;0
3208;Loaded Weapon 1;107659;3.5;22;3;19;13;0;4;0;4;0;2.8;4689;50
3209;The Loves of Carmen;40552;0;1;0;1;0;0;0;0;0;0;0;0;0
3210;Fast Times at Ridgemont High;83929;6.7;44;35;9;79;3.9;6;2;4;33;3.5;26337;76
3211;Evil Angels;94924;6.8;20;18;2;90;0;1;1;0;100;3.3;1554;63
3213;Batman: Mask of the Phantasm;106364;6.9;23;20;3;86;0;3;1;2;33;3.4;14817;73
3214;American Flyers;88707;5.5;20;12;8;60;0;3;0;3;0;3.2;1640;57
3215;Voyage of the Damned;75406;5.2;5;4;1;80;0;0;0;0;0;0;0;0
3216;Vampiros lesbos;66380;5.6;6;3;3;50;0;1;0;1;0;3;1298;45
3217;A Star Is Born;29606;7.3;11;11;0;100;0;0;0;0;0;0;0;0
3218;Poison;102687;7;12;10;2;83;0;1;1;0;100;3.5;529;65
3219;Pacific Heights;100318;5.2;22;10;12;45;0;2;0;2;0;3.1;1624;51
3220;Night Tide;55230;0;0;0;0;0;0;0;0;0;0;0;0;0
3221;The Draughtsman's Contract;83851;8;17;17;0;100;0;2;2;0;100;3.9;1191;84
3222;U-Carmen e-Khayelitsha;445776;7.4;20;19;1;95;7.8;7;7;0;100;3.2;1204;50
3223;A Zed & Two Noughts;90366;6.7;19;15;4;78;0;1;1;0;100;4;1255;86
3224;Suna no onna;58625;8.7;14;14;0;100;0;1;1;0;100;4.3;1517;92
3225;Down to You;186975;3.2;58;2;56;3;2.8;16;0;16;0;2.7;6516;51
3226;Hellhounds on My Trail: The Afterlife of Robert Johnson;197544;0;0;0;0;0;0;0;0;0;0;0;0;0
3230;The Odessa File;71935;5.7;14;9;5;64;0;2;0;2;0;3.4;663;64
3231;The Saphead;11652;0;0;0;0;0;0;0;0;0;0;0;0;0
3232;Seven Chances;16332;8.8;12;12;0;100;0;0;0;0;0;0;0;0
3235;Where the Buffalo Roam;81748;4.7;12;3;9;25;0;1;0;1;0;3.6;5671;75
3237;Falkens öga;183065;6.6;7;5;2;71;0;1;1;0;100;3.2;281;38
3238;Eye of the Beholder;120662;3.4;86;8;78;9;3.1;20;1;19;5;2.7;2529;34
3239;Isn't She Great;141399;4;60;15;45;25;3.7;22;5;17;22;2.9;563;41
3240;The Big Tease;156639;5.7;39;22;17;56;5.7;15;9;6;60;3.2;496;56
3241;Phörpa;201840;6.9;33;28;5;84;7;7;6;1;85;4;324;85
3242;Santitos;126651;6.3;7;4;3;57;0;1;1;0;100;3.3;199;58
3243;Encino Man;104187;3.1;29;4;25;13;2.6;6;0;6;0;2.9;9527;58
3244;The Goodbye Girl;76095;6.5;15;12;3;80;0;1;1;0;100;3.8;1711;84
3245;Soy Cuba;58604;8.6;31;31;0;100;8.9;7;7;0;100;4.2;1082;91
3246;Malcolm X;104797;7.4;51;46;5;90;6.6;9;6;3;66;3.8;11524;90
3247;Sister Act;105417;5.6;18;12;6;66;0;2;1;1;50;3.1;27888;66
3248;Sister Act 2: Back in the Habit;108147;3;28;2;26;7;3.5;8;1;7;12;3;21141;66
3249;The Hand That Rocks the Cradle;104389;5.6;32;18;14;56;5.2;6;3;3;50;3.1;4973;60
3250;Alive;106246;6.4;21;15;6;71;0;3;1;2;33;3.3;5360;68
3251;Agnes of God;88683;5.5;17;9;8;52;0;1;0;1;0;3.2;1316;55
3252;Scent of a Woman;105323;7.2;32;30;2;93;0;3;3;0;100;3.7;23625;90
3253;Wayne's World;105793;6.8;45;38;7;84;6.4;7;5;2;71;3.4;45784;80
3254;Wayne's World 2;108525;5.8;42;25;17;59;7.1;7;6;1;85;3.1;24416;64
3255;A League of Their Own;104694;0;0;0;0;0;0;0;0;0;0;0;0;0
3256;Patriot Games;105112;6;28;21;7;75;3.8;5;0;5;0;3.4;13313;70
3257;The Bodyguard;103855;4.8;24;9;15;37;0;2;1;1;50;2.9;15937;61
3258;Death Becomes Her;104070;0;0;0;0;0;0;0;0;0;0;0;0;0
3259;Far and Away;104231;5.2;21;10;11;47;0;2;0;2;0;3.1;11238;61
3260;Howards End;104454;8.2;34;31;3;91;9.8;5;5;0;100;3.7;3467;80
3261;Singles;105415;6.9;40;32;8;80;7.5;8;6;2;75;3.4;4630;70
3262;Twin Peaks: Fire Walk with Me;105665;6.2;50;31;19;62;4.4;5;2;3;40;3.6;10347;79
3263;White Men Can't Jump;105812;6.3;37;29;8;78;6;7;5;2;71;3;9040;61
3264;Buffy the Vampire Slayer;103893;4.1;34;11;23;32;3.9;6;2;4;33;2.8;18735;44
3265;Lat sau san taam;104684;\N;\N;\N;\N;\N;\N;\N;\N;\N;\N;\N;\N;\N
3266;C'est arrivé près de chez vous;103905;7.3;14;12;2;85;0;1;1;0;100;4.1;6544;90
3267;El mariachi;104815;7;25;23;2;92;7.6;5;5;0;100;3.5;11481;73
3268;Stop! Or My Mom Will Shoot;105477;2.5;23;1;22;4;0;4;0;4;0;2.2;5278;26
3269;Forever Young;104291;5.3;16;8;8;50;0;1;0;1;0;3.1;9230;55
3270;The Cutting Edge;104040;6.1;12;7;5;58;0;3;2;1;66;3.3;6209;76
3271;Of Mice and Men;105046;7.9;25;24;1;96;8.9;6;6;0;100;3.5;6505;77
3272;Bad Lieutenant;103759;6.9;38;29;9;76;6.7;10;7;3;70;3.5;4087;73
3273;Scream 3;134084;5.2;94;36;58;38;5.1;23;9;14;39;2.8;28349;49
3274;Single White Female;105414;5.3;39;23;16;58;4.9;8;4;4;50;2.9;3934;49
3275;The Boondock Saints;144117;4;21;4;17;19;0;1;0;1;0;4.2;104281;93
3276;Gun Shy;171356;4.5;42;10;32;23;3.8;10;2;8;20;2.9;1203;40
3278;Gendernauts - Eine Reise durch die Geschlechter;192069;0;2;1;1;50;0;0;0;0;0;0;0;0
3280;Gone Baby Gone;452623;7.7;164;154;10;93;7.4;36;33;3;91;3.8;95109;84
3281;The Brandon Teena Story;144801;6.2;12;8;4;66;0;2;2;0;100;3.7;649;70
3282;Different for Girls;116102;5.9;24;12;12;50;6.7;10;7;3;70;3.5;391;65
3283;Minnie and Moskowitz;67433;7.3;10;8;2;80;0;2;1;1;50;0;0;0
3284;They Might Be Giants;67848;7.1;9;7;2;77;0;0;0;0;0;0;0;0
3285;The Beach;163978;4.4;116;22;94;18;3.9;31;4;27;12;2.9;21479;59
3286;Snow Day;184907;4.2;62;16;46;25;4;20;5;15;25;2.5;4272;33
3287;The Tigger Movie;220099;5.9;70;43;27;61;5.7;19;10;9;52;3.2;5413;63
3289;Yi ge dou bu neng shao;209189;7.6;42;40;2;95;7.8;10;10;0;100;4;1451;88
3292;The Big Combo;47878;7;12;11;1;91;0;3;2;1;66;3.5;764;69
3293;Conceiving Ada;118882;6.6;11;9;2;81;0;1;1;0;100;3.2;57;50
3294;Eaten Alive;74455;4.4;10;1;9;10;0;0;0;0;0;0;0;0
3295;Raining Stones;107920;8;11;11;0;100;0;4;4;0;100;3.9;560;88
3296;To Sir, with Love;62376;7.1;23;21;2;91;0;4;3;1;75;3.8;4209;85
3298;Boiler Room;181984;6.4;97;65;32;67;6.7;22;17;5;77;3.4;7689;75
3300;Pitch Black;134847;5.6;100;55;45;55;4.9;26;10;16;38;3.4;39767;79
3301;The Whole Nine Yards;190138;5.2;93;42;51;45;5;25;10;15;40;3.2;16066;67
3302;Beautiful People;159272;6.7;24;19;5;79;7.6;6;6;0;100;3.9;289;82
3303;Black Tar Heroin: The Dark End of the Street;221023;0;0;0;0;0;0;0;0;0;0;0;0;0
3304;Blue Collar Comedy Tour: The Movie;330069;6.8;13;12;1;92;7;8;8;0;100;3.6;6829;82
3305;Bluebeard;36653;7.6;7;7;0;100;0;0;0;0;0;0;0;0
3306;Monty Python's Flying Circus;63929;\N;\N;\N;\N;\N;\N;\N;\N;\N;\N;\N;\N;\N
3307;City Lights;21749;9;37;37;0;100;8.8;8;8;0;100;4.3;7937;94
3308;The Flamingo Kid;87265;6.8;17;15;2;88;0;4;4;0;100;2.8;700;39
3309;A Dog's Life;9018;0;0;0;0;0;0;0;0;0;0;0;0;0
3310;The Karate Kid;87538;6.9;41;37;4;90;6.9;5;4;1;80;3.3;20688;71
3311;The Man from Laramie;48342;7.6;6;6;0;100;0;0;0;0;0;0;0;0
3313;Class Reunion;84395;2.4;6;0;6;0;0;0;0;0;0;0;0;0
3314;The Big Trees;44420;0;1;0;1;0;0;0;0;0;0;0;0;0
3315;Happy Go Lovely;43618;0;0;0;0;0;0;0;0;0;0;0;0;0
3316;Reindeer Games;184858;4.2;86;21;65;24;4.4;26;8;18;30;2.5;4918;33
3317;Wonder Boys;185014;7.2;122;99;23;81;7.1;28;23;5;82;3.5;7544;79
3318;Deterrence;158583;5.3;38;17;21;44;5.3;12;5;7;41;3.2;258;54
3319;Judy Berlin;181618;7.1;29;23;6;79;7.8;5;4;1;80;3.4;156;73
3320;Mifunes sidste sang;164756;6.7;30;22;8;73;8;6;6;0;100;3.8;534;84
3322;3 Strikes;199290;2.3;29;0;29;0;2.4;11;0;11;0;3.1;1088;60
3323;Chain of Fools;194368;0;0;0;0;0;0;0;0;0;0;0;0;0
3324;Drowning Mona;186045;4.4;75;22;53;29;4.2;23;7;16;30;2.7;2361;40
3325;The Next Best Thing;156841;3.6;91;17;74;18;3.3;27;3;24;11;2.6;3665;36
3326;What Planet Are You From?;181151;5;77;32;45;41;4.1;23;7;16;30;2.5;1064;25
3327;Beyond the Mat;218043;6.7;65;53;12;81;6.2;18;13;5;72;3.6;1609;79
3328;Ghost Dog: The Way of the Samurai;165798;7;91;74;17;81;6.2;25;16;9;64;3.7;11931;82
3329;The Year My Voice Broke;94347;7.1;15;14;1;93;0;4;4;0;100;4.1;242;89
3330;Splendor in the Grass;55471;7.2;13;11;2;84;0;0;0;0;0;0;0;0
3331;My Tutor;85980;0;0;0;0;0;0;0;0;0;0;0;0;0
3332;The Legend of Lobo;56173;0;1;0;1;0;0;0;0;0;0;0;0;0
3333;The Killing of Sister George;63185;6.5;12;9;3;75;0;1;0;1;0;4;248;85
3334;Key Largo;40506;8.1;26;25;1;96;0;3;2;1;66;0;0;0
3335;Jailbait;364435;4.3;18;3;15;16;3.9;7;1;6;14;3.7;257;62
3336;It Happened Here;55024;6.9;6;4;2;66;0;1;1;0;100;3.4;278;63
3337;I'll Never Forget What's'isname;61801;0;1;1;0;100;0;0;0;0;0;0;0;0
3338;For All Mankind;97372;8.1;14;13;1;92;0;1;1;0;100;4.1;579;91
3339;Cross of Iron;74695;6.3;14;11;3;78;0;1;0;1;0;0;0;0
3340;Bride of the Monster;47898;3.8;8;3;5;37;0;0;0;0;0;0;0;0
3341;Born Yesterday;42276;8.1;20;19;1;95;0;2;1;1;50;3.9;1132;86
3342;Birdy;86969;7.4;25;22;3;88;0;3;2;1;66;3.8;2454;82
3343;Et Dieu... créa la femme;49189;6.2;11;8;3;72;0;1;0;1;0;3;1435;52
3344;Blood Feast;56875;4.2;11;4;7;36;0;0;0;0;0;0;0;0
3345;Charlie, the Lonesome Cougar;62793;0;1;1;0;100;0;0;0;0;0;0;0;0
3347;Never Cry Wolf;86005;7.7;17;17;0;100;0;4;4;0;100;3.7;962;80
3348;The Night Visitor;66141;0;4;1;3;25;0;1;0;1;0;3;54;50
3349;The Perils of Pauline;39698;0;0;0;0;0;0;0;0;0;0;0;0;0
3350;A Raisin in the Sun;55353;8.1;12;12;0;100;0;1;1;0;100;3.8;1378;83
3351;Two Thousand Maniacs!;58694;4.5;13;4;9;30;0;0;0;0;0;0;0;0
3352;Brown's Requiem;171135;6;6;3;3;50;0;0;0;0;0;0;0;0
3353;The Closer You Get;218112;5.4;19;6;13;31;0;3;1;2;33;3.1;100;56
3354;Mission to Mars;183523;0;0;0;0;0;0;0;0;0;0;0;0;0
3355;The Ninth Gate;142688;4.9;85;35;50;41;4;24;6;18;25;3.2;23993;60
3357;Est - Ouest;181530;6.6;29;20;9;68;6.3;5;2;3;40;4;588;85
3358;Defending Your Life;101698;7.6;27;26;1;96;0;3;3;0;100;3.6;2592;76
3359;Breaking Away;78902;8.2;33;31;2;93;8.3;5;5;0;100;3.9;2650;84
3360;Hoosiers;91217;7.4;42;37;5;88;7.4;9;8;1;88;3.7;10169;87
3361;Bull Durham;94812;7.9;45;44;1;97;7.9;7;7;0;100;3.4;8264;78
3362;Dog Day Afternoon;72890;8.5;35;34;1;97;6.9;6;5;1;83;4;18531;91
3363;American Graffiti;69704;8.3;32;31;1;96;0;4;4;0;100;3.6;12630;78
3364;The Asphalt Jungle;42208;8.4;25;24;1;96;0;0;0;0;0;0;0;0
3365;The Searchers;49730;8.8;41;40;1;97;8.3;5;5;0;100;4;8713;87
3367;The Devil's Brigade;62886;0;4;3;1;75;0;1;0;1;0;3.5;612;71
3368;The Big Country;51411;6.8;9;9;0;100;0;0;0;0;0;0;0;0
3369;Mélodie en sous-sol;57344;0;3;2;1;66;0;0;0;0;0;0;0;0
3370;The Betrayal - Nerakhoon;1157685;7.6;29;27;2;93;7.7;12;12;0;100;3.6;219;72
3371;Bound for Glory;74235;7.3;16;14;2;87;0;1;1;0;100;3.6;461;74
3372;The Bridge at Remagen;64110;0;3;0;3;0;0;0;0;0;0;0;0;0
3373;Buck and the Preacher;68323;0;0;0;0;0;0;0;0;0;0;0;0;0
3374;Daughters of the Dust;104057;7.2;8;7;1;87;0;2;2;0;100;3.9;285;78
3375;Destination Moon;42393;4.7;9;5;4;55;0;0;0;0;0;0;0;0
3376;La nuit fantastique;41705;\N;\N;\N;\N;\N;\N;\N;\N;\N;\N;\N;\N;\N
3377;Hangmen Also Die!;35966;0;3;3;0;100;0;0;0;0;0;0;0;0
3378;Der Unhold;118043;7;9;8;1;88;0;2;2;0;100;3.8;262;79
3379;The Beach;163978;4.4;116;22;94;18;3.9;31;4;27;12;2.9;21479;59
3380;Railroaded!;39748;0;4;3;1;75;0;0;0;0;0;0;0;0
3384;The Taking of Pelham One Two Three;72251;8.2;32;32;0;100;7.9;5;5;0;100;3.9;2926;86
3385;Volunteers;90274;4.6;8;4;4;50;0;0;0;0;0;0;0;0
3386;JFK;102138;7.5;52;43;9;82;7.1;9;7;2;77;3.7;15334;84
3387;Who's Harry Crumb?;98645;3.6;10;3;7;30;0;0;0;0;0;0;0;0
3388;Harry and the Hendersons;93148;4.8;17;7;10;41;0;0;0;0;0;0;0;0
3389;Let's Get Harry;91400;0;0;0;0;0;0;0;0;0;0;0;0;0
3390;Shanghai Surprise;91934;2.3;7;1;6;14;0;0;0;0;0;0;0;0
3391;Who's That Girl;94321;3.2;13;3;10;23;0;1;1;0;100;0;0;0
3392;She-Devil;98309;4.5;17;7;10;41;0;1;1;0;100;2.6;2831;44
3393;Date with an Angel;92834;3.4;7;1;6;14;0;2;0;2;0;3.1;926;59
3394;Blind Date;92666;4.1;22;5;17;22;0;3;1;2;33;2.9;2983;44
3395;Nadine;93596;5;10;4;6;40;0;1;0;1;0;2.8;404;21
3396;The Muppet Movie;79588;7.8;37;33;4;89;0;3;2;1;66;3.5;8541;79
3397;The Great Muppet Caper;82474;6;17;12;5;70;0;3;1;2;33;3.3;4174;72
3398;The Muppets Take Manhattan;87755;6.7;19;15;4;78;0;3;3;0;100;3.3;5077;70
3399;Sesame Street Presents: Follow that Bird;89994;6.1;11;10;1;90;0;1;1;0;100;3.4;1485;64
3400;We're Back! A Dinosaur's Story;108526;4;11;3;8;27;0;4;1;3;25;3.1;2567;54
3401;Baby: Secret of the Lost Legend;88760;3.5;9;1;8;11;0;1;0;1;0;2.8;986;37
3402;Turtle Diary;90219;7.7;6;6;0;100;0;1;1;0;100;3.7;57;69
3403;Raise the Titanic;81400;5.2;5;3;2;60;0;1;0;1;0;3;2514;44
3404;Titanic;120338;7.4;97;80;17;82;6.6;29;21;8;72;3.3;464576;68
3405;A Night to Remember;51994;8.7;9;9;0;100;0;0;0;0;0;0;0;0
3406;Captain Horatio Hornblower R.N.;43379;7.3;7;7;0;100;0;0;0;0;0;0;0;0
3407;Les convoyeurs attendent;201538;7.4;7;7;0;100;0;1;1;0;100;3.8;198;71
3408;Erin Brockovich;195685;7.3;137;114;23;83;7.3;34;30;4;88;3.5;33256;76
3409;Final Destination;195714;4.6;85;26;59;30;4.4;22;7;15;31;3.4;55113;75
3410;Soft Fruit;180181;6.2;14;9;5;64;5.1;6;3;3;50;3.9;118;83
3412;L'ours;95800;7.2;11;10;1;90;0;2;1;1;50;3.6;2107;76
3413;Deep Impact;120647;5.7;51;24;27;47;5.9;6;2;4;33;2.9;28624;51
3414;Love Is a Many-Splendored Thing;48316;\N;\N;\N;\N;\N;\N;\N;\N;\N;\N;\N;\N;\N
3415;Zerkalo;72443;9.2;6;6;0;100;0;1;1;0;100;4.4;2940;93
3417;The Crimson Pirate;44517;7.8;9;9;0;100;0;0;0;0;0;0;0;0
3418;Thelma & Louise;103074;7.9;44;40;4;90;8.2;9;9;0;100;3.3;16458;75
3419;Something for Everyone;66392;0;2;1;1;50;0;0;0;0;0;0;0;0
3420;...And Justice for All.;78718;6.9;19;18;1;94;0;2;2;0;100;3.5;3756;76
3421;Animal House;77975;7.7;40;36;4;90;7.1;5;4;1;80;3.7;25149;88
3422;She's Gotta Have It;91939;7;27;25;2;92;0;3;2;1;66;3.4;1428;66
3423;School Daze;96054;5.7;19;11;8;57;0;4;1;3;25;3.8;2379;80
3424;Do the Right Thing;97216;8.8;51;49;2;96;7.9;7;6;1;85;3.8;28566;86
3425;Mo' Better Blues;100168;6;32;23;9;71;4.5;8;3;5;37;0;0;0
3426;Jungle Fever;102175;6.7;7;4;3;57;0;1;1;0;100;3;220;36
3427;Coogan's Bluff;62824;6.8;10;10;0;100;0;1;1;0;100;3.2;1501;48
3428;Resurrecting the Champ;416185;6;116;69;47;59;5.5;30;15;15;50;3.4;18572;62
3429;Creature Comforts;99317;7.6;12;11;1;91;0;0;0;0;0;0;0;0
3430;Death Wish;71402;6;23;16;7;69;0;3;1;2;33;3.3;4245;68
3431;Death Wish;71402;6;23;16;7;69;0;3;1;2;33;3.3;4245;68
3432;Death Wish 3;89003;2.2;14;0;14;0;0;3;0;3;0;3.1;2045;54
3433;Death Wish 4: The Crackdown;92857;3.8;6;1;5;16;0;0;0;0;0;0;0;0
3434;Death Wish V: The Face of Death;109578;\N;\N;\N;\N;\N;\N;\N;\N;\N;\N;\N;\N;\N
3435;Double Indemnity;36775;8.7;43;42;1;97;7.3;5;4;1;80;4.2;8526;93
3436;Dying Young;101787;4.5;16;5;11;31;0;2;0;2;0;3.2;5112;66
3437;Cool as Ice;101615;2.2;13;1;12;7;0;2;0;2;0;0;0;0
3438;Teenage Mutant Ninja Turtles;100758;4.9;37;17;20;45;5.8;7;4;3;57;3.3;21473;76
3439;Teenage Mutant Ninja Turtles II: The Secret of the Ooze;103060;4.6;27;10;17;37;5.1;8;4;4;50;3.1;14179;68
3440;Teenage Mutant Ninja Turtles III;108308;3.8;21;6;15;28;0;4;2;2;50;2.7;11304;42
3441;Red Dawn;87985;4.8;16;8;8;50;0;0;0;0;0;0;0;0
3442;Band of the Hand;90693;3.5;7;1;6;14;0;1;0;1;0;3.2;921;49
3443;Born American;91313;0;1;0;1;0;0;0;0;0;0;0;0;0
3444;Bloodsport;92675;4.3;18;6;12;33;0;0;0;0;0;0;0;0
3445;Eyes of Laura Mars;77530;5.2;17;8;9;47;0;1;0;1;0;3.1;982;44
3446;Funny Bones;113133;6.5;17;11;6;64;0;2;1;1;50;3.4;706;72
3447;The Good Earth;28944;7.4;13;12;1;92;0;3;2;1;66;3.7;367;76
3448;Good Morning, Vietnam;93105;7.3;31;28;3;90;0;1;1;0;100;3.5;13673;78
3449;The Good Mother;95238;5.5;6;4;2;66;0;1;0;1;0;3.1;241;35
3450;Grumpy Old Men;107050;5.9;36;24;12;66;7;6;5;1;83;3.2;10489;66
3451;Guess Who's Coming to Dinner;61735;6;24;15;9;62;0;4;3;1;75;3.7;6951;84
3452;Romeo Must Die;165929;4.9;89;29;60;32;5.6;20;10;10;50;3.1;16660;67
3453;Here on Earth;195778;3.8;67;12;55;17;3.3;23;2;21;8;3.1;3503;63
3454;Whatever It Takes;202402;3.5;64;10;54;15;3.6;22;3;19;13;2.9;8374;52
3455;Buddy Boy;146516;6.2;7;5;2;71;0;2;1;1;50;3.1;563;53
3456;Rang-e khoda;191043;7.6;31;27;4;87;8.9;5;5;0;100;4.3;1466;94
3457;Waking the Dead;127349;5.9;54;28;26;51;5.5;12;4;8;33;3.7;1126;77
3458;Blood and Sand;12952;7;8;8;0;100;0;0;0;0;0;0;0;0
3459;Gothic;91142;5.9;11;6;5;54;0;0;0;0;0;0;0;0
3461;Lord of the Flies;100054;6.4;18;11;7;61;0;1;0;1;0;3.1;6608;54
3462;Modern Times;27977;8.9;47;47;0;100;8.2;11;11;0;100;4.2;9563;95
3463;Last Resort;258761;7.3;70;66;4;94;7.5;23;23;0;100;3.7;459;77
3464;Solar Crisis;100649;0;4;0;4;0;0;0;0;0;0;0;0;0
3465;That's Life!;92079;5.7;13;6;7;46;0;1;0;1;0;3.5;371;64
3466;Heart and Souls;107091;5.4;22;12;10;54;0;2;1;1;50;3.4;3529;72
3467;Hud;57163;7.2;24;19;5;79;0;3;1;2;33;3.9;2075;87
3468;The Hustler;54997;8.6;33;32;1;96;7.6;6;5;1;83;3.9;6593;90
3469;Inherit the Wind;53946;7.8;21;19;2;90;0;1;0;1;0;4;3071;88
3470;Dersu Uzala;71411;7.5;12;9;3;75;0;1;0;1;0;4.3;2637;94
3471;Close Encounters of the Third Kind;75860;8.6;39;37;2;94;9;5;5;0;100;3.6;21572;79
3472;The City of the Dead;53719;0;4;2;2;50;0;0;0;0;0;0;0;0
3473;Jonas qui aura 25 ans en l'an 2000;74718;0;2;2;0;100;0;0;0;0;0;0;0;0
3474;Retroactive;117468;4.4;5;2;3;40;0;0;0;0;0;0;0;0
3475;A Place in the Sun;43924;6.8;20;15;5;75;0;2;0;2;0;3.9;2248;86
3476;Jacob's Ladder;99871;6.6;45;32;13;71;5;7;3;4;42;3.7;15733;82
3477;Empire Records;112950;4.3;21;5;16;23;0;3;1;2;33;3.5;27733;83
3478;La Bamba;93378;6.8;20;19;1;95;0;1;1;0;100;3.2;5593;74
3479;Ladyhawke;89457;5.5;19;12;7;63;0;0;0;0;0;0;0;0
3480;Lucas;91445;6.2;14;9;5;64;0;2;2;0;100;3.3;2546;66
3481;High Fidelity;146882;7.6;145;133;12;91;7.2;38;33;5;86;3.7;41116;88
3483;The Road to El Dorado;138749;5.5;101;49;52;48;5.1;26;10;16;38;3.1;9172;64
3484;The Skulls;192614;3.1;84;7;77;8;3;28;2;26;7;2.8;6706;48
3485;Macchie solari;73327;0;2;1;1;50;0;0;0;0;0;0;0;0
3486;Devil Girl from Mars;46907;0;0;0;0;0;0;0;0;0;0;0;0;0
3487;The Road to El Dorado;138749;5.5;101;49;52;48;5.1;26;10;16;38;3.1;9172;64
3489;Hook;102057;4.3;37;9;28;24;4.6;6;2;4;33;3.3;59655;72
3490;Horror Express;68713;6;5;2;3;40;0;0;0;0;0;0;0;0
3491;My Chauffeur;91579;0;1;0;1;0;0;0;0;0;0;0;0;0
3492;The Son of the Sheik;17416;6.8;6;4;2;66;0;0;0;0;0;0;0;0
3494;True Grit;65126;7.6;15;14;1;93;0;1;1;0;100;3.8;4651;83
3495;Roadside Prophets;105267;6.7;6;5;1;83;0;0;0;0;0;0;0;0
3496;Madame Sousatzka;95564;6.2;16;12;4;75;0;4;4;0;100;3.5;120;57
3497;Max Dugan Returns;85919;6;7;5;2;71;0;1;0;1;0;3.3;492;56
3498;Midnight Express;77928;7.7;20;19;1;95;0;0;0;0;0;0;0;0
3499;Misery;100157;7.3;51;46;5;90;6.4;7;5;2;71;3.6;18885;83
3500;Mr. Saturday Night;104928;0;0;0;0;0;0;0;0;0;0;0;0;0
3501;Murphy's Romance;89643;6.6;14;12;2;85;0;1;1;0;100;3.4;940;71
3502;My Life Without Me;314412;0;0;0;0;0;0;0;0;0;0;0;0;0
3503;Solyaris;69293;8.3;39;38;1;97;8.2;8;8;0;100;4.1;7425;89
3504;Network;74958;8.1;41;37;4;90;7.4;5;4;1;80;4.1;8716;93
3505;No Way Out;93640;7.1;27;27;0;100;8;6;6;0;100;3.3;4406;65
3506;North Dallas Forty;79640;6.6;20;17;3;85;0;4;4;0;100;3.4;594;69
3507;The Odd Couple;63374;8.2;31;31;0;100;0;4;4;0;100;0;0;0
3508;The Outlaw Josey Wales;75029;8;31;30;1;96;0;3;2;1;66;0;0;0
3509;Black and White;165643;4.3;8;2;6;25;0;0;0;0;0;0;0;0
3510;Frequency;186151;6.5;122;85;37;69;6.4;27;20;7;74;3.4;17214;78
3511;Ready to Rumble;217756;4;64;16;48;25;4.3;15;4;11;26;2.6;3493;49
3512;Return to Me;122459;6.1;97;59;38;60;5.5;26;14;12;53;3.3;8306;76
3513;Rules of Engagement;160797;5;93;34;59;36;5;24;9;15;37;3.2;7074;60
3514;Joe Gould's Secret;172632;6.6;31;20;11;64;7.3;7;5;2;71;3.4;281;59
3515;Me, Myself & Irene;183505;5.4;95;46;49;48;4.7;24;9;15;37;3.1;39953;60
3516;Bell Book and Candle;51406;5.8;9;6;3;66;0;0;0;0;0;0;0;0
3518;The End of Violence;119062;4.8;33;9;24;27;4.6;10;1;9;10;3;659;43
3519;Force 10 from Navarone;77572;6.1;11;7;4;63;0;1;0;1;0;3.3;2137;56
3520;How to Stuff a Wild Bikini;59287;0;2;0;2;0;0;0;0;0;0;0;0;0
3521;Mystery Train;97940;7.2;25;21;4;84;0;1;1;0;100;3.9;3307;87
3522;Sacco e Vanzetti;67698;5.9;6;3;3;50;0;4;2;2;50;4;58;94
3523;Taffin;96211;0;2;0;2;0;0;0;0;0;0;0;0;0
3524;King Arthur;349683;4.9;183;57;126;31;5.2;38;12;26;31;3.2;57867;63
3525;Bachelor Party;86927;5.4;20;11;9;55;0;1;1;0;100;3;5525;53
3526;Parenthood;98067;7.2;39;36;3;92;7.9;7;7;0;100;3.2;6310;68
3527;Predator;93773;6.8;37;28;9;75;0;4;2;2;50;3.5;52908;83
3528;The Prince of Tides;102713;6.4;19;14;5;73;0;2;1;1;50;3.3;2156;68
3529;The Postman Always Rings Twice;82934;6.3;10;7;3;70;0;1;0;1;0;3.3;2610;61
3530;Smoking/No Smoking;108167;\N;\N;\N;\N;\N;\N;\N;\N;\N;\N;\N;\N;\N
3531;All the Vermeers in New York;99014;7.2;5;5;0;100;0;1;1;0;100;3;232;49
3533;Yukinojô henge;57710;7.5;9;8;1;88;0;2;2;0;100;4.2;181;88
3534;28 Days Later...;289043;7.3;200;177;23;88;7.1;39;34;5;87;3.6;107149;82
3535;American Psycho;144084;6.3;122;81;41;66;5.8;28;16;12;57;3.6;57904;83
3536;Keeping the Faith;171433;6.2;114;78;36;68;5.8;25;14;11;56;3;9636;55
3537;Where the Money Is;149367;5.3;74;34;40;45;5.6;19;10;9;52;3;517;36
3538;East Is East;166175;7.2;30;24;6;80;7.1;6;5;1;83;3.6;2798;75
3539;The Filth and the Fury;236216;7.8;37;35;2;94;8.6;6;6;0;100;4;362;82
3540;Passion of Mind;160644;3.9;33;5;28;15;3.8;7;0;7;0;3.1;711;45
3541;Third World Cop;179063;4.6;12;2;10;16;0;4;0;4;0;3.8;477;77
3542;Coming Apart;64180;0;4;2;2;50;0;0;0;0;0;0;0;0
3543;Diner;83833;8.2;25;24;1;96;0;2;2;0;100;3.6;2408;75
3544;Shakes the Clown;102898;4.4;19;7;12;36;0;2;0;2;0;0;0;0
3545;Cabaret;68327;8.3;32;31;1;96;6.6;5;4;1;80;3.8;7394;86
3546;What Ever Happened to Baby Jane?;56687;7.6;37;33;4;89;0;3;2;1;66;3.9;7128;89
3547;Prick Up Your Ears;93776;7.6;15;15;0;100;0;1;1;0;100;3.7;1024;76
3548;Auntie Mame;51383;8;13;12;1;92;0;0;0;0;0;0;0;0
3549;Guys and Dolls;48140;6.9;15;12;3;80;0;0;0;0;0;0;0;0
3550;Hunger;986233;7.7;109;98;11;89;7.5;24;21;3;87;3.5;21784;75
3551;Marathon Man;74860;7.2;34;27;7;79;0;1;1;0;100;3.6;4534;81
3552;Caddyshack;80487;6.5;44;33;11;75;0;4;1;3;25;3.6;26005;86
3553;Gossip;176783;4.4;65;18;47;27;3.8;19;4;15;21;2.9;3212;45
3554;Love & Basketball;199725;6.7;86;70;16;81;6.7;29;24;5;82;3.9;41056;93
3555;U-571;141926;6.2;94;64;30;68;5.9;26;16;10;61;3.1;8932;60
3556;The Virgin Suicides;159097;7;90;70;20;77;7.5;17;16;1;94;3.5;29052;80
3557;Jennifer Eight;104549;5.2;16;7;9;43;0;2;0;2;0;2.9;1225;39
3559;Limelight;44837;7.7;13;13;0;100;0;0;0;0;0;0;0;0
3560;Ai no borei;77132;0;2;1;1;50;0;0;0;0;0;0;0;0
3562;Committed;144142;5.4;38;17;21;44;5.2;10;5;5;50;2.7;930;32
3563;The Crow: Salvation;132910;4.6;9;2;7;22;0;1;1;0;100;2.9;8151;53
3564;The Flintstones in Viva Rock Vegas;158622;4;70;17;53;24;4.5;20;6;14;30;2.3;3581;30
3565;Where the Heart Is;198021;4.6;94;32;62;34;3.9;27;5;22;18;3.5;12595;78
3566;The Big Kahuna;189584;6.4;76;56;20;73;6.4;22;15;7;68;3.3;1772;65
3567;Bossa Nova;180837;6.6;28;21;7;75;0;4;2;2;50;3.2;470;54
3568;Goat on Fire and Smiling Fish;162348;5.8;14;7;7;50;0;4;2;2;50;3.2;55;50
3569;Idioterne;154421;\N;\N;\N;\N;\N;\N;\N;\N;\N;\N;\N;\N;\N
3570;The Last September;180793;5.5;23;9;14;39;7.1;5;4;1;80;3;278;39
3571;Timecode;220100;6.3;80;54;26;67;6.4;21;14;7;66;3;896;50
3572;Carnosaur;106521;3.2;9;1;8;11;0;0;0;0;0;0;0;0
3573;Carnosaur 2;112634;0;2;0;2;0;0;0;0;0;0;0;0;0
3574;Carnosaur 3: Primal Species;115834;0;2;0;2;0;0;0;0;0;0;0;0;0
3575;Defying Gravity;156460;5.9;6;4;2;66;0;3;2;1;66;3.5;284;57
3576;Caché;387898;7.8;128;113;15;88;8.2;31;29;2;93;3.5;16387;71
3577;Two Moon Junction;96324;3.2;6;0;6;0;0;1;0;1;0;3.1;1343;54
3578;Gladiator;172495;7;159;123;36;77;6.4;36;26;10;72;3.8;248672;85
3580;Up at the Villa;153464;5.3;58;27;31;46;4.9;19;7;12;36;3;371;34
3581;Human Traffic;188674;6.1;28;17;11;60;5.5;7;2;5;28;4;6954;88
3583;1-2-3-4 ou Les Collants noirs;53726;0;0;0;0;0;0;0;0;0;0;0;0;0
3584;À bout de souffle;53472;8.6;48;46;2;95;8.1;12;11;1;91;4.2;10327;90
3585;The Great Locomotive Chase;49279;0;2;1;1;50;0;0;0;0;0;0;0;0
3586;The Idolmaker;80913;6.4;7;6;1;85;0;1;1;0;100;3.7;186;80
3587;From Dusk Till Dawn;116367;6;43;27;16;62;4.9;10;5;5;50;3.4;36073;75
3588;The King of Marvin Gardens;68805;6.4;17;12;5;70;0;4;2;2;50;3.3;626;55
3589;Die Nibelungen, Teil 1 - Siegfried;60749;0;0;0;0;0;0;0;0;0;0;0;0;0
3590;The Lord's of Flatbush;71772;5.6;11;7;4;63;0;3;0;3;0;3.1;800;43
3591;Mr. Mom;85970;5.9;17;13;4;76;0;1;0;1;0;3;3176;54
3592;Les maîtres du temps;84315;0;1;0;1;0;0;0;0;0;0;0;0;0
3593;Battlefield Earth: A Saga of the Year 3000;185183;2.3;122;3;119;2;2.4;29;1;28;3;1.6;6896;14
3594;Center Stage;210616;5;79;33;46;41;5.2;21;9;12;42;3.5;28939;79
3595;Held Up;165831;3.3;30;5;25;16;3;8;1;7;12;2.9;580;48
3596;Screwed;156323;3.5;30;4;26;13;2.7;5;1;4;20;2.9;1198;48
3597;Whipped;174336;3.2;68;9;59;13;2.9;23;3;20;13;2.4;782;32
3598;Hamlet;116477;8.2;54;51;3;94;7.2;14;11;3;78;3.8;5816;86
3599;Anchors Aweigh;37514;7.2;5;3;2;60;0;0;0;0;0;0;0;0
3600;Blue Hawaii;54692;4.3;6;1;5;16;0;0;0;0;0;0;0;0
3601;The Castaway Cowboy;71288;0;2;1;1;50;0;0;0;0;0;0;0;0
3602;G.I. Blues;53848;4.7;5;0;5;0;0;0;0;0;0;0;0;0
3603;The Gay Deceivers;64363;0;3;0;3;0;0;0;0;0;0;0;0;0
3604;Gypsy;56048;6.4;11;8;3;72;0;0;0;0;0;0;0;0
3605;King Creole;51818;6.7;12;12;0;100;0;0;0;0;0;0;0;0
3606;On the Town;41716;8;16;15;1;93;0;0;0;0;0;0;0;0
3607;One Little Indian;70481;0;0;0;0;0;0;0;0;0;0;0;0;0
3608;Pee-wee's Big Adventure;89791;7.4;35;32;3;91;0;4;1;3;25;3;14034;66
3609;Regret to Inform;181786;7.7;16;15;1;93;0;3;3;0;100;3.7;139;55
3610;Roustabout;58534;5.7;8;5;3;62;0;0;0;0;0;0;0;0
3612;The Slipper and the Rose: The Story of Cinderella;75232;0;1;1;0;100;0;0;0;0;0;0;0;0
3613;Things Change;96259;6.9;11;9;2;81;0;1;1;0;100;3.5;240;70
3614;Honeymoon in Vegas;104438;6;26;17;9;65;0;2;1;1;50;2.7;3153;35
3615;Dinosaur;130623;6.2;120;78;42;65;6;30;20;10;66;3;9615;48
3616;Loser;217630;4.2;94;23;71;24;4.5;26;9;17;34;2.6;5745;37
3617;Road Trip;215129;5.9;89;52;37;58;5.9;21;14;7;66;3.3;57286;68
3618;Small Time Crooks;196216;6.4;98;65;33;66;6.2;22;13;9;59;3.2;3828;54
3619;The Hollywood Knights;80881;0;4;1;3;25;0;0;0;0;0;0;0;0
3620;The Myth of Fingerprints;119746;6;19;12;7;63;0;3;1;2;33;3.2;418;54
3621;Possession;368563;0;2;0;2;0;0;1;0;1;0;2.9;4231;34
3622;The Twelve Chairs;66495;6.5;13;12;1;92;0;0;0;0;0;0;0;0
3623;Mission: Impossible;117060;5.8;45;26;19;57;5.2;18;9;9;50;3.3;46104;70
3624;Shanghai Noon;184894;6.6;130;102;28;78;5.9;28;18;10;64;3.2;29911;67
3625;Better Living Through Circuitry;207998;6.4;16;13;3;81;0;4;3;1;75;0;0;0
3626;8 ½ Women;154443;4.9;35;14;21;40;5.2;7;2;5;28;3.1;1362;51
3627;Carnival of Souls;55830;7.2;31;25;6;80;0;4;3;1;75;3.5;2508;71
3628;Flying Tigers;34742;5.9;8;5;3;62;0;0;0;0;0;0;0;0
3629;The Gold Rush;15864;8.8;30;30;0;100;0;4;4;0;100;4.1;4794;91
3630;Lisa e il diavolo;68863;\N;\N;\N;\N;\N;\N;\N;\N;\N;\N;\N;\N;\N
3631;It's in the Water;116661;0;3;1;2;33;0;0;0;0;0;0;0;0
3632;Monsieur Verdoux;39631;8;24;23;1;95;6.8;5;4;1;80;4;1388;88
3633;On Her Majesty's Secret Service;64757;6.6;37;30;7;81;6.2;5;3;2;60;3.2;8953;62
3634;Seven Days in May;58576;7.8;18;18;0;100;0;3;3;0;100;3.9;754;86
3635;The Spy Who Loved Me;76752;6.7;37;29;8;78;5.2;5;2;3;40;3.4;10473;71
3636;Ceux qui m'aiment prendront le train;118834;5.7;17;10;7;58;0;2;2;0;100;3.6;478;68
3637;Sans toit ni loi;89960;8.6;11;11;0;100;0;1;1;0;100;4;549;82
3638;Moonraker;79574;5.7;36;23;13;63;7.6;6;6;0;100;3;10343;48
3639;The Man with the Golden Gun;71807;5.1;33;17;16;51;3.6;5;0;5;0;3.3;11297;63
3640;King of New York;99939;6;23;16;7;69;6.2;5;3;2;60;3.7;5329;77
3641;A Woman of Paris: A Drama of Fate;14624;0;3;3;0;100;0;0;0;0;0;0;0;0
3642;In Old California;34889;0;0;0;0;0;0;0;0;0;0;0;0;0
3643;The Fighting Seabees;36824;6.8;5;5;0;100;0;0;0;0;0;0;0;0
3644;Dark Command;32383;0;4;4;0;100;0;0;0;0;0;0;0;0
3645;Cléo de 5 à 7;55852;8.6;21;20;1;95;0;2;1;1;50;4;1372;88
3646;Big Momma's House;208003;4.4;80;24;56;30;4.2;26;9;17;34;3.2;47401;68
3648;The Abominable Snowman;50095;0;0;0;0;0;0;0;0;0;0;0;0;0
3649;American Gigolo;80365;6.4;15;11;4;73;0;1;1;0;100;3.1;2098;49
3650;Angustia;90644;0;3;1;2;33;0;0;0;0;0;0;0;0
3651;La novia ensangrentada;69029;7.2;6;6;0;100;0;0;0;0;0;0;0;0
3652;Paura nella città dei morti viventi;81318;4.9;10;5;5;50;0;0;0;0;0;0;0;0
3653;The Endless Summer;60371;7.2;15;15;0;100;0;3;3;0;100;4.1;1286;88
3654;The Guns of Navarone;54953;8;20;19;1;95;0;0;0;0;0;0;0;0
3655;La grande bouffe;70130;0;3;2;1;66;0;1;0;1;0;4;1017;85
3656;Lured;39589;0;3;3;0;100;0;0;0;0;0;0;0;0
3658;Quatermass and the Pit;62168;7.2;8;6;2;75;0;2;0;2;0;3.7;842;75
3659;Quatermass 2;50873;6.3;8;6;2;75;0;1;0;1;0;0;0;0
3660;Puppetmaster;98143;3.4;5;1;4;20;0;0;0;0;0;0;0;0
3661;Puppet Master II;100438;4.4;5;1;4;20;0;0;0;0;0;0;0;0
3662;Puppet Master III: Toulon's Revenge;102728;0;2;1;1;50;0;0;0;0;0;0;0;0
3663;Puppet Master 4;107899;3.6;5;0;5;0;0;0;0;0;0;0;0;0
3664;Puppet Master 5: The Final Chapter;110916;0;2;0;2;0;0;0;0;0;0;0;0;0
3665;Curse of the Puppet Master;132451;0;2;0;2;0;0;0;0;0;0;0;0;0
3666;Retro Puppet Master;189047;0;0;0;0;0;0;0;0;0;0;0;0;0
3667;Rent-a-Cop;95977;3.8;11;2;9;18;0;1;0;1;0;2.3;601;19
3668;Romeo + Juliet;117509;0;0;0;0;0;0;0;0;0;0;0;0;0
3669;Stay Tuned;105466;4.8;12;6;6;50;0;0;0;0;0;0;0;0
3670;Story of G.I. Joe;38120;5.9;10;7;3;70;0;2;0;2;0;3.5;303;71
3671;Blazing Saddles;71230;8.1;45;40;5;88;7.5;5;4;1;80;3.9;41980;89
3672;Benji the Hunted;92638;5.6;7;4;3;57;0;0;0;0;0;0;0;0
3673;Benji the Hunted;92638;5.6;7;4;3;57;0;0;0;0;0;0;0;0
3674;For the Love of Benji;76044;0;0;0;0;0;0;0;0;0;0;0;0;0
3675;White Christmas;47673;6.4;30;23;7;76;0;3;1;2;33;0;0;0
3676;Eraserhead;74486;7.9;40;36;4;90;6.5;5;4;1;80;3.9;15996;83
3677;The Boys of Baraka;444608;6.8;42;31;11;73;6.8;13;10;3;76;4;627;84
3678;The Man with the Golden Arm;48347;6.9;17;14;3;82;0;3;1;2;33;3.8;961;84
3679;The Decline of Western Civilization Part III;138393;7.6;7;7;0;100;0;2;2;0;100;4;242;78
3680;The Decline of Western Civilization Part II: The Metal Years;94980;6.4;5;4;1;80;0;2;1;1;50;3.9;762;80
3681;Per qualche dollaro in più;59578;7.8;24;22;2;91;0;2;1;1;50;3.9;15319;91
3682;Magnum Force;70355;6.6;20;16;4;80;0;0;0;0;0;0;0;0
3683;Blood Simple.;86979;8.1;77;73;4;94;7.9;12;11;1;91;3.9;11335;86
3684;The Fabulous Baker Boys;97322;7.4;23;22;1;95;8.2;5;5;0;100;3.2;2272;59
3685;Prizzi's Honor;89841;7;32;28;4;87;0;3;2;1;66;3.3;2048;61
3686;Flatliners;99582;5.3;23;12;11;52;0;2;1;1;50;3.2;10417;61
3687;Gandahar;95525;0;0;0;0;0;0;0;0;0;0;0;0;0
3688;Porky's;84522;4.5;22;7;15;31;0;1;0;1;0;3.1;8737;58
3689;Porky's II: The Next Day;86129;3.6;9;1;8;11;0;0;0;0;0;0;0;0
3690;Porky's Revenge;89826;3.7;11;3;8;27;0;0;0;0;0;0;0;0
3691;Private School;86143;0;1;0;1;0;0;0;0;0;0;0;0;0
3692;Class of Nuke 'Em High;90849;4.2;5;1;4;20;0;0;0;0;0;0;0;0
3693;The Toxic Avenger;90190;5.4;16;10;6;62;0;3;3;0;100;3.1;5107;60
3694;The Toxic Avenger Part II;98503;2.7;8;0;8;0;0;0;0;0;0;0;0;0
3695;The Toxic Avenger Part III: The Last Temptation of Toxie;98502;0;1;0;1;0;0;0;0;0;0;0;0;0
3696;Night of the Creeps;91630;6.7;11;8;3;72;0;0;0;0;0;0;0;0
3697;Predator;93773;6.8;37;28;9;75;0;4;2;2;50;3.5;52908;83
3698;The Running Man;93894;5.5;32;20;12;62;5;5;2;3;40;3.2;13632;59
3699;Starman;88172;6.5;23;18;5;78;0;4;2;2;50;3.2;5773;61
3700;The Brother from Another Planet;87004;7.1;24;22;2;91;0;4;2;2;50;3.5;941;74
3701;Alien Nation;96531;\N;\N;\N;\N;\N;\N;\N;\N;\N;\N;\N;\N;\N
3702;Mad Max;79501;7.7;38;36;2;94;6.4;5;4;1;80;3.4;17975;69
3703;Mad Max 2;82694;8.3;36;36;0;100;7.8;6;6;0;100;3.5;18318;76
3704;Mad Max Beyond Thunderdome;89530;6.3;37;30;7;81;6.7;7;6;1;85;3.1;11185;50
3705;Bird on a Wire;99141;4.4;20;6;14;30;0;2;0;2;0;2.8;6723;43
3706;Angel Heart;92563;7.1;20;15;5;75;0;2;2;0;100;3.6;7026;79
3707;Nine 1/2 Weeks;91635;5.5;21;13;8;61;0;1;1;0;100;3;6256;57
3708;Firestarter;87262;5;21;8;13;38;0;1;0;1;0;3.1;7166;57
3709;Sleepwalking;888693;4.2;57;10;47;17;4.3;22;4;18;18;3;8038;45
3710;Action Jackson;94612;3.2;10;1;9;10;0;1;0;1;0;2.6;2187;30
3711;Sarafina!;105316;5.1;8;4;4;50;0;1;0;1;0;3.8;1077;83
3712;Soapdish;102951;6;33;24;9;72;5.8;8;5;3;62;3.1;2023;56
3713;The Long Walk Home;100046;6.7;12;10;2;83;0;2;2;0;100;3.6;831;78
3714;Clara's Heart;94882;5.2;8;3;5;37;0;1;0;1;0;3.5;408;69
3715;Burglar;92710;4;11;3;8;27;0;1;0;1;0;2.7;844;43
3716;Fatal Beauty;93011;3.5;12;3;9;25;0;4;1;3;25;2.8;1052;40
3717;Gone in Sixty Seconds;187078;4.4;133;32;101;24;4;35;8;27;22;3.5;92563;79
3718;American Pimp;179074;6;21;11;10;52;0;4;1;3;25;3.5;767;67
3719;Love's Labour's Lost;182295;5.6;61;30;31;49;4.7;17;6;11;35;3.1;949;46
3720;Sunshine;448134;0;0;0;0;0;0;0;0;0;0;0;0;0
3721;Trixie;162711;4.2;48;13;35;27;3.4;14;2;12;14;2.8;268;30
3722;The Last American Virgin;84234;5.8;9;6;3;66;0;1;0;1;0;3.3;3330;60
3723;Hamlet;116477;8.2;54;51;3;94;7.2;14;11;3;78;3.8;5816;86
3724;Coming Home;77362;7.4;21;17;4;80;0;4;2;2;50;3.7;1137;79
3725;American Pop;82009;5.6;16;9;7;56;0;0;0;0;0;0;0;0
3726;Assault on Precinct 13;398712;5.9;160;96;64;60;6;36;23;13;63;3.1;12635;54
3727;Near Dark;93605;7.4;41;37;4;90;6.9;6;5;1;83;3.5;5751;73
3728;One False Move;102592;8.5;26;26;0;100;0;2;2;0;100;3.5;963;67
3729;Shaft;67741;7.4;31;28;3;90;0;2;1;1;50;3.3;2211;66
3730;The Conversation;71360;8.6;43;42;1;97;0;4;4;0;100;4;7644;89
3731;Cutter's Way;82220;7.3;5;5;0;100;0;0;0;0;0;0;0;0
3732;Balls of Fury;424823;4.2;127;29;98;22;4.5;24;8;16;33;2.8;85682;36
3733;The Paper Chase;70509;7.3;24;21;3;87;0;4;3;1;75;3.5;842;72
3734;Prince of the City;82945;7.3;16;15;1;93;0;1;1;0;100;3.9;431;82
3735;Serpico;70666;8;37;34;3;91;0;4;4;0;100;3.8;14881;85
3736;Ace in the Hole;43338;7.9;22;19;3;86;0;4;2;2;50;4.2;1846;92
3737;Lonely Are the Brave;56195;8.4;10;9;1;90;0;0;0;0;0;0;0;0
3738;The Sugarland Express;72226;7.2;25;23;2;92;0;2;1;1;50;3.3;1677;60
3739;Trouble in Paradise;23622;8.4;22;20;2;90;7.6;8;7;1;87;4.2;1059;91
3740;Big Trouble in Little China;90728;0;0;0;0;0;0;0;0;0;0;0;0;0
3741;Badlands;69762;8.7;38;37;1;97;0;4;4;0;100;0;0;0
3742;Bronenosets Potyomkin;15648;9;30;30;0;100;0;3;3;0;100;4;4546;85
3743;Boys and Girls;204175;3.8;61;7;54;11;3.9;20;3;17;15;2.8;3763;51
3744;Shaft;67741;7.4;31;28;3;90;0;2;1;1;50;3.3;2211;66
3745;Titan A.E.;120913;5.7;97;49;48;50;5.9;27;15;12;55;3.2;13747;59
3746;La lengua de las mariposas;188030;7.3;24;23;1;95;7.8;5;5;0;100;4.1;1520;89
3747;Jesus' Son;186253;7.3;43;35;8;81;7.6;9;7;2;77;3.8;1524;83
3748;Match Point;416320;7.2;205;158;47;77;7.9;40;36;4;90;3.4;41276;78
3749;Le temps retrouvé, d'après l'oeuvre de Marcel Proust;189142;7;25;17;8;68;0;3;3;0;100;3.6;451;71
3751;Chicken Run;120630;8;139;134;5;96;7.9;31;31;0;100;3;41786;53
3752;Me, Myself & Irene;183505;5.4;95;46;49;48;4.7;24;9;15;37;3.1;39953;60
3753;The Patriot;187393;6.1;131;81;50;61;5.2;30;14;16;46;3.6;80249;80
3754;The Adventures of Rocky & Bullwinkle;131704;4.8;92;39;53;42;5.2;26;13;13;50;2.2;4613;24
3755;The Perfect Storm;177971;0;0;0;0;0;0;0;0;0;0;0;0;0
3756;The Golden Bowl;200669;5.3;85;45;40;52;5.6;27;15;12;55;3;832;38
3757;Asylum;804443;0;2;0;2;0;0;1;0;1;0;2.2;1071;17
3758;Communion;76150;0;3;2;1;66;0;0;0;0;0;0;0;0
3759;Fun & Fancy Free;39404;5.9;6;4;2;66;0;2;1;1;50;3.4;1979;62
3760;The Kentucky Fried Movie;76257;6.6;26;20;6;76;0;3;2;1;66;3.5;2991;67
3761;Bound by Honor;106469;5.4;10;5;5;50;0;3;1;2;33;4.1;9658;92
3763;F/X2;101846;4.6;12;3;9;25;0;2;0;2;0;2.8;1000;37
3764;F/X2;101846;4.6;12;3;9;25;0;2;0;2;0;2.8;1000;37
3765;The Hot Spot;99797;0;0;0;0;0;0;0;0;0;0;0;0;0
3766;Missing in Action 2: The Beginning;89604;0;0;0;0;0;0;0;0;0;0;0;0;0
3767;Missing in Action 2: The Beginning;89604;0;0;0;0;0;0;0;0;0;0;0;0;0
3768;Braddock: Missing in Action III;94792;0;0;0;0;0;0;0;0;0;0;0;0;0
3769;Thunderbolt and Lightfoot;72288;6.6;22;19;3;86;0;3;2;1;66;3.5;1983;69
3770;Dreamscape;87175;6.4;27;21;6;77;0;3;1;2;33;3.1;2088;48
3771;The Golden Voyage of Sinbad;71569;5.4;7;4;3;57;0;0;0;0;0;0;0;0
3772;Il rosso segno della follia;64904;0;4;2;2;50;0;0;0;0;0;0;0;0
3773;House Party;99800;6.8;22;21;1;95;7.5;6;6;0;100;2.9;3949;74
3774;House Party 2;102065;4.4;12;3;9;25;0;2;0;2;0;2.8;2457;59
3775;Make Mine Music;38718;6.3;9;6;3;66;0;3;1;2;33;3.1;777;46
3776;Melody Time;40580;7.3;8;7;1;87;0;2;2;0;100;3.2;896;48
3777;Nekromantik;93608;4.7;6;3;3;50;0;0;0;0;0;0;0;0
3779;Project Moon Base;46213;0;1;0;1;0;0;0;0;0;0;0;0;0
3780;Rocketship X-M;42897;0;1;1;0;100;0;0;0;0;0;0;0;0
3781;Shaft in Africa;70679;4.9;7;3;4;42;0;0;0;0;0;0;0;0
3782;Shaft's Big Score!;69257;5.6;10;7;3;70;0;1;1;0;100;0;0;0
3783;Croupier;159382;7.7;53;52;1;98;7.7;13;13;0;100;3.6;2486;76
3784;The Karate Kid;87538;6.9;41;37;4;90;6.9;5;4;1;80;3.3;20688;71
3785;Scary Movie;175142;5.5;109;58;51;53;5.1;28;14;14;50;3;178002;50
3786;But I'm a Cheerleader;179116;4.7;46;15;31;32;4.1;12;3;9;25;3.4;7077;74
3787;Xizao;215369;7.3;29;25;4;86;6.6;5;3;2;60;3.9;957;89
3788;Blowup;60176;8;35;30;5;85;7.5;5;4;1;80;4;7433;86
3789;The Pawnbroker;59575;8.4;6;6;0;100;0;0;0;0;0;0;0;0
3790;Groove;212974;6.1;50;28;22;56;5.5;14;6;8;42;3.8;1177;79
3791;Footloose;87277;5.6;32;18;14;56;0;4;3;1;75;3.3;28933;73
3792;Duel in the Sun;38499;6.5;14;12;2;85;0;0;0;0;0;0;0;0
3793;X-Men;120903;7;152;124;28;81;5.8;32;19;13;59;3.7;133573;83
3794;Chuck & Buck;200530;7;85;72;13;84;7;31;26;5;83;3.2;907;59
3795;The Five Senses;168794;6.7;31;23;8;74;6.3;7;4;3;57;3.6;461;76
3796;The Wisdom of Crocodiles;120894;5.3;19;9;10;47;6.3;5;4;1;80;3.2;1130;51
3797;The In Crowd;163676;2.7;52;1;51;1;2.4;14;0;14;0;2.6;925;41
3798;What Lies Beneath;161081;5.5;122;55;67;45;5.1;30;13;17;43;3.1;17841;61
3799;Pokémon: The Movie 2000;257001;3.8;63;10;53;15;4;18;4;14;22;2.7;8481;51
3800;Les amants criminels;205735;6.1;14;9;5;64;0;2;1;1;50;3.4;502;63
3801;Anatomy of a Murder;52561;8.5;35;35;0;100;0;4;4;0;100;4;3171;89
3802;Freejack;104299;4.1;12;2;10;16;0;1;0;1;0;2.6;3020;27
3803;Greaser's Palace;68659;4;5;2;3;40;0;1;0;1;0;3.7;274;72
3804;Some Like It Hot;53291;8.9;40;39;1;97;0;4;4;0;100;4.1;23119;93
3805;Knight Rider;1114258;0;0;0;0;0;0;0;0;0;0;0;0;0
3806;Mackenna's Gold;64615;5.4;5;2;3;40;0;0;0;0;0;0;0;0
3807;Sinbad and the Eye of the Tiger;76716;6;8;5;3;62;0;0;0;0;0;0;0;0
3808;La ciociara;54749;8.6;7;7;0;100;0;0;0;0;0;0;0;0
3809;What About Bob?;103241;6.4;38;31;7;81;6.9;7;6;1;85;3.3;13746;74
3810;White Sands;105813;5;13;6;7;46;0;1;0;1;0;2.9;802;36
3811;'Breaker' Morant;80310;8.4;20;20;0;100;0;0;0;0;0;0;0;0
3812;Every Thing You Always Wanted to Know About Sex * But Were Afraid to Ask;68555;7.3;19;17;2;89;0;0;0;0;0;0;0;0
3813;Interiors;77742;6.5;12;9;3;75;0;0;0;0;0;0;0;0
3814;Love and Death;73312;8;15;15;0;100;0;1;1;0;100;4;4797;88
3816;La historia oficial;89276;8.3;8;8;0;100;0;1;1;0;100;3.9;624;86
3817;Søndagsengler;117817;0;3;2;1;66;0;0;0;0;0;0;0;0
3818;Pot o' Gold;34055;0;2;1;1;50;0;0;0;0;0;0;0;0
3819;Tampopo;92048;8.3;13;13;0;100;0;1;1;0;100;4.3;2542;93
3820;Thomas and the Magic Railroad;205461;3.9;65;12;53;18;4.3;19;5;14;26;2.8;700;41
3821;Nutty Professor II: The Klumps;144528;4.4;84;22;62;26;4.8;22;8;14;36;2.7;14847;53
3822;La fille sur le pont;144201;7.4;39;35;4;89;7.4;7;6;1;85;4.1;2378;88
3823;Wonderland;335563;5;98;34;64;34;4.5;32;7;25;21;3.3;3666;67
3824;Autumn in New York;174480;4.1;68;14;54;20;3.6;19;3;16;15;3;6655;56
3825;Coyote Ugly;200550;3.9;94;20;74;21;3.6;27;5;22;18;3.2;65988;73
3826;Hollow Man;164052;4.4;112;31;81;27;3.8;29;5;24;17;2.6;18221;35
3827;Space Cowboys;186566;6.8;114;90;24;78;7;28;23;5;82;3;9433;49
3829;Mad About Mambo;156757;5.2;14;8;6;57;0;4;1;3;25;3.1;674;46
3830;Psycho Beach Party;206226;5.5;31;17;14;54;4.4;7;2;5;28;3.3;1978;62
3831;Saving Grace;195234;6;88;56;32;63;6.3;23;15;8;65;3.8;3065;82
3832;I tre volti della paura;57603;6.7;12;10;2;83;0;0;0;0;0;0;0;0
3833;The Brain That Wouldn't Die;52646;4.2;11;4;7;36;0;0;0;0;0;0;0;0
3834;Bronco Billy;80472;6.5;15;12;3;80;0;0;0;0;0;0;0;0
3835;Crush;245407;\N;\N;\N;\N;\N;\N;\N;\N;\N;\N;\N;\N;\N
3836;Kelly's Heroes;65938;7;14;12;2;85;0;0;0;0;0;0;0;0
3837;Phantasm II;95863;3.9;14;4;10;28;0;1;0;1;0;0;0;0
3838;Phantasm III: Lord of the Dead;110823;4.5;9;4;5;44;0;0;0;0;0;0;0;0
3839;Phantasm IV: Oblivion;138703;3.5;7;1;6;14;0;0;0;0;0;0;0;0
3840;Pumpkinhead;95925;5.3;16;9;7;56;0;1;0;1;0;2.9;3312;52
3841;Air America;99005;3.4;14;2;12;14;0;1;0;1;0;2.7;5347;37
3843;Sleepaway Camp;86320;6.2;10;7;3;70;0;0;0;0;0;0;0;0
3844;Steel Magnolias;98384;5.8;18;12;6;66;0;1;1;0;100;3.6;26167;88
3845;Et Dieu... créa la femme;49189;6.2;11;8;3;72;0;1;0;1;0;3;1435;52
3846;Easy Money;85470;5.2;6;2;4;33;0;1;0;1;0;3.1;883;57
3847;Ilsa: She Wolf of the SS;71650;3.9;10;3;7;30;0;1;0;1;0;3;950;49
3848;Silent Fall;111187;4.1;17;4;13;23;3.2;5;0;5;0;3;420;37
3849;The Spiral Staircase;38975;8;13;12;1;92;0;0;0;0;0;0;0;0
3850;What Ever Happened to Aunt Alice?;65206;0;0;0;0;0;0;0;0;0;0;0;0;0
3851;I'm the One That I Want;251739;6.7;22;13;9;59;0;4;2;2;50;0;0;0
3852;The Tao of Steve;234853;6.8;47;37;10;78;7.8;9;9;0;100;3.4;1245;66
3853;The Tic Code;165986;6.6;28;21;7;75;7.2;11;10;1;90;3.5;135;64
3854;Aimée & Jaguar;130444;7.2;48;43;5;89;7.1;13;12;1;92;4;1140;84
3855;Une liaison pornographique;204709;7.4;34;29;5;85;8.6;7;7;0;100;3.7;724;75
3857;Bless the Child;163983;2.9;97;3;94;3;2.4;28;0;28;0;2.8;4085;45
3858;Cecil B. DeMented;173716;5.6;78;40;38;51;4.4;24;8;16;33;3.4;2682;65
3859;The Eyes of Tammy Faye;233687;7;34;29;5;85;7.6;6;6;0;100;3.6;398;69
3860;The Opportunists;138681;5.7;26;14;12;53;6.9;6;5;1;83;3.1;74;41
3861;The Replacements;191397;4.9;105;42;63;40;4.5;32;11;21;34;3.1;15029;70
3862;About Adam;199314;6;57;39;18;68;6.7;16;13;3;81;3;2040;45
3863;The Cell;209958;5.3;142;65;77;45;4.5;31;13;18;41;2.8;13598;55
3864;Gojira ni-sen mireniamu;188640;0;0;0;0;0;0;0;0;0;0;0;0;0
3865;The Original Kings of Comedy;236388;6.9;87;75;12;86;7.1;29;26;3;89;3.7;3266;81
3866;Sunset Blvd.;43014;9.2;52;51;1;98;8.2;7;7;0;100;4.3;12588;95
3867;All the Rage;176426;4.2;11;3;8;27;0;1;0;1;0;2.9;444;40
3868;The Naked Gun: From the Files of Police Squad!;95705;7.2;35;31;4;88;0;4;4;0;100;3.2;16516;78
3869;The Naked Gun 2½: The Smell of Fear;102510;5.8;34;19;15;55;6.9;7;6;1;85;2.9;10932;66
3870;Our Town;32881;7.2;7;6;1;85;0;0;0;0;0;0;0;0
3871;Shane;46303;8.3;28;27;1;96;0;4;3;1;75;3.7;3957;78
3872;Suddenly, Last Summer;53318;7.7;6;6;0;100;0;0;0;0;0;0;0;0
3873;Cat Ballou;59017;7.4;19;19;0;100;0;0;0;0;0;0;0;0
3874;Un divan à New York;118018;0;3;1;2;33;0;0;0;0;0;0;0;0
3875;The Devil Rides Out;62885;7.3;14;13;1;92;0;2;2;0;100;3.7;898;74
3876;Tom and Jerry: The Movie;105616;2.8;6;1;5;16;0;0;0;0;0;0;0;0
3877;Supergirl;88206;3.3;24;2;22;8;0;4;0;4;0;2.3;7270;28
3878;X: The Unknown;49967;0;0;0;0;0;0;0;0;0;0;0;0;0
3879;The Art of War;160009;3.9;80;13;67;16;3.8;25;6;19;24;2.9;3794;45
3880;The Ballad of Ramblin' Jack;236008;7.4;18;17;1;94;0;3;3;0;100;3.6;162;48
3881;Bittersweet Motel;168515;0;1;1;0;100;0;1;1;0;100;4.3;140;92
3882;Bring It On;204946;6;115;73;42;63;5.7;32;19;13;59;3.1;100795;68
3883;Catfish in Black Bean Sauce;162903;5.3;14;6;8;42;0;4;1;3;25;3.5;264;64
3884;Star Trek;796366;8.1;281;265;16;94;7.8;41;38;3;92;4.1;380680;91
3885;Love & Sex;234137;\N;\N;\N;\N;\N;\N;\N;\N;\N;\N;\N;\N;\N
3886;Steal This Movie;161216;5.5;41;22;19;53;5.1;9;4;5;44;3.6;704;69
3887;Went to Coney Island on a Mission from God... Be Back by Five;157182;5.4;7;3;4;42;0;1;0;1;0;0;0;0
3888;Skipped Parts;209322;0;4;1;3;25;0;0;0;0;0;0;0;0
3889;Highlander: Endgame;144964;3.3;53;6;47;11;3.6;13;2;11;15;2.8;5402;49
3891;Center Stage: Turn It Up;1145144;0;4;2;2;50;0;0;0;0;0;0;0;0
3892;Grey's Anatomy;413573;\N;\N;\N;\N;\N;\N;\N;\N;\N;\N;\N;\N;\N
3893;Nurse Betty;171580;7.2;129;108;21;83;6.6;33;24;9;72;2.6;4271;37
3894;Solas;190798;7.3;19;17;2;89;7.3;5;4;1;80;4;317;87
3895;The Watcher;204626;3.4;87;9;78;10;3.3;25;2;23;8;2.7;3820;36
3896;The Way of the Gun;202677;5.4;102;48;54;47;4.9;24;10;14;41;3.3;5742;68
3897;Almost Famous;181875;7.8;159;139;20;87;7.1;33;26;7;78;3.7;57797;89
3898;Bait;211938;4.2;81;21;60;25;3.4;22;4;18;18;2.9;2354;44
3899;The Circus;18773;8.4;15;15;0;100;0;2;2;0;100;4.1;1756;92
3900;Crime and Punishment in Suburbia;197384;3.6;29;6;23;20;3;12;2;10;16;3.3;634;61
3901;Duets;134630;3.9;88;18;70;20;3.9;25;5;20;20;2.9;2253;44
3902;Goya en Burdeos;210717;6;26;14;12;53;6.2;6;2;4;33;3.5;289;65
3903;Urbania;182508;6.8;27;19;8;70;7.2;6;4;2;66;3.6;469;73
3905;The Specials;181836;5.1;15;7;8;46;0;1;0;1;0;3.3;699;59
3906;Under Suspicion;164212;5.3;44;22;22;50;5.2;12;6;6;50;3.2;1858;49
3907;Prince of Central Park;170452;4.4;5;1;4;20;0;1;0;1;0;3;480;40
3908;Urban Legends: Final Cut;192731;3;78;7;71;8;2.6;20;1;19;5;2.5;5717;35
3909;Woman on Top;206420;4.8;95;33;62;34;4.7;28;9;19;32;3;2022;44
3910;Dancer in the Dark;168629;6.7;113;76;37;67;6.2;26;17;9;65;4.1;17700;90
3911;Best in Show;218839;7.5;107;101;6;94;7.6;29;28;1;96;3.7;12719;87
3912;A Beautiful Mind;268978;7.1;180;140;40;77;7.2;37;30;7;81;3.9;103150;91
3913;Barenaked in America;211219;6.4;18;14;4;77;6.9;5;4;1;80;0;0;0
3914;The Broken Hearts Club: A Romantic Comedy;222850;6;27;17;10;62;0;4;3;1;75;3.6;2111;70
3915;Girlfight;578680;\N;\N;\N;\N;\N;\N;\N;\N;\N;\N;\N;\N;\N
3916;Remember the Titans;210945;6.3;130;94;36;72;5.8;32;20;12;62;3.9;91483;91
3917;Hellraiser;93177;5.9;30;19;11;63;0;3;0;3;0;3.4;13712;77
3918;Hellbound: Hellraiser II;95294;5.1;18;8;10;44;0;3;1;2;33;3.2;6950;68
3919;Hellraiser III: Hell on Earth;104409;3.8;9;2;7;22;0;1;0;1;0;2.9;5917;52
3920;In weiter Ferne, so nah!;107209;0;0;0;0;0;0;0;0;0;0;0;0;0
3921;Psycho Beach Party;206226;5.5;31;17;14;54;4.4;7;2;5;28;3.3;1978;62
3922;Bikini Beach;57887;0;0;0;0;0;0;0;0;0;0;0;0;0
3923;Return of the Fly;53219;4.8;12;5;7;41;0;0;0;0;0;0;0;0
3924;Pajama Party;58440;4.5;7;3;4;42;0;0;0;0;0;0;0;0
3925;Stranger Than Paradise;88184;7.6;19;18;1;94;0;1;1;0;100;4;4419;88
3926;Voyage to the Bottom of the Sea;55608;6.2;11;9;2;81;0;0;0;0;0;0;0;0
3927;Fantastic Voyage;60397;7;25;23;2;92;0;3;3;0;100;3.3;1258;66
3928;Bud Abbott Lou Costello Meet Frankenstein;40068;7.1;22;20;2;90;0;2;0;2;0;3.8;2347;81
3929;The Bank Dick;32234;8.6;21;21;0;100;0;3;3;0;100;0;0;0
3930;Creature from the Black Lagoon;46876;7;26;22;4;84;0;2;1;1;50;3.3;4189;63
3931;The Giant Gila Monster;52846;2.9;8;1;7;12;0;0;0;0;0;0;0;0
3932;The Invisible Man;24184;8.4;29;29;0;100;0;4;4;0;100;3.7;2484;78
3933;The Killer Shrews;52969;4.7;9;5;4;55;0;0;0;0;0;0;0;0
3934;Kronos;50610;5;6;4;2;66;0;0;0;0;0;0;0;0
3936;The Phantom of the Opera;293508;5;165;54;111;32;4.6;37;10;27;27;3.7;70849;86
3937;Runaway Jury;313542;6.6;152;111;41;73;6.6;38;28;10;73;3.4;11578;73
3938;The Slumber Party Massacre;84695;4;10;3;7;30;0;0;0;0;0;0;0;0
3939;Slumber Party Massacre II;93996;0;3;0;3;0;0;0;0;0;0;0;0;0
3940;Slumber Party Massacre III;100639;0;2;0;2;0;0;0;0;0;0;0;0;0
3941;Sorority House Massacre;91990;0;4;0;4;0;0;0;0;0;0;0;0;0
3942;Sorority House Massacre II;100663;0;2;1;1;50;0;0;0;0;0;0;0;0
3943;Bamboozled;215545;5.4;96;46;50;47;5.5;32;16;16;50;3.6;2334;74
3944;Bootmen;210584;4.9;17;6;11;35;4.4;5;1;4;20;3.4;1576;65
3945;Digimon: Digital Monsters;210418;0;3;0;3;0;0;0;0;0;0;0;0;0
3946;Get Carter;208988;3.6;60;7;53;11;2.9;19;1;18;5;2.5;4003;31
3947;Get Carter;208988;3.6;60;7;53;11;2.9;19;1;18;5;2.5;4003;31
3948;Meet the Parents;212338;6.9;140;118;22;84;7.1;35;29;6;82;3.6;119331;79
3949;Requiem for a Dream;180093;7.4;127;99;28;77;6.6;32;21;11;65;4.1;103666;93
3950;Tigerland;170691;7;42;32;10;76;7.5;10;9;1;90;3.4;8243;68
3951;Two Family House;202641;7.6;33;29;4;87;8.2;10;10;0;100;3.6;294;79
3952;The Contender;208874;6.7;128;97;31;75;6.2;34;25;9;73;3.5;2093;72
3953;Dr T and the Women;205271;5.7;106;60;46;56;5.9;33;21;12;63;2.3;2922;20
3954;Just Looking;162236;5.3;21;9;12;42;4.7;5;1;4;20;3.1;291;54
3955;The Ladies Man;213790;3.2;71;8;63;11;3.3;18;3;15;16;2.6;2790;43
3956;Lost Souls;160484;3;89;6;83;6;2.6;26;0;26;0;2.6;2140;26
3957;Billy Jack;66832;5.4;13;8;5;61;0;1;0;1;0;3.4;2007;63
3958;Billy Jack Goes to Washington;75754;2.7;7;0;7;0;0;0;0;0;0;0;0;0
3959;The Time Machine;268695;4.8;146;41;105;28;5;32;6;26;18;2.7;10389;45
3960;Thir13en Ghosts;245674;3.4;89;11;78;12;3.4;22;3;19;13;3;20700;60
3961;Ghoulies;89200;3;8;0;8;0;0;0;0;0;0;0;0;0
3962;Ghoulies II;93091;1.8;5;0;5;0;0;0;0;0;0;0;0;0
3963;The Unsinkable Molly Brown;58708;5.1;7;5;2;71;0;0;0;0;0;0;0;0
3964;The Adventures of Ichabod and Mr. Toad;41094;7;10;9;1;90;0;3;2;1;66;3.4;2101;65
3965;The Strange Love of Martha Ivers;38988;7.4;8;8;0;100;0;1;1;0;100;3.5;463;69
3966;Detour;37638;8.2;17;17;0;100;0;3;3;0;100;3.7;1411;75
3967;Billy Elliot;249462;7.2;114;97;17;85;7.3;33;29;4;87;3.4;21103;82
3968;Bedazzled;230030;5.4;109;53;56;48;5.2;32;14;18;43;2.7;15017;45
3969;Pay It Forward;223897;5;125;49;76;39;4.5;35;13;22;37;3.5;22458;82
3970;E tu vivrai nel terrore - L'aldilà;82307;6.2;16;10;6;62;0;1;0;1;0;3.9;2574;80
3971;The Private Eyes;81376;0;3;1;2;33;0;0;0;0;0;0;0;0
3972;Jui kuen II;111512;7;74;61;13;82;7.1;24;20;4;83;3.6;7905;83
3973;Book of Shadows: Blair Witch 2;229260;3.4;103;13;90;12;3;29;2;27;6;2.1;7040;24
3974;The Little Vampire;192255;5.5;65;35;30;53;5;20;9;11;45;2.7;4743;54
3975;Lucky Number Slevin;425210;0;0;0;0;0;0;0;0;0;0;0;0;0
3976;Stardom;192949;4.9;21;8;13;38;5.3;5;2;3;40;2.8;424;34
3977;Charlie's Angels: Full Throttle;305357;5;171;74;97;43;5;37;15;22;40;3;33126;54
3978;The Legend of Bagger Vance;146984;5.2;128;54;74;42;4.7;32;12;20;37;3.2;9150;64
3979;Little Nicky;185431;3.9;113;24;89;21;3.9;31;6;25;19;3.1;32660;64
3980;Men of Honor;203019;5.3;102;42;60;41;5.7;31;17;14;54;3.6;13217;83
3981;Red Planet;199753;3.7;98;12;86;12;3.4;28;3;25;10;2.6;5320;32
3982;What's Cooking?;197096;5.5;65;34;31;52;5.2;21;10;11;47;3.4;440;64
3983;You Can Count on Me;203230;8;96;91;5;94;7.7;29;27;2;93;4;2952;87
3984;Diamonds Are Forever;66995;6.4;36;24;12;66;5.7;6;3;3;50;3.4;12688;64
3985;The Eagle Has Landed;74452;6.5;5;4;1;80;0;0;0;0;0;0;0;0
3986;The 6th Day;216216;5.2;112;45;67;40;5.1;31;13;18;41;2.7;12583;38
3987;Bounce;186894;5.5;105;54;51;51;5.1;32;14;18;43;2.7;3696;34
3988;How the Grinch Stole Christmas;170016;5.6;127;67;60;52;5.2;31;16;15;51;3.1;34926;57
3989;One Day in September;230591;8;28;27;1;96;0;3;3;0;100;4;829;88
3990;Rugrats in Paris: The Movie - Rugrats II;213203;6.3;72;54;18;75;5.8;22;13;9;59;2.8;5095;48
3991;102 Dalmatians;211181;4.4;89;27;62;30;4.2;27;8;19;29;2.9;17460;44
3992;Malèna;213847;5.6;76;42;34;55;5;30;14;16;46;3.9;7433;85
3993;Quills;180073;6.6;118;88;30;74;6.2;35;25;10;71;3.6;9122;81
3994;Unbreakable;217869;6.2;156;106;50;67;5.6;33;19;14;57;3.3;35079;73
3995;Boys Life 3;265101;5.4;7;4;3;57;0;2;0;2;0;3.2;77;43
3996;Wo hu cang long;190332;8.6;143;139;4;97;8.4;34;33;1;97;3.5;47802;81
3997;Dungeons & Dragons;190374;3.1;87;9;78;10;3.1;26;2;24;7;2.2;6148;30
3998;Proof of Life;228750;5.3;113;44;69;38;4.9;32;10;22;31;2.9;6955;44
3999;Vertical Limit;190865;5.2;107;50;57;46;5.4;32;17;15;53;2.8;6863;44
4000;The Bounty;86993;6.2;16;13;3;81;0;3;2;1;66;3.4;2904;64
4001;Code of Silence;88936;5.4;10;4;6;40;0;1;1;0;100;3;1217;50
4002;Planes, Trains & Automobiles;93748;7.8;41;39;2;95;7.1;7;6;1;85;3.4;13720;81
4003;She's Having a Baby;96094;5.4;20;10;10;50;0;1;0;1;0;3.1;2609;48
4005;The Living Daylights;93428;6.1;33;24;9;72;6.1;8;5;3;62;3.1;9634;61
4006;Transformers;418279;0;0;0;0;0;0;0;0;0;0;0;0;0
4007;Wall Street;94291;6.8;48;37;11;77;4.5;7;2;5;28;3.5;10858;79
4008;Born on the Fourth of July;96969;7.3;36;32;4;88;6.6;7;5;2;71;3.3;11412;69
4009;Talk Radio;96219;6.7;25;20;5;80;0;4;2;2;50;3.6;1535;77
4010;Brewster's Millions;88850;4.7;20;8;12;40;0;0;0;0;0;0;0;0
4011;Snatch.;208092;6.4;136;98;38;72;5.9;34;22;12;64;4;125460;92
4012;Punchline;95927;5.4;16;8;8;50;0;1;0;1;0;2.8;1447;35
4013;Mr. Accident;156807;3;6;1;5;16;0;0;0;0;0;0;0;0
4014;Chocolat;241303;6;114;71;43;62;6.1;32;20;12;62;3.6;62492;82
4015;Dude, Where's My Car?;242423;3.6;54;10;44;18;4.2;14;4;10;28;2.8;34490;52
4016;The Emperor's New Groove;120917;7;126;107;19;84;6.6;32;24;8;75;3.4;35081;75
4017;Who the #$&% Is Jackson Pollock?;487092;7.4;15;15;0;100;7.8;7;7;0;100;3.5;1003;71
4018;What Women Want;207201;5.6;118;62;56;52;5.8;32;20;12;62;3.1;33431;60
4019;Finding Forrester;181536;6.5;122;90;32;73;6.3;30;21;9;70;3.4;15572;76
4020;The Gift;219699;5.9;116;65;51;56;6.1;29;18;11;62;3.1;8477;56
4021;Before Night Falls;247196;6.9;95;71;24;74;7.6;28;26;2;92;3.8;7012;79
4022;Cast Away;162222;7.4;152;136;16;89;7.2;34;30;4;88;3.5;60473;80
4023;The Family Man;218967;5.4;125;65;60;52;4.7;31;11;20;35;3.1;19358;66
4024;The House of Mirth;200720;6.9;93;75;18;80;6.9;31;25;6;80;3.5;1118;69
4025;Miss Congeniality;212346;5.1;113;46;67;40;4.3;27;8;19;29;3.2;63572;71
4026;Injeong sajeong bol geot eobtda;223530;\N;\N;\N;\N;\N;\N;\N;\N;\N;\N;\N;\N;\N
4027;O Brother, Where Art Thou?;190590;7.1;143;109;34;76;6.6;35;24;11;68;3.7;35122;87
4028;Songcatcher;210299;6.3;80;57;23;71;6.3;26;19;7;73;3.7;521;77
4029;State and Main;120202;7.3;113;97;16;85;6.8;29;24;5;82;3.3;2255;64
4030;Dracula 2000;219653;0;0;0;0;0;0;0;0;0;0;0;0;0
4031;All the Pretty Horses;149624;4.9;99;32;67;32;4.6;33;8;25;24;3;2957;43
4032;An Everlasting Piece;218182;5.2;45;22;23;48;6.2;18;14;4;77;3.6;540;73
4033;Thirteen Days;146309;7.1;114;94;20;82;7.1;28;24;4;85;3.4;4777;76
4034;Traffic;181865;8;149;136;13;91;7.8;39;36;3;92;3.5;26217;81
4035;The Claim;218378;5.8;83;52;31;62;6.2;28;18;10;64;3.1;892;46
4036;Shadow of the Vampire;189998;7;133;108;25;81;6.9;32;27;5;84;3.4;5965;69
4037;House of Games;93223;8.2;24;23;1;95;0;1;1;0;100;3.8;1676;80
4038;Kill Me Again;97662;0;4;4;0;100;0;0;0;0;0;0;0;0
4039;Annie;83564;4.9;23;12;11;52;0;4;2;2;50;3.1;20236;64
4040;Don't Tell Mom the Babysitter's Dead;101757;0;0;0;0;0;0;0;0;0;0;0;0;0
4041;An Officer and a Gentleman;84434;7.4;16;15;1;93;0;1;1;0;100;3.5;8345;79
4042;The Alamo;318974;0;0;0;0;0;0;0;0;0;0;0;0;0
4043;At Close Range;90670;7.1;14;13;1;92;0;1;1;0;100;3.5;2435;71
4044;Breaker! Breaker!;75783;0;1;0;1;0;0;0;0;0;0;0;0;0
4045;Breakheart Pass;72735;6.3;7;5;2;71;0;0;0;0;0;0;0;0
4046;Friendly Persuasion;49233;7.7;6;6;0;100;0;0;0;0;0;0;0;0
4047;Gettysburg;107007;7.1;15;13;2;86;0;3;3;0;100;3.7;4656;86
4048;Imaginary Crimes;110115;6.5;7;5;2;71;0;3;2;1;66;3.2;276;55
4049;Rancho Deluxe;73605;6;12;8;4;66;0;4;1;3;25;3;463;42
4050;The St. Francisville Experiment;218625;0;3;0;3;0;0;0;0;0;0;0;0;0
4051;Ein Toter hing im Netz;54333;0;0;0;0;0;0;0;0;0;0;0;0;0
4052;Antitrust;218817;4.1;102;25;77;24;4;31;9;22;29;2.8;5738;48
4053;Double Take;238948;3.4;75;9;66;12;3.5;22;4;18;18;2.8;2242;47
4054;Save the Last Dance;206275;0;0;0;0;0;0;0;0;0;0;0;0;0
4055;Panic Room;258000;6.9;178;136;42;76;6.6;34;24;10;70;3;19615;61
4056;The Pledge;237572;6.8;119;92;27;77;7.1;36;31;5;86;3.2;4315;55
4057;Kids World;176883;0;2;0;2;0;0;1;0;1;0;3.2;289;47
4059;The Amati Girls;213446;4.2;12;5;7;41;3.3;5;1;4;20;3.4;179;65
4060;Love Field;104765;5.7;10;5;5;50;0;3;0;3;0;3.2;596;48
4061;Man on the Moon;125664;6.2;117;73;44;62;5.3;31;16;15;51;3.3;15027;74
4062;Mystic Pizza;95690;0;0;0;0;0;0;0;0;0;0;0;0;0
4063;Prelude to a Kiss;105165;5.8;21;13;8;61;0;4;2;2;50;2.8;2250;37
4064;Coffy;69897;6.7;19;15;4;78;0;4;2;2;50;3.7;2668;73
4065;Foxy Brown;71517;5.5;18;10;8;55;0;2;1;1;50;3.4;1680;67
4066;I'm Gonna Git You Sucka;95348;5.7;26;16;10;61;4.2;5;2;3;40;3.4;2387;69
4067;Untamed Heart;108451;5.6;25;13;12;52;0;3;2;1;66;3.4;3409;76
4068;Sugar & spice: Fûmi zekka;794373;\N;\N;\N;\N;\N;\N;\N;\N;\N;\N;\N;\N;\N
4069;The Wedding Planner;209475;0;2;2;0;100;0;0;0;0;0;0;0;0
4070;Amy;118614;5;14;6;8;42;6.1;6;4;2;66;3.7;361;76
4072;Trolösa;157122;\N;\N;\N;\N;\N;\N;\N;\N;\N;\N;\N;\N;\N
4073;The Invisible Circus;178642;4.1;60;13;47;21;3.8;19;3;16;15;3;935;44
4074;Die Stille nach dem Schuß;234805;7.4;14;12;2;85;0;4;4;0;100;3.5;304;66
4076;Two Ninas;162024;5.9;9;6;3;66;0;4;3;1;75;3;339;40
4077;Harry un ami qui vous veut du bien;216800;7.5;88;84;4;95;7.9;26;26;0;100;3.6;960;74
4078;Amazing Grace and Chuck;92545;4.4;7;2;5;28;0;2;0;2;0;0;0;0
4079;Amazon Women on the Moon;92546;5.5;11;7;4;63;0;1;0;1;0;3.2;2625;53
4080;Baby Boom;92605;6.4;16;13;3;81;0;1;1;0;100;2.9;3027;56
4081;Back to the Beach;92608;5.8;14;10;4;71;0;1;1;0;100;2.9;1446;49
4082;Barfly;92618;6.6;17;13;4;76;0;2;1;1;50;3.8;2187;82
4083;Best Seller;92641;5.9;10;6;4;60;0;1;0;1;0;3.1;763;45
4084;Beverly Hills Cop II;92644;4.8;24;11;13;45;0;1;0;1;0;3.1;15724;63
4085;Beverly Hills Cop;86960;7.1;36;30;6;83;6.4;5;3;2;60;3.4;24776;73
4086;The Big Easy;92654;7.5;13;13;0;100;0;1;1;0;100;3.3;1369;61
4087;Da wan;287934;4.7;15;3;12;20;0;1;0;1;0;3.6;201;72
4088;The Big Town;92656;5.5;6;4;2;66;0;1;1;0;100;3;433;30
4089;Born in East L.A.;92690;4.9;7;3;4;42;0;0;0;0;0;0;0;0
4090;The Brave Little Toaster;92695;7.1;12;9;3;75;0;0;0;0;0;0;0;0
4091;Can't Buy Me Love;92718;4.8;19;8;11;42;0;3;0;3;0;3.3;7122;73
4092;Cherry 2000;92746;2.7;6;0;6;0;0;0;0;0;0;0;0;0
4093;Paul Blart: Mall Cop;1114740;4.6;106;37;69;34;4.5;25;8;17;32;3.2;234394;50
4094;Critical Condition;92798;0;1;1;0;100;0;0;0;0;0;0;0;0
4095;Cry Freedom;92804;6.4;21;16;5;76;6;5;3;2;60;3.8;2642;86
4096;Cursed;257516;0;0;0;0;0;0;0;0;0;0;0;0;0
4097;Killer Movie;988083;0;1;0;1;0;0;0;0;0;0;0;0;0
4098;Dawn of the Dead;363547;6.7;171;130;41;76;6.1;32;20;12;62;3.4;49706;75
4099;Death Before Dishonor;92854;0;4;0;4;0;0;1;0;1;0;2.9;538;33
4100;Disorderlies;92897;0;2;0;2;0;0;0;0;0;0;0;0;0
4101;Dogs in Space;92904;0;2;1;1;50;0;0;0;0;0;0;0;0
4102;Eddie Murphy Raw;92948;6.4;20;16;4;80;0;2;2;0;100;3.7;5495;84
4103;Empire of the Sun;92965;6.8;35;28;7;80;5.7;6;3;3;50;3.9;15781;88
4104;Ernest Goes to Camp;92974;5.4;13;8;5;61;0;0;0;0;0;0;0;0
4105;The Evil Dead;83907;8.1;45;45;0;100;0;3;3;0;100;3.6;26792;81
4106;Extreme Prejudice;92997;6.4;7;5;2;71;0;1;1;0;100;3.1;682;49
4107;Family Viewing;93006;0;0;0;0;0;0;0;0;0;0;0;0;0
4108;Five Corners;93029;6.1;7;5;2;71;0;0;0;0;0;0;0;0
4109;Flowers in the Attic;93036;3.4;7;1;6;14;0;0;0;0;0;0;0;0
4110;The Fourth Protocol;93044;5.7;14;9;5;64;0;2;2;0;100;3.4;544;58
4111;Gardens of Stone;93073;4.7;13;5;8;38;4.2;6;1;5;16;3.4;619;57
4112;Giulia e Giulia;93092;0;4;2;2;50;0;1;1;0;100;2.7;36;33
4113;The Glass Menagerie;93093;6;9;6;3;66;0;0;0;0;0;0;0;0
4114;Good Morning, Babylon;93104;0;4;3;1;75;0;0;0;0;0;0;0;0
4115;Hiding Out;93186;4.7;6;2;4;33;0;1;0;1;0;3.3;562;64
4116;Hollywood Shuffle;93200;6.5;23;20;3;86;6.6;5;4;1;80;0;0;0
4117;Hope and Glory;93209;8.4;17;16;1;94;0;1;1;0;100;3.7;1181;82
4118;Hot Pursuit;93215;0;3;0;3;0;0;0;0;0;0;0;0;0
4119;Housekeeping;93225;7.6;8;8;0;100;0;1;1;0;100;4.2;254;85
4120;Hunk;93231;0;2;0;2;0;0;0;0;0;0;0;0;0
4121;Innerspace;93260;6.6;34;27;7;79;6.4;6;5;1;83;3.1;4478;59
4122;Ironweed;93277;7.4;10;9;1;90;0;1;1;0;100;3.4;1004;58
4123;Ishtar;93278;3.4;26;5;21;19;0;1;0;1;0;2.3;1043;33
4124;Jaws: The Revenge;93300;2;20;0;20;0;2.2;5;0;5;0;2.5;12154;30
4125;Leonard Part 6;93405;0;0;0;0;0;0;0;0;0;0;0;0;0
4126;Less Than Zero;93407;5.2;24;13;11;54;0;3;1;2;33;3.4;3388;65
4127;Like Father Like Son;93418;0;1;0;1;0;0;0;0;0;0;0;0;0
4128;The Lost Boys;93437;6.3;40;30;10;75;0;4;2;2;50;3.7;48695;85
4129;Made in Heaven;93467;4.4;10;4;6;40;0;1;0;1;0;0;0;0
4130;Maid to Order;93476;4.6;11;4;7;36;0;1;0;1;0;2.8;763;50
4131;Making Mr. Right;93477;4.8;13;6;7;46;0;3;2;1;66;2.8;480;33
4132;Mannequin;93493;\N;\N;\N;\N;\N;\N;\N;\N;\N;\N;\N;\N;\N
4133;Masters of the Universe;93507;3.1;16;2;14;12;0;3;0;3;0;2.6;7837;39
4135;The Monster Squad;93560;5.5;16;9;7;56;0;2;0;2;0;3.6;8621;76
4136;A Month in the Country;93562;0;2;2;0;100;0;0;0;0;0;0;0;0
4137;Morgan Stewart's Coming Home;93567;0;4;0;4;0;0;0;0;0;0;0;0;0
4138;My Demon Lover;93589;0;3;0;3;0;0;0;0;0;0;0;0;0
4139;No Man's Land;283509;7.8;97;90;7;92;8.2;24;23;1;95;4.1;3608;92
4140;North Shore;93648;0;2;0;2;0;0;0;0;0;0;0;0;0
4141;Head Over Heels;192111;3.3;86;8;78;9;3.7;28;5;23;17;2.9;5738;60
4142;Left Behind;190524;3.1;41;5;36;12;3.2;15;2;13;13;3.2;3491;66
4143;Valentine;242998;3.1;69;6;63;8;3.1;21;3;18;14;2.5;6295;40
4144;Fa yeung nin wa;118694;7.6;98;86;12;87;7.6;27;23;4;85;4.4;17073;94
4145;Cabin Fever;303816;5.9;134;84;50;62;5.2;31;15;16;48;2.6;15690;45
4146;The Million Dollar Hotel;120753;4.2;41;10;31;24;3.5;13;2;11;15;3.4;3687;64
4147;Krámpack;250478;6.6;52;45;7;86;6.8;19;15;4;78;3.5;545;69
4148;Hannibal;212985;5.1;162;63;99;38;4.8;37;14;23;37;3.4;44476;69
4149;Saving Silverman;239948;3.3;98;16;82;16;2.6;33;2;31;6;3;11086;52
4150;Signs & Wonders;230783;6;27;18;9;66;6.6;12;9;3;75;3;91;35
4151;Le goût des autres;216787;7.9;57;57;0;100;7.8;23;23;0;100;3.8;1673;80
4152;Vatel;190861;4.6;32;10;22;31;4.4;11;3;8;27;3.4;1090;59
4153;Down to Earth;231775;3.9;94;18;76;19;4;30;8;22;26;2.8;6402;46
4154;Recess: School's Out;265632;5.9;68;42;26;61;5.3;19;10;9;52;3.1;1678;51
4155;Sweet November;230838;3.5;95;15;80;15;3.3;33;6;27;18;3.4;24564;76
4156;Company Man;177650;3.3;62;9;53;14;2.9;23;1;22;4;2.9;433;40
4157;The Price of Milk;249893;5.4;47;23;24;48;5.5;16;8;8;50;3.7;727;69
4158;Monkeybone;166276;3.9;111;22;89;19;3.8;29;5;24;17;2.3;5059;30
4159;3000 Miles to Graceland;233142;3.5;95;13;82;13;2.7;23;1;22;4;2.9;8755;45
4160;La veuve de Saint-Pierre;191636;7.2;76;67;9;88;7.2;29;25;4;86;3.6;806;72
4161;The Mexican;236493;5.5;127;70;57;55;4.7;33;13;20;39;2.9;16576;47
4162;See Spot Run;250720;3.7;76;18;58;23;4.2;25;8;17;32;2.8;4645;51
4163;Carman: The Champion;262462;4.1;9;1;8;11;0;2;1;1;50;3.4;245;63
4164;The Caveman's Valentine;182000;5.1;80;35;45;43;4.7;29;11;18;37;3.1;1346;52
4165;Eu Tu Eles;244504;6.4;55;41;14;74;6.5;19;14;5;73;3.4;377;62
4166;Series 7: The Contenders;251031;6.5;79;55;24;69;6.5;26;19;7;73;3.4;1190;65
4167;15 Minutes;179626;\N;\N;\N;\N;\N;\N;\N;\N;\N;\N;\N;\N;\N
4168;Get Over It;192071;5.1;62;28;34;45;5.4;18;9;9;50;2.9;9761;51
4169;Blow Dry;212380;4;63;12;51;19;4.2;24;5;19;20;3.1;2504;53
4170;Hit and Runway;138493;4.5;34;11;23;32;4.1;12;3;9;25;2.6;61;19
4171;Long Night's Journey Into Day;236447;7.5;15;14;1;93;7.7;8;8;0;100;4;115;82
4172;Simon Magus;161977;\N;\N;\N;\N;\N;\N;\N;\N;\N;\N;\N;\N;\N
4173;When Brendan Met Trudy;220157;5.7;60;37;23;61;5.5;24;14;10;58;3.3;72;58
4174;The Mists of Avalon;244353;5.6;7;3;4;42;0;1;1;0;100;3.7;4639;74
4175;Grey's Anatomy;413573;\N;\N;\N;\N;\N;\N;\N;\N;\N;\N;\N;\N;\N
4176;Madadayo;107474;7.2;15;13;2;86;0;4;4;0;100;3.9;918;80
4177;The Mirror Crack'd;81163;5.7;8;6;2;75;0;0;0;0;0;0;0;0
4178;Of Mice and Men;105046;7.9;25;24;1;96;8.9;6;6;0;100;3.5;6505;77
4179;Pixote: A Lei do Mais Fraco;82912;8.6;9;9;0;100;0;0;0;0;0;0;0;0
4180;Reform School Girls;91836;4;6;1;5;16;0;0;0;0;0;0;0;0
4181;Tapeheads;96223;5.6;15;9;6;60;0;4;1;3;25;3;937;43
4182;Tuff Turf;90213;4;5;1;4;20;0;1;0;1;0;3.5;827;65
4183;The Unbelievable Truth;100842;7.7;10;10;0;100;0;1;1;0;100;3.9;679;87
4184;The Bishop's Wife;39190;6.5;19;15;4;78;0;4;2;2;50;3.8;1928;81
4185;Elvis: That's the Way It Is;65687;6.6;7;6;1;85;0;0;0;0;0;0;0;0
4186;The Fortune Cookie;60424;7.4;21;19;2;90;0;3;3;0;100;3.6;1049;77
4187;Lilies of the Field;57251;7.8;12;12;0;100;0;0;0;0;0;0;0;0
4188;Hans Christian Andersen;44685;6;5;4;1;80;0;0;0;0;0;0;0;0
4189;The Greatest Story Ever Told;59245;4.7;18;7;11;38;0;3;2;1;66;3.5;3122;68
4190;Elmer Gantry;53793;7.8;26;25;1;96;0;3;2;1;66;3.8;750;82
4191;Alfie;375173;5.5;149;73;76;48;5.2;38;16;22;42;2.9;15367;49
4192;Demetrius and the Gladiators;46899;0;3;2;1;66;0;0;0;0;0;0;0;0
4193;The Fantasticks;113026;5.2;24;12;12;50;0;2;0;2;0;3.2;418;48
4194;'I Know Where I'm Going!';37800;8.8;8;8;0;100;0;0;0;0;0;0;0;0
4195;The Abominable Dr. Phibes;66740;6.8;22;17;5;77;0;0;0;0;0;0;0;0
4196;Die, Monster, Die!;59465;5.6;5;4;1;80;0;0;0;0;0;0;0;0
4197;Dan in Real Life;480242;6.2;167;107;60;64;6.6;35;22;13;62;3.5;112489;70
4198;Battle Beyond the Stars;80421;4.1;8;2;6;25;0;0;0;0;0;0;0;0
4199;Death Warrant;99385;0;4;0;4;0;0;0;0;0;0;0;0;0
4200;Double Impact;101764;3.5;12;1;11;8;0;2;0;2;0;2.7;5123;45
4201;Pirates of the Caribbean: At World's End;449088;5.4;213;95;118;44;5.2;40;14;26;35;3.8;1768593;74
4202;Hot Fuzz;425112;7.7;194;176;18;90;7.2;39;36;3;92;4;177532;88
4203;Harley Davidson and the Marlboro Man;102005;3.6;15;4;11;26;0;1;0;1;0;3.2;2463;63
4204;Losin' It;85868;3.9;8;1;7;12;0;2;1;1;50;2.7;1511;30
4205;Mermaids;100140;6.2;15;12;3;80;0;2;1;1;50;3;6806;63
4206;The Mighty Quinn;97880;6.4;17;14;3;82;0;3;3;0;100;3.2;1203;49
4207;Navy Seals;100232;3.8;20;4;16;20;4.1;5;2;3;40;2.9;2470;46
4208;Unmade Beds;81688;0;0;0;0;0;0;0;0;0;0;0;0;0
4209;Rated X;201776;\N;\N;\N;\N;\N;\N;\N;\N;\N;\N;\N;\N;\N
4210;Manhunter;91474;7.7;32;30;2;93;0;4;4;0;100;3.5;13592;70
4211;Reversal of Fortune;100486;7.7;32;30;2;93;8.4;7;7;0;100;3.5;1155;69
4212;Death on the Nile;77413;6;11;8;3;72;0;0;0;0;0;0;0;0
4213;DeepStar Six;97179;2.5;6;0;6;0;0;0;0;0;0;0;0;0
4214;Revenge of the Nerds;88000;\N;\N;\N;\N;\N;\N;\N;\N;\N;\N;\N;\N;\N
4215;Revenge of the Nerds II: Nerds in Paradise;93857;3.6;18;1;17;5;0;3;0;3;0;2.6;3253;40
4216;Longtime Companion;100049;7.7;15;15;0;100;0;1;1;0;100;3.9;741;81
4217;4 Little Girls;118540;8.4;25;25;0;100;9.1;7;7;0;100;3.8;1088;81
4218;The River's Edge;50903;0;2;1;1;50;0;0;0;0;0;0;0;0
4219;Girls Just Want to Have Fun;89208;4.5;12;4;8;33;0;0;0;0;0;0;0;0
4220;The Longest Yard;398165;4.8;163;51;112;31;5.2;35;14;21;40;3.3;198675;67
4221;Necessary Roughness;102517;4.6;12;3;9;25;0;2;1;1;50;3;1806;45
4222;C.H.U.D.;87015;3.7;11;2;9;18;0;0;0;0;0;0;0;0
4223;Enemy at the Gates;215750;5.6;135;72;63;53;5.6;31;16;15;51;3.6;31546;81
4224;Exit Wounds;242445;4.4;64;21;43;32;4.1;18;5;13;27;2.8;6171;55
4225;The Dish;205873;7.4;95;91;4;95;7.3;26;25;1;96;3.6;1829;77
4226;Memento;209144;8.1;135;125;10;92;7.7;32;30;2;93;4;103567;93
4227;Band of Brothers;185906;0;0;0;0;0;0;0;0;0;0;0;0;0
4228;Heartbreakers;125022;5.3;115;60;55;52;4.7;32;12;20;37;2.9;11640;51
4229;Say It Isn't So;239949;3.1;101;9;92;8;2.5;28;2;26;7;2.6;2001;34
4230;Too Much Sleep;120352;6.1;45;30;15;66;6.9;21;19;2;90;1.5;3;0
4231;Someone Like You...;244970;4.8;105;43;62;40;4.3;28;9;19;32;3.1;6824;60
4232;Spy Kids 2: Island of Lost Dreams;287717;6.6;127;95;32;74;6.7;30;23;7;76;2.6;12329;43
4233;Tomcats;246989;\N;\N;\N;\N;\N;\N;\N;\N;\N;\N;\N;\N;\N
4234;The Tailor of Panama;236784;6.8;111;86;25;77;7.3;33;30;3;90;3;2860;42
4235;Amores perros;245712;7.8;111;102;9;91;7.7;30;29;1;96;4.2;37736;93
4236;Keep the River on Your Right: A Modern Cannibal Tale;206187;6.6;49;38;11;77;6.9;18;16;2;88;3.3;344;49
4237;Les glaneurs et la glaneuse;247380;7.7;37;34;3;91;7.9;13;13;0;100;4;608;87
4238;The Making of 'Along Came a Spider';349774;\N;\N;\N;\N;\N;\N;\N;\N;\N;\N;\N;\N;\N
4239;Blow;221027;5.8;134;73;61;54;5.3;32;13;19;40;3.8;70428;88
4240;Just Visiting;189192;4.7;76;25;51;32;4.6;23;8;15;34;2.9;2005;48
4241;Pokémon 3: The Movie;266860;4;53;12;41;22;3.9;16;3;13;18;3.1;4327;57
4242;Beautiful Creatures;221889;4.8;59;22;37;37;4.7;19;7;12;36;3;741;38
4243;Brigham City;268200;6.2;24;17;7;70;6.7;7;6;1;85;3.4;535;70
4244;Roozi ke zan shodam;260332;7.3;56;49;7;87;7.6;23;22;1;95;4;301;82
4245;Shadow Magic;238588;6.2;49;35;14;71;6.9;19;15;4;78;3.5;284;58
4246;Bridget Jones's Diary;243155;6.8;151;121;30;80;6.2;35;24;11;68;3.3;70748;77
4247;Joe Dirt;245686;3;74;8;66;10;2.7;24;1;23;4;2.8;16165;63
4248;Josie and the Pussycats;236348;5.2;118;62;56;52;5.6;29;17;12;58;2.6;7768;45
4249;Kingdom Come;246002;4.3;64;18;46;28;4.3;22;7;15;31;3.4;1386;66
4250;Body of Lies;758774;5.8;194;102;92;52;5.6;40;21;19;52;3.5;38376;66
4251;Chopper;221073;6.4;64;45;19;70;7;20;17;3;85;3.9;6049;89
4252;Dayereh;255094;7.8;60;56;4;93;7.9;20;19;1;95;3.7;578;75
4253;Lakeboat;210149;6.6;41;34;7;82;6.5;15;11;4;73;3.2;199;57
4254;Crocodile Dundee in Los Angeles;231402;3.6;77;9;68;11;3.6;23;2;21;8;2.4;8135;37
4255;Freddy Got Fingered;240515;2.7;91;10;81;10;2.6;27;2;25;7;2.5;14822;54
4256;The Center of the World;240402;4.8;80;27;53;33;3.6;24;3;21;12;3;592;42
4258;Sweet and Lowdown;158371;6.8;59;46;13;77;6.5;16;11;5;68;3.6;3877;76
4259;The Luzhin Defence;211492;5.9;71;42;29;59;6.1;23;14;9;60;3.5;403;68
4260;Jonas Brothers: The 3D Concert Experience;1229827;4.2;71;16;55;22;4.6;22;7;15;31;3.3;74109;64
4261;Lilies - Les feluettes;116882;7.2;7;7;0;100;0;2;2;0;100;4;517;83
4262;Scarface;86250;7.5;50;44;6;88;8;5;4;1;80;4.1;121090;93
4263;Days of Wine and Roses;55895;9;7;7;0;100;0;0;0;0;0;0;0;0
4265;Driven;132245;3.6;108;14;94;12;3.6;27;3;24;11;2.5;7367;40
4266;The Forsaken;245120;3.3;53;4;49;7;3.5;11;2;9;18;2.9;2483;45
4267;One Night at McCool's;203755;4.7;102;34;68;33;4;31;7;24;22;2.7;2770;38
4268;Town & Country;141907;3.5;89;12;77;13;3.7;24;4;20;16;2.4;717;16
4269;Ratatouille;382932;8.4;213;205;8;96;8.3;42;41;1;97;3.9;414956;84
4270;The Mummy Returns;209163;5.2;137;64;73;46;5.2;33;15;18;45;3.3;65125;69
4271;Eureka;243889;7.2;42;38;4;90;6.8;19;16;3;84;4.1;667;88
4272;Tuvalu;162023;6.8;26;19;7;73;6.3;6;3;3;50;4.1;583;90
4273;Sous le sable;240913;7.5;70;66;4;94;7.8;23;23;0;100;3.7;924;79
4274;Cleopatra;56937;5.4;20;8;12;40;0;3;2;1;66;3.4;3444;73
4275;Krull;85811;0;0;0;0;0;0;0;0;0;0;0;0;0
4276;Lost in America;89504;7.9;24;23;1;95;0;1;1;0;100;3.5;869;71
4277;The Lost World: Jurassic Park;119567;5.6;59;29;30;49;5.1;13;6;7;46;3.2;46513;55
4278;Triumph des Willens;25913;7.8;16;15;1;93;0;0;0;0;0;0;0;0
4279;True Believer;98524;7;22;21;1;95;0;4;3;1;75;3.2;549;49
4280;The World According to Garp;84917;6.3;14;11;3;78;0;1;1;0;100;3.5;3647;75
4281;Candy;424880;5.8;74;36;38;48;6.1;24;14;10;58;3.8;9542;78
4282;Fellini - Satyricon;64940;7;22;17;5;77;7.3;5;4;1;80;3.7;3120;73
4283;Roma;69191;6.5;12;7;5;58;0;2;1;1;50;3.9;1894;82
4284;Frankie and Johnny;101912;6.8;17;13;4;76;0;2;1;1;50;3.2;4527;62
4285;Frankie and Johnny;101912;6.8;17;13;4;76;0;2;1;1;50;3.2;4527;62
4286;A Home of Our Own;107130;5.7;11;5;6;45;0;3;1;2;33;3.3;706;67
4287;Paris - When It Sizzles;58453;5.8;7;4;3;57;0;0;0;0;0;0;0;0
4288;Pola X;152015;6.6;20;15;5;75;6.9;7;6;1;85;3.3;449;54
4289;La città delle donne;80539;7.1;9;7;2;77;0;2;1;1;50;3.7;1181;74
4290;Boy A;1078188;7.5;57;51;6;89;7.5;23;20;3;86;3.5;5895;84
4291;Nine to Five;80319;6.9;25;22;3;88;0;1;1;0;100;3.2;3894;70
4292;Norma Rae;79638;7.5;19;17;2;89;0;3;2;1;66;3.5;1339;77
4293;Summer Rental;90098;4.4;13;2;11;15;0;0;0;0;0;0;0;0
4294;The 5,000 Fingers of Dr. T.;45464;6.8;13;10;3;76;0;0;0;0;0;0;0;0
4295;Catchfire;96875;5.2;7;3;4;42;0;0;0;0;0;0;0;0
4296;Love Story;66011;5.8;21;12;9;57;0;4;4;0;100;3.5;10498;75
4297;Pelle erobreren;93713;7.3;8;8;0;100;0;1;1;0;100;3.9;852;86
4298;Du rififi chez les hommes;48021;8.1;40;37;3;92;7.8;9;8;1;88;4.3;2008;95
4299;A Knight's Tale;183790;5.8;137;79;58;57;5.7;34;20;14;58;3.5;77647;80
4300;Bread and Roses;212826;6.1;62;40;22;64;6.3;21;15;6;71;3.7;1038;76
4301;Calle 54;260775;7.2;47;41;6;87;7.7;19;17;2;89;3.7;351;74
4302;The King Is Alive;208911;5.8;65;39;26;60;4.7;16;6;10;37;3.3;375;55
4303;Sordid Lives;204640;4.4;27;10;17;37;4.1;8;2;6;25;4.1;754;87
4304;Startup.com;256408;7.6;92;85;7;92;7.4;30;27;3;90;3.4;490;65
4305;Angel Eyes;225071;0;0;0;0;0;0;0;0;0;0;0;0;0
4306;Shrek;126029;7.7;174;155;19;89;7.6;36;31;5;86;3.9;208170;87
4307;Fast Food Fast Women;206742;4.8;35;17;18;48;4.5;14;6;8;42;3.4;504;63
4308;Moulin Rouge!;203009;7;168;130;38;77;6.1;35;23;12;65;3.7;110817;88
4309;Petits frères;184819;5.7;13;8;5;61;0;4;4;0;100;2.6;22;25
4310;Pearl Harbor;213149;4.3;159;41;118;25;4.1;36;8;28;22;3.3;80658;73
4311;1732 Høtten;157411;6.7;8;6;2;75;0;2;2;0;100;5;5;100
4312;Himalaya - l'enfance d'un chef;210727;7.2;53;47;6;88;7.5;19;17;2;89;4;571;89
4313;The Man Who Cried;206917;4.7;68;24;44;35;4.3;23;6;17;26;3.4;8886;61
4314;Our Song;234407;7.3;51;46;5;90;7.7;21;20;1;95;3.8;342;78
4315;Gabriela;189541;0;2;0;2;0;0;0;0;0;0;0;0;0
4316;Ice Castles;77716;5.2;7;3;4;42;0;1;0;1;0;3.5;1225;71
4317;Love Potion No. 9;102343;3.7;11;3;8;27;0;0;0;0;0;0;0;0
4318;Postcards from the Edge;100395;6.8;20;18;2;90;0;2;2;0;100;3.3;2163;63
4319;Apache;46719;5.5;6;4;2;66;0;0;0;0;0;0;0;0
4320;Buffalo Bill and the Indians, or Sitting Bull's History Lesson;74254;6.3;11;8;3;72;0;2;1;1;50;3.2;745;53
4321;City Slickers;101587;6.7;26;23;3;88;0;2;2;0;100;3.1;7371;59
4322;Eight Men Out;95082;7.2;36;31;5;86;4.8;6;2;4;33;3.6;2938;76
4323;The Horse Soldiers;52902;7.4;5;5;0;100;0;0;0;0;0;0;0;0
4324;The Kentuckian;48248;0;1;0;1;0;0;0;0;0;0;0;0;0
4325;La notte;54130;6.8;14;10;4;71;0;1;1;0;100;4.2;1605;92
4326;Mississippi Burning;95647;6.3;14;12;2;85;0;1;1;0;100;3.7;6011;87
4327;The Magnificent Seven;54047;7.9;27;25;2;92;0;0;0;0;0;0;0;0
4328;Return of the Seven;60897;3.3;7;1;6;14;0;0;0;0;0;0;0;0
4329;Rio Bravo;53221;8.2;33;33;0;100;7.2;5;5;0;100;4;4947;89
4330;The Scarlet Empress;25746;9;11;11;0;100;0;0;0;0;0;0;0;0
4331;Semi-Tough;78227;6.6;5;4;1;80;0;2;1;1;50;3;355;32
4332;The Usual Suspects;114814;7.5;47;41;6;87;6.9;14;12;2;85;4.2;109588;95
4333;Throw Momma from the Train;94142;5.6;25;15;10;60;0;1;0;1;0;2.9;4120;51
4334;Yi yi;244316;0;0;0;0;0;0;0;0;0;0;0;0;0
4335;Midnight Madness;81159;0;3;0;3;0;0;1;0;1;0;3.6;703;71
4336;Nattevagten;110631;0;4;2;2;50;0;0;0;0;0;0;0;0
4337;The Sand Pebbles;60934;7;16;14;2;87;0;0;0;0;0;0;0;0
4338;Twelve O'Clock High;41996;8.2;14;14;0;100;0;0;0;0;0;0;0;0
4339;Von Ryan's Express;59885;6.8;11;10;1;90;0;0;0;0;0;0;0;0
4340;Animal House;77975;7.7;40;36;4;90;7.1;5;4;1;80;3.7;25149;88
4341;What's the Worst That Could Happen?;161083;3.5;96;10;86;10;3.3;31;1;30;3;2.7;2321;41
4342;Big Eden;212815;6;51;33;18;64;5.4;19;9;10;47;3.9;895;80
4343;Underworld: Evolution;401855;3.7;100;15;85;15;3.5;16;1;15;6;3.6;111035;77
4344;Swordfish;244244;4.3;134;34;100;25;3.5;34;6;28;17;3.2;30360;64
4345;The Anniversary Party;254099;5.8;111;67;44;60;5.5;31;18;13;58;3.2;1519;54
4346;Bride of the Wind;212827;0;0;0;0;0;0;0;0;0;0;0;0;0
4347;Musíme si pomáhat;234288;7.3;61;55;6;90;7.7;23;22;1;95;4;599;89
4348;Whatever Happened to Harold Smith?;194530;4.6;10;4;6;40;0;3;0;3;0;3.5;629;61
4349;Catch-22;65528;7.2;23;20;3;86;0;1;1;0;100;3.6;3246;74
4350;Forgotten Silver;116344;7.5;10;10;0;100;0;2;2;0;100;3.7;1179;77
4351;Point Break;102685;6;49;33;16;67;4.4;7;2;5;28;3.3;19358;75
4352;Shag;98300;6;14;9;5;64;0;4;3;1;75;3.9;1799;84
4353;Uncommon Valor;86508;6.1;9;5;4;55;0;1;0;1;0;3.4;1161;64
4354;Unlawful Entry;105699;6.2;30;22;8;73;6.4;7;6;1;85;3.1;1826;44
4355;Youngblood;92272;3.8;6;2;4;33;0;1;0;1;0;3.4;2381;67
4356;Gentlemen Prefer Blondes;45810;7.8;34;34;0;100;0;4;4;0;100;3.7;7651;82
4357;How to Marry a Millionaire;45891;7;13;12;1;92;0;0;0;0;0;0;0;0
4358;Movie Macabre;262973;\N;\N;\N;\N;\N;\N;\N;\N;\N;\N;\N;\N;\N
4359;The Seven Year Itch;48605;7.3;25;22;3;88;0;4;3;1;75;3.6;5407;75
4360;There's No Business Like Show Business;47574;6.4;11;8;3;72;0;0;0;0;0;0;0;0
4361;Tootsie;84805;7.6;39;34;5;87;8.2;6;6;0;100;3.4;12431;75
4362;The Boys Next Door;115743;0;0;0;0;0;0;0;0;0;0;0;0;0
4363;Too Late the Hero;66471;6;11;8;3;72;0;3;1;2;33;3.4;437;64
4364;Das Trio;120374;\N;\N;\N;\N;\N;\N;\N;\N;\N;\N;\N;\N;\N
4365;Pavilion of Women;244709;3.1;31;2;29;6;2.6;12;0;12;0;3.4;326;65
4366;Atlantis: The Lost Empire;230011;5.3;125;57;68;45;5;30;12;18;40;2.9;15720;50
4367;Lara Croft: Tomb Raider;146316;3.9;154;29;125;18;3.9;35;7;28;20;3.1;46926;60
4368;Dr. Dolittle 2;240462;4.9;104;42;62;40;5.4;31;14;17;45;2.8;16612;43
4369;The Fast and the Furious;232500;5.4;143;76;67;53;5.7;33;21;12;63;3.4;122441;81
4370;Artificial Intelligence: AI;212720;6.6;186;135;51;72;6.4;40;27;13;67;3.1;42316;58
4371;Baby Boy;255819;6.1;90;62;28;68;6.3;31;24;7;77;3.8;15836;85
4372;Crazy/Beautiful;250224;5.8;97;61;36;62;5.6;29;17;12;58;3.1;9723;68
4373;Pootie Tang;258038;3.8;41;11;30;26;4.2;18;7;11;38;2.7;4226;56
4374;Snow Days;212517;5;17;9;8;52;5.5;7;4;3;57;3.2;238;55
4375;Drôle de Félix;228242;6.3;39;27;12;69;6.4;15;11;4;73;3.4;60;52
4376;Down from the Mountain;284067;7.5;31;30;1;96;7.9;11;11;0;100;3.5;336;75
4377;Les poupées russes;409184;6.6;47;34;13;72;6.8;17;11;6;64;3.6;8145;76
4378;Sexy Beast;203119;7.2;118;101;17;85;7.7;31;30;1;96;3.7;7958;83
4379;South of Heaven, West of Hell;179473;3.5;7;1;6;14;0;0;0;0;0;0;0;0
4380;Der Krieger und die Kaiserin;203632;\N;\N;\N;\N;\N;\N;\N;\N;\N;\N;\N;\N;\N
4381;Le placard;243493;7;79;68;11;86;6.7;24;18;6;75;3.7;2303;76
4382;Dances with Wolves;99348;7;46;35;11;76;6.9;10;7;3;70;3.6;28000;84
4383;Les rivières pourpres;228786;6;53;36;17;67;4.9;16;6;10;37;3.5;3727;70
4384;Lumumba;246765;7;55;46;9;83;7.2;23;20;3;86;3.9;339;81
4385;Pandaemonium;210217;5.7;26;15;11;57;4.9;7;3;4;42;3.7;260;70
4386;The Truth About Cats & Dogs;117979;6.7;36;30;6;83;7.6;6;5;1;83;2.9;6120;55
4387;Kiss of the Dragon;271027;5.3;103;53;50;51;5.2;27;13;14;48;3.3;12628;70
4388;Scary Movie 2;257106;3.3;106;15;91;14;3.2;29;2;27;6;3;85716;68
4389;Lost and Delirious;245238;5.4;58;29;29;50;5.6;22;11;11;50;3.8;3998;79
4390;Baise-moi;249380;4.2;56;12;44;21;3.7;19;1;18;5;2.7;2080;38
4391;Mua he chieu thang dung;224578;7.1;55;45;10;81;7;20;17;3;85;4;746;84
4393;Another Woman;94663;6.2;20;12;8;60;5.7;6;3;3;50;3.7;1472;75
4394;Beach Blanket Bingo;58953;5.4;7;5;2;71;0;0;0;0;0;0;0;0
4395;I soliti ignoti;52216;7.3;8;7;1;87;0;0;0;0;0;0;0;0
4396;The Cannonball Run;82136;4.2;29;9;20;31;0;3;0;3;0;3.1;6545;59
4397;Cannonball Run II;87032;2.4;9;1;8;11;0;1;0;1;0;2.7;2869;42
4398;Speed Zone!;98369;0;4;0;4;0;0;1;0;1;0;3;765;43
4399;Le journal d'une femme de chambre;58249;8;19;16;3;84;0;1;0;1;0;3.8;1018;82
4401;Donovan's Reef;57007;0;0;0;0;0;0;0;0;0;0;0;0;0
4402;Dr. Goldfoot and the Bikini Machine;59124;3.8;5;1;4;20;0;0;0;0;0;0;0;0
4403;House of Usher;53925;6.7;21;18;3;85;0;2;1;1;50;3.5;2068;69
4404;Faust: Love of the Damned;223268;0;3;1;2;33;0;0;0;0;0;0;0;0
4405;Der letzte Mann;15064;9;24;24;0;100;0;3;3;0;100;4.1;1020;90
4406;The Man Who Shot Liberty Valance;56217;8.6;34;33;1;97;0;2;2;0;100;4;5590;89
4407;Salvador (Puig Antich);445691;0;2;0;2;0;0;1;0;1;0;0;0;0
4408;11'09''01 - September 11;328802;6.6;58;45;13;77;6.6;21;16;5;76;3.5;303;62
4409;Shadows and Fog;105378;5.9;21;12;9;57;0;0;0;0;0;0;0;0
4410;Something Wild;91983;7;28;24;4;85;6.2;5;3;2;60;3.2;1139;58
4411;The Sons of Katie Elder;59740;6.6;11;11;0;100;0;0;0;0;0;0;0;0
4412;The Thing with Two Heads;69372;2.1;7;0;7;0;0;1;0;1;0;2.8;123;36
4413;Village of the Giants;59878;0;4;0;4;0;0;0;0;0;0;0;0;0
4414;X;57693;6.6;21;18;3;85;0;3;3;0;100;3.3;872;61
4415;Nice Dreams;82163;4.5;7;3;4;42;0;0;0;0;0;0;0;0
4416;The Day the Earth Caught Fire;54790;6.5;6;5;1;83;0;0;0;0;0;0;0;0
4417;Quella villa accanto al cimitero;82966;4.6;6;2;4;33;0;0;0;0;0;0;0;0
4418;Things Are Tough All Over;84788;0;1;1;0;100;0;0;0;0;0;0;0;0
4419;All That Heaven Allows;47811;7.6;26;24;2;92;0;3;1;2;33;0;0;0
4420;The Barefoot Contessa;46754;7.5;8;8;0;100;0;1;1;0;100;3.6;1121;70
4421;Blackout;822791;0;3;1;2;33;0;0;0;0;0;0;0;0
4422;Viskningar och rop;69467;8.2;27;24;3;88;8;5;4;1;80;4.3;3227;91
4423;The Entertainer;53796;7.8;8;7;1;87;0;0;0;0;0;0;0;0
4424;Il giardino dei Finzi Contini;65777;8.1;12;12;0;100;0;3;3;0;100;3.9;483;81
4425;Howling III;93227;3;10;2;8;20;0;0;0;0;0;0;0;0
4426;Kiss Me Deadly;48261;7.9;26;25;1;96;0;4;3;1;75;4;1672;85
4427;The Lion in Winter;63227;8;21;20;1;95;0;4;4;0;100;4.1;3596;88
4428;The Misfits;55184;7.8;13;13;0;100;0;0;0;0;0;0;0;0
4429;Moby Dick;120756;6.2;6;4;2;66;0;0;0;0;0;0;0;0
4430;Hot Popcorn: Movie Awards Greatest Moments;460824;\N;\N;\N;\N;\N;\N;\N;\N;\N;\N;\N;\N;\N
4431;Rembrandt;28167;0;4;3;1;75;0;0;0;0;0;0;0;0
4432;Sweet Smell of Success;51036;8.7;41;41;0;100;8.2;7;7;0;100;4.1;1652;91
4433;Written on the Wind;49966;7.4;21;17;4;80;0;1;1;0;100;3.8;927;76
4434;La decima vittima;59095;0;4;4;0;100;0;0;0;0;0;0;0;0
4435;Oberst Redl;89716;0;3;3;0;100;0;0;0;0;0;0;0;0
4436;Obsession;74991;6;14;11;3;78;0;1;1;0;100;3.3;664;58
4437;Suspiria;76786;7.9;30;28;2;93;0;3;3;0;100;3.9;7987;84
4438;Jing wu men;68767;0;0;0;0;0;0;0;0;0;0;0;0;0
4439;Christiane F. - Wir Kinder vom Bahnhof Zoo;82176;0;4;3;1;75;0;1;1;0;100;3.9;1584;83
4440;Tang shan da xiong;67824;5.6;10;6;4;60;0;0;0;0;0;0;0;0
4441;Game of Death;77594;6;8;6;2;75;0;0;0;0;0;0;0;0
4442;The Last Dragon;89461;0;4;0;4;0;0;1;0;1;0;3.9;4398;84
4443;Outland;82869;5.8;22;13;9;59;0;3;2;1;66;0;0;0
4444;Meng long guo jiang;68935;6.5;8;8;0;100;0;0;0;0;0;0;0;0
4445;T-Rex: Back to the Cretaceous;163862;6.1;19;13;6;68;6.5;7;5;2;71;2.8;304;34
4446;Final Fantasy: The Spirits Within;173840;5.2;141;61;80;43;4.8;28;9;19;32;3;17822;54
4447;Legally Blonde;250494;0;1;0;1;0;0;0;0;0;0;0;0;0
4448;The Score;227445;6.5;126;93;33;73;6.1;34;21;13;61;3.3;12417;64
4449;Adanggaman;262210;6.7;10;9;1;90;0;3;3;0;100;3.5;119;55
4450;Bully;242193;5.6;83;42;41;50;4.9;22;9;13;40;3.5;6131;70
4451;Jump Tomorrow;273300;6.6;54;44;10;81;6.9;19;17;2;89;4.1;302;88
4452;Made;227005;6.3;107;75;32;70;5.9;31;20;11;64;3.3;3264;66
4453;Michael Jordan to the Max;245280;6.2;25;16;9;64;4.7;8;1;7;12;3.8;753;78
4454;More;188913;0;0;0;0;0;0;0;0;0;0;0;0;0
4457;Bianca Beauchamp All Access 2: Rubberized;1275532;0;0;0;0;0;0;0;0;0;0;0;0;0
4458;Africa: The Serengeti;109049;8;5;5;0;100;0;0;0;0;0;0;0;0
4459;Alaska: Spirit of the Wild;130445;0;3;3;0;100;0;0;0;0;0;0;0;0
4461;Siegfried & Roy: The Magic Box;182299;6.5;14;10;4;71;0;4;3;1;75;3.2;48;40
4462;18 Again!;94593;4;7;2;5;28;0;1;0;1;0;2.8;1550;44
4463;Star Trek;60028;\N;\N;\N;\N;\N;\N;\N;\N;\N;\N;\N;\N;\N
4464;The Accidental Tourist;94606;7.1;26;21;5;80;0;2;1;1;50;3.2;1424;57
4465;The Accused;94608;7.1;19;18;1;94;0;1;1;0;100;3.5;3437;77
4466;Above the Law;94602;5.1;14;8;6;57;0;2;1;1;50;2.8;5280;52
4467;The Adventures of Baron Munchausen;96764;7.2;27;24;3;88;0;3;3;0;100;0;0;0
4468;Apartment Zero;94667;6.9;18;17;1;94;0;4;3;1;75;3.5;629;64
4469;Appointment with Death;94669;0;2;0;2;0;0;0;0;0;0;0;0;0
4470;The Little Mermaid: Ariel's Beginning;969647;0;4;2;2;50;0;0;0;0;0;0;0;0
4471;Arthur 2: On the Rocks;94678;3.3;13;2;11;15;0;1;0;1;0;2.5;865;33
4472;Bad Dreams;94701;3.3;8;1;7;12;0;1;0;1;0;3.1;374;46
4473;Bat*21;94712;6.1;10;8;2;80;0;2;1;1;50;3.1;1497;51
4474;The Beach;163978;4.4;116;22;94;18;3.9;31;4;27;12;2.9;21479;59
4475;The Beast of War;94716;0;1;1;0;100;0;0;0;0;0;0;0;0
4476;Big Business;19688;0;2;2;0;100;0;0;0;0;0;0;0;0
4477;Big Top Pee-wee;94744;4.6;19;6;13;31;0;1;0;1;0;2.5;2934;32
4478;Biloxi Blues;94746;6;18;13;5;72;0;1;0;1;0;3.1;2051;52
4479;The Birds;56869;8;40;38;2;95;0;4;2;2;50;3.5;17449;80
4480;The Blob;94761;5.6;16;9;7;56;0;0;0;0;0;0;0;0
4481;The Boost;94783;5.1;6;3;3;50;0;1;1;0;100;3.2;281;52
4482;Bright Lights, Big City;94799;5.5;18;11;7;61;5.6;5;3;2;60;2.8;1095;37
4483;Caddyshack II;94824;1.9;11;0;11;0;0;1;0;1;0;2.4;2756;26
4484;Camille Claudel;94828;8.3;8;8;0;100;0;1;1;0;100;3.9;1318;85
4485;Casual Sex?;94846;0;3;0;3;0;0;0;0;0;0;0;0;0
4486;Clean and Sober;94884;5.3;11;6;5;54;0;1;1;0;100;3.2;1014;60
4487;Cocktail;94889;3.7;21;3;18;14;0;2;0;2;0;3;13625;60
4488;Colors;94894;6.7;28;23;5;82;7.3;6;5;1;83;3.3;5019;66
4489;Coming to America;94898;5.7;36;23;13;63;2.5;5;0;5;0;3.4;32197;82
4490;The Couch Trip;94910;5.2;7;3;4;42;0;1;0;1;0;2.9;521;40
4491;Criminal Law;97125;4.6;8;3;5;37;0;1;0;1;0;3;410;35
4492;Critters;90887;5.2;14;8;6;57;0;1;1;0;100;2.7;6045;43
4493;Critters 2;94919;4.4;9;3;6;33;0;1;0;1;0;2.6;2866;38
4494;Critters 3;101627;2.8;6;0;6;0;0;0;0;0;0;0;0;0
4495;Crossing Delancey;94921;6.9;20;17;3;85;0;1;0;1;0;3.6;495;75
4496;DOA: Dead or Alive;398913;4.5;44;15;29;34;4.2;10;2;8;20;2.7;71044;43
4497;Dead Heat;94961;0;3;1;2;33;0;0;0;0;0;0;0;0
4498;The Dead Pool;94963;5.6;26;14;12;53;0;1;1;0;100;3.2;4365;49
4499;Dirty Rotten Scoundrels;95031;6.9;31;27;4;87;0;4;4;0;100;3.4;7136;78
4500;Drowning by Numbers;92929;7.1;11;10;1;90;0;1;0;1;0;4.2;1008;91
4501;Elvira, Mistress of the Dark;95088;4.3;9;3;6;33;0;0;0;0;0;0;0;0
4502;Ernest Saves Christmas;95107;4.7;13;5;8;38;0;0;0;0;0;0;0;0
4503;Everybody's All-American;95119;4.8;10;3;7;30;0;1;0;1;0;3.1;505;45
4504;Feds;95145;4.3;5;1;4;20;0;1;1;0;100;3;269;50
4505;For Keeps?;95169;4.3;9;2;7;22;0;1;1;0;100;3.4;2404;64
4506;Frantic;95174;6.4;39;30;9;76;5.6;5;3;2;60;3.2;4749;56
4507;Fresh Horses;95178;3.6;6;0;6;0;0;0;0;0;0;0;0;0
4508;Gorillas in the Mist: The Story of Dian Fossey;95243;6.8;17;14;3;82;0;2;2;0;100;3.3;3826;72
4509;The Great Outdoors;95253;4.2;13;5;8;38;0;0;0;0;0;0;0;0
4510;Heartbreak Hotel;785002;0;1;1;0;100;0;0;0;0;0;0;0;0
4511;High Spirits;95304;3.4;11;2;9;18;0;0;0;0;0;0;0;0
4512;Hot to Trot;95326;2.3;6;0;6;0;0;0;0;0;0;0;0;0
4513;The House on Carroll Street;95333;5.6;6;4;2;66;0;1;1;0;100;2.9;262;21
4514;Howling IV: The Original Nightmare;95334;0;0;0;0;0;0;0;0;0;0;0;0;0
4515;Imagine: John Lennon;95360;7.4;13;12;1;92;0;1;1;0;100;4;1149;88
4516;Johnny Be Good;95409;2.3;11;0;11;0;0;3;0;3;0;2.6;1294;27
4517;Lady in White;95484;6.2;11;8;3;72;0;1;1;0;100;3.5;1031;70
4518;The Lair of the White Worm;95488;5.5;21;12;9;57;0;1;0;1;0;2.9;1348;43
4519;The Land Before Time;95489;5.9;14;10;4;71;0;1;1;0;100;3.3;18763;69
4520;License to Drive;95519;3.2;17;3;14;17;0;3;0;3;0;3;3880;61
4521;Little Nikita;95532;5.7;7;6;1;85;0;1;0;1;0;3.1;1024;47
4522;Masquerade;95599;5.1;14;6;8;42;0;1;1;0;100;3.1;407;41
4523;The Milagro Beanfield War;95638;5.9;27;16;11;59;5.9;6;3;3;50;3.6;855;72
4524;Moon Over Parador;95654;4.8;12;5;7;41;0;1;0;1;0;2.9;529;39
4525;Moving;95662;0;3;1;2;33;0;0;0;0;0;0;0;0
4526;My Stepmother Is an Alien;95687;3.6;15;2;13;13;0;1;0;1;0;2.5;3796;32
4527;A Night in the Life of Jimmy Reardon;95736;4.8;5;2;3;40;0;0;0;0;0;0;0;0
4528;Off Limits;95774;4.9;8;4;4;50;0;1;0;1;0;3;458;31
4529;Out of Rosenheim;95801;6.7;16;14;2;87;0;2;1;1;50;4;2378;88
4530;Permanent Record;95853;6.7;8;6;2;75;0;1;1;0;100;3.4;779;65
4531;Red Heat;95963;5.3;15;8;7;53;0;1;1;0;100;2.7;4602;38
4532;Return of the Living Dead Part II;95990;3.3;13;0;13;0;0;1;0;1;0;2.9;4031;47
4533;The Return of the Living Dead;89907;7;26;23;3;88;0;1;1;0;100;3.3;10213;71
4534;The Man from Snowy River II;95993;0;1;0;1;0;0;0;0;0;0;0;0;0
4535;The Man from Snowy River;84296;6.5;10;8;2;80;0;1;0;1;0;3.7;3791;85
4536;Rocket Gibraltar;96003;0;2;1;1;50;0;0;0;0;0;0;0;0
4537;Running on Empty;96018;6.9;11;9;2;81;0;2;1;1;50;3.8;1817;84
4538;Salome's Last Dance;96029;5.8;6;3;3;50;0;1;0;1;0;3.9;233;81
4539;Salsa;229694;0;0;0;0;0;0;0;0;0;0;0;0;0
4540;Satisfaction;1129029;\N;\N;\N;\N;\N;\N;\N;\N;\N;\N;\N;\N;\N
4541;The Serpent and the Rainbow;96071;0;0;0;0;0;0;0;0;0;0;0;0;0
4542;Shakedown;96087;0;1;1;0;100;0;1;1;0;100;2.9;382;32
4543;Shoot to Kill;96098;7.1;11;11;0;100;0;1;1;0;100;3.2;950;57
4544;Short Circuit;91949;4.8;20;10;10;50;0;1;0;1;0;3.2;12589;66
4545;Short Circuit;91949;4.8;20;10;10;50;0;1;0;1;0;3.2;12589;66
4546;Spoorloos;96163;8.4;33;33;0;100;0;4;4;0;100;4;2421;87
4547;Stormy Monday;96180;6.6;9;8;1;88;0;1;1;0;100;3.1;420;41
4548;Before Sunset;381681;8.3;158;150;8;94;8.4;39;38;1;97;4;20750;90
4549;Sweet Hearts Dance;96200;5.5;10;5;5;50;0;1;0;1;0;3.2;431;45
4550;Switching Channels;96203;5.3;9;5;4;55;0;1;1;0;100;2.9;314;31
4551;The Telephone;96241;0;0;0;0;0;0;0;0;0;0;0;0;0
4552;Tetsuo;96251;7.2;12;9;3;75;0;0;0;0;0;0;0;0
4553;They Live;96256;7;33;29;4;87;0;4;2;2;50;3.5;7637;77
4554;To Kill a Priest;96280;0;4;3;1;75;0;1;0;1;0;3.5;191;68
4555;Torch Song Trilogy;96289;6.1;13;7;6;53;0;2;2;0;100;4;1240;89
4556;Track 29;96294;6.4;6;4;2;66;0;2;1;1;50;3.2;444;49
4557;Tucker: The Man and His Dream;96316;7.2;35;30;5;85;6.8;7;5;2;71;3.2;1497;58
4558;Twins;96320;4.7;27;9;18;33;0;4;3;1;75;2.7;10066;41
4559;Vice Versa;96380;5;13;6;7;46;0;1;1;0;100;2.8;1418;40
4560;The Watcher;204626;3.4;87;9;78;10;3.3;25;2;23;8;2.7;3820;36
4561;Waxwork;96426;4.7;9;5;4;55;0;0;0;0;0;0;0;0
4562;Without a Clue;96454;5.2;9;5;4;55;0;1;0;1;0;3.4;1126;68
4563;Young Einstein;96486;3;17;3;14;17;0;1;0;1;0;2.6;1565;44
4564;The First $20 Million Is Always the Hardest;280674;2.4;9;1;8;11;0;2;0;2;0;3.2;483;50
4565;American Ninja;88708;2.6;5;0;5;0;0;0;0;0;0;0;0;0
4566;American Ninja 2: The Confrontation;92548;0;0;0;0;0;0;0;0;0;0;0;0;0
4567;American Ninja 3: Blood Hunt;96804;0;0;0;0;0;0;0;0;0;0;0;0;0
4568;Best of the Best;96913;0;4;2;2;50;0;1;0;1;0;3.2;4991;62
4569;Best of the Best 2;106393;3;9;1;8;11;0;1;0;1;0;2.9;1415;46
4570;Movie Critters' Big Picture;382186;\N;\N;\N;\N;\N;\N;\N;\N;\N;\N;\N;\N;\N
4571;Bill & Ted's Excellent Adventure;96928;6.3;32;26;6;81;0;3;1;2;33;3.3;30577;70
4572;Black Rain;96933;5.4;21;12;9;57;0;1;0;1;0;0;0;0
4573;Blaze;96943;6.3;10;8;2;80;0;1;1;0;100;2.9;402;40
4574;Blind Fury;96945;4.8;10;6;4;60;0;1;0;1;0;3.1;1813;52
4575;The Hunting Party;455782;6;89;47;42;52;5.8;26;12;14;46;3.4;13820;67
4576;C.H.U.D. II - Bud the Chud;97001;0;0;0;0;0;0;0;0;0;0;0;0;0
4577;Casualties of War;97027;7.2;30;25;5;83;0;2;1;1;50;3.4;4154;70
4578;Chances Are;97044;5.6;25;15;10;60;4.6;6;2;4;33;3.4;2184;66
4579;Cookie's Fortune;126250;7.5;55;47;8;85;7.4;12;11;1;91;3.2;1364;57
4580;Cyborg;97138;2.9;14;2;12;14;0;3;0;3;0;2.5;3775;35
4581;Getting Even with Dad;109891;3.3;12;1;11;8;0;3;0;3;0;2.4;2200;29
4582;Dead Bang;97166;4.4;10;3;7;30;0;0;0;0;0;0;0;0
4583;Disorganized Crime;97211;5.3;6;3;3;50;0;0;0;0;0;0;0;0
4584;Dream a Little Dream;97236;3;9;0;9;0;0;3;0;3;0;3.3;2148;67
4585;The Dream Team;97235;5.2;13;7;6;53;0;1;0;1;0;3.1;1533;60
4586;A Dry White Season;97243;6.4;11;10;1;90;0;1;1;0;100;0;0;0
4587;Earth Girls Are Easy;97257;5.5;32;20;12;62;6.8;7;6;1;85;2.6;5342;40
4588;Eddie and the Cruisers II: Eddie Lives!;97262;0;0;0;0;0;0;0;0;0;0;0;0;0
4589;Eddie and the Cruisers;85475;5.6;8;3;5;37;0;1;0;1;0;3.5;2405;71
4590;Enemies: A Love Story;97276;6.8;11;10;1;90;0;1;1;0;100;3.2;346;51
4591;Erik the Viking;97289;4;10;3;7;30;0;1;0;1;0;3.2;1894;59
4592;The Experts;97314;0;0;0;0;0;0;0;0;0;0;0;0;0
4593;Family Business;97328;5.1;15;6;9;40;0;1;1;0;100;2.8;1601;28
4594;Farewell to the King;97334;5.5;11;6;5;54;0;1;1;0;100;3.2;415;53
4595;Fat Man and Little Boy;97336;5.2;17;9;8;52;0;3;1;2;33;3.1;908;44
4596;The Girl in a Swing;97435;0;3;1;2;33;0;1;0;1;0;2.4;61;25
4597;Gleaming the Cube;97438;4.2;8;2;6;25;0;0;0;0;0;0;0;0
4598;Going Overboard;96870;0;3;0;3;0;0;0;0;0;0;0;0;0
4599;Great Balls of Fire!;97457;5.8;24;15;9;62;0;2;0;2;0;3;3034;52
4600;Gross Anatomy;97458;4.6;10;3;7;30;0;1;1;0;100;2.9;620;43
4601;Chun gwong cha sit;118845;7.1;31;24;7;77;7.1;9;7;2;77;4.1;4907;90
4602;Harlem Nights;97481;3.8;14;3;11;21;0;3;0;3;0;3.3;5383;78
4603;Her Alibi;97500;3.8;13;2;11;15;0;1;0;1;0;2.7;795;37
4604;Homer and Eddie;97521;2.3;7;0;7;0;0;0;0;0;0;0;0;0
4605;How to Get Ahead in Advertising;97531;6.3;14;8;6;57;0;1;0;1;0;3.7;1015;78
4606;Immediate Family;97567;5;10;6;4;60;0;1;0;1;0;3.4;323;59
4607;North Country;395972;6.7;166;114;52;68;6.8;38;26;12;68;3.5;14739;72
4608;An Innocent Man;97579;4.8;7;2;5;28;0;1;0;1;0;2.9;1267;42
4609;Jacknife;97607;6;13;9;4;69;0;1;1;0;100;3.2;827;45
4610;The January Man;97613;3.8;14;3;11;21;0;1;0;1;0;2.8;957;31
4611;Johnny Handsome;97626;6.2;13;8;5;61;0;1;1;0;100;3;857;42
4612;Jésus de Montréal;97635;7.4;13;11;2;84;0;2;1;1;50;3.9;1256;85
4613;K-9;97637;4.1;8;2;6;25;0;1;0;1;0;2.7;4457;46
4614;Kickboxer;97659;0;4;2;2;50;0;0;0;0;0;0;0;0
4615;Last Exit to Brooklyn;97714;6.6;13;10;3;76;0;2;1;1;50;3.6;623;73
4616;Lean on Me;97722;5.8;14;9;5;64;0;1;0;1;0;3.7;5235;86
4617;Let It Ride;97731;5;10;3;7;30;0;0;0;0;0;0;0;0
4618;Leviathan;97737;4;19;2;17;10;0;2;0;2;0;2.7;1532;31
4619;Little Monsters;97758;0;3;1;2;33;0;0;0;0;0;0;0;0
4620;Lock Up;97770;4.3;10;2;8;20;0;0;0;0;0;0;0;0
4621;Look Who's Talking;97778;5;33;19;14;57;3.9;7;2;5;28;2.9;13369;53
4622;Loverboy;388213;4.1;34;6;28;17;4.6;12;3;9;25;2.7;12704;32
4623;Major League;97815;6.6;31;26;5;83;0;4;2;2;50;3.3;13020;78
4624;Meet the Feebles;97858;6.6;20;15;5;75;0;1;0;1;0;3.5;3519;71
4625;Millennium;115270;\N;\N;\N;\N;\N;\N;\N;\N;\N;\N;\N;\N;\N
4626;Miracle Mile;97889;6.7;21;18;3;85;0;1;1;0;100;3.5;1088;70
4627;Miss Firecracker;97892;6;9;6;3;66;0;1;1;0;100;3.2;403;49
4628;New York Stories;97965;6.1;23;17;6;73;6.4;5;3;2;60;3.4;3295;57
4629;Next of Kin;97967;4.6;7;3;4;42;0;0;0;0;0;0;0;0
4630;No Holds Barred;97987;1.7;8;0;8;0;0;0;0;0;0;0;0;0
4631;Old Gringo;98022;5.1;11;5;6;45;0;1;0;1;0;3.1;298;42
4632;The Package;98051;5.3;14;9;5;64;0;2;2;0;100;3.2;849;45
4633;Meet the Parents;212338;6.9;140;118;22;84;7.1;35;29;6;82;3.6;119331;79
4634;Penn & Teller Get Killed;98073;4.6;7;1;6;14;0;0;0;0;0;0;0;0
4635;Pink Cadillac;98097;3.9;18;3;15;16;4.4;5;2;3;40;2.8;2125;30
4636;Punisher: War Zone;450314;4.2;96;25;71;26;3.7;21;1;20;4;3;29393;47
4637;Red Scorpion;98180;3.3;9;1;8;11;0;3;0;3;0;0;0;0
4638;Jurassic Park III;163025;5.2;153;75;78;49;4.1;31;9;22;29;3;38571;47
4639;America's Sweethearts;265029;4.6;142;45;97;31;4;37;7;30;18;2.8;17330;43
4640;O Brother, Where Art Thou?;190590;7.1;143;109;34;76;6.6;35;24;11;68;3.7;35122;87
4641;Ghost World;162346;7.8;148;136;12;91;8;33;32;1;96;3.6;20727;81
4642;Hedwig and the Angry Inch;248845;7.8;103;95;8;92;7.7;30;27;3;90;4.1;11932;91
4643;Planet of the Apes;63442;7.4;44;39;5;88;5.5;5;3;2;60;3.4;12844;80
4644;Pane e tulipani;237539;6.3;62;44;18;70;6.3;22;17;5;77;3.9;1393;85
4645;The Cure;112757;5.5;10;4;6;40;0;4;1;3;25;3.7;2207;79
4646;Greenfingers;203540;5.2;67;31;36;46;4.6;25;9;16;36;3.5;1333;68
4649;Wet Hot American Summer;243655;4.3;63;19;44;30;3.7;20;3;17;15;3.7;7016;85
4650;Relentless;98184;0;4;1;3;25;0;0;0;0;0;0;0;0
4651;Blueberry;276830;4.2;7;2;5;28;0;0;0;0;0;0;0;0
4652;The Return of Swamp Thing;98193;0;4;2;2;50;0;0;0;0;0;0;0;0
4653;The Return of the Musketeers;98194;5.6;5;3;2;60;0;0;0;0;0;0;0;0
4654;Road House;98206;5.2;27;12;15;44;3.6;5;0;5;0;3.2;10370;68
4655;Romero;98219;7.3;8;6;2;75;0;1;0;1;0;3.8;512;79
4656;Rosalie Goes Shopping;98224;6.1;7;5;2;71;0;2;1;1;50;3.6;136;64
4657;Rude Awakening;165057;\N;\N;\N;\N;\N;\N;\N;\N;\N;\N;\N;\N;\N
4658;Santa sangre;98253;6.8;18;14;4;77;6.6;5;4;1;80;4.1;2145;88
4659;Notes on a Scandal;465551;7.5;167;145;22;86;8;36;33;3;91;3.7;22200;81
4660;Scenes from the Class Struggle in Beverly Hills;98261;5.8;5;4;1;80;0;1;0;1;0;3;268;38
4661;Sea of Love;98273;7;19;16;3;84;0;1;1;0;100;3.3;3334;62
4662;See No Evil, Hear No Evil;98282;3.4;11;2;9;18;0;1;0;1;0;3.3;6015;72
4663;She's Out of Control;98308;3;16;1;15;6;0;4;0;4;0;2.8;915;46
4664;Shirley Valentine;98319;6.3;11;8;3;72;0;2;0;2;0;3.8;1235;85
4665;Shocker;98320;3.4;12;1;11;8;0;0;0;0;0;0;0;0
4666;Skin Deep;98343;4.8;12;5;7;41;0;1;1;0;100;3;517;49
4667;Slaves of New York;98347;2.9;8;1;7;12;0;1;0;1;0;3.2;287;58
4668;Some Girls;98356;0;1;0;1;0;0;0;0;0;0;0;0;0
4669;Stepfather II;98385;\N;\N;\N;\N;\N;\N;\N;\N;\N;\N;\N;\N;\N
4670;The Stepfather;94035;6.5;26;22;4;84;6.6;5;3;2;60;3.4;1144;64
4671;Sweetie;98725;7.1;12;11;1;91;0;1;1;0;100;3.6;538;72
4672;The Tall Guy;98436;6.7;12;10;2;83;0;2;2;0;100;3.1;901;55
4673;Tango & Cash;98439;4.3;33;13;20;39;0;3;0;3;0;3;9072;54
4674;This Is Spinal Tap;88258;8.6;53;51;2;96;7.7;7;6;1;85;3.9;23608;91
4675;Three Fugitives;98471;3.9;13;2;11;15;0;0;0;0;0;0;0;0
4676;Troop Beverly Hills;98519;3.2;12;1;11;8;0;2;0;2;0;2.6;2799;53
4677;Turner & Hooch;98536;5.2;21;13;8;61;0;0;0;0;0;0;0;0
4678;UHF;98546;5.5;22;12;10;54;0;1;0;1;0;3.2;7472;73
4679;Uncle Buck;98554;5.8;17;9;8;52;0;1;0;1;0;3.2;13669;72
4680;Vampire's Kiss;98577;5.9;21;13;8;61;3.8;5;1;4;20;2.9;2172;48
4681;The War of the Roses;98621;7;37;30;7;81;5.8;8;5;3;62;3.2;5702;64
4682;Warlock;98622;5.3;15;8;7;53;0;1;0;1;0;3.1;2153;53
4683;The Wizard;98663;4.3;17;4;13;23;0;3;0;3;0;3.1;3783;60
4684;Worth Winning;98678;0;4;0;4;0;0;0;0;0;0;0;0;0
4685;Warlock: The Armageddon;108517;0;4;0;4;0;0;0;0;0;0;0;0;0
4686;Weekend at Bernie's II;108539;2.5;28;3;25;10;3.7;5;2;3;40;0;0;0
4687;Billy Liar;56868;7.6;9;9;0;100;0;1;1;0;100;4;754;82
4688;Black Robe;101465;7;12;11;1;91;0;1;0;1;0;3.3;1641;60
4689;Il gatto a nove code;65761;6.4;12;10;2;83;0;0;0;0;0;0;0;0
4690;The Cotton Club;87089;6.3;23;17;6;73;0;3;2;1;66;3.2;1978;53
4691;Def-Con 4;87130;0;0;0;0;0;0;0;0;0;0;0;0;0
4692;The Hotel New Hampshire;87428;6.1;13;9;4;69;0;0;0;0;0;0;0;0
4693;Idiot Box;116604;0;3;1;2;33;0;0;0;0;0;0;0;0
4694;Left Luggage;119512;5;11;4;7;36;0;3;1;2;33;4.1;417;89
4695;Who'll Stop the Rain;78490;6.8;7;5;2;71;0;0;0;0;0;0;0;0
4696;Zorro, the Gay Blade;83366;4.8;14;6;8;42;0;1;0;1;0;3.2;1667;60
4697;Basket Case;83624;6.3;16;12;4;75;0;0;0;0;0;0;0;0
4698;Orphans;119842;\N;\N;\N;\N;\N;\N;\N;\N;\N;\N;\N;\N;\N
4699;Original Sin;218922;3.4;90;11;79;12;3.1;29;2;27;6;3.2;10609;67
4700;The Princess Diaries;247638;5.1;110;51;59;46;5.2;28;13;15;46;3.2;83951;71
4701;Rush Hour 2;266915;5.4;125;64;61;51;5.1;33;17;16;51;3.3;64114;77
4702;Thomas est amoureux;262826;\N;\N;\N;\N;\N;\N;\N;\N;\N;\N;\N;\N;\N
4703;Chocolat;241303;6;114;71;43;62;6.1;32;20;12;62;3.6;62492;82
4704;Hatari!;56059;6.6;22;15;7;68;0;4;3;1;75;3.7;1953;75
4705;La cage aux folles;77288;8;15;15;0;100;0;1;1;0;100;3.7;1639;79
4706;La cage aux folles II;80489;0;4;2;2;50;0;0;0;0;0;0;0;0
4707;Liebestraum;102299;5.6;10;4;6;40;0;2;1;1;50;3.1;260;41
4708;Marat/Sade;60668;\N;\N;\N;\N;\N;\N;\N;\N;\N;\N;\N;\N;\N
4709;Paint Your Wagon;64782;4.7;13;3;10;23;0;1;0;1;0;3.4;1851;66
4710;The Shootist;75213;7.9;14;13;1;92;0;1;1;0;100;3.9;2835;84
4711;Theremin: An Electronic Odyssey;108323;7.6;15;15;0;100;0;3;3;0;100;3.5;288;64
4712;L'enfant sauvage;64285;8.4;25;25;0;100;8.5;9;9;0;100;3.7;996;78
4713;Altered States;80360;6.9;33;29;4;87;0;4;4;0;100;3.4;4339;66
4714;Any Which Way You Can;80377;4.9;10;2;8;20;0;1;0;1;0;3.1;3457;50
4715;A Crude Awakening: The Oil Crash;776794;6.5;14;11;3;78;0;1;0;1;0;4;969;85
4716;Bad Timing;80408;6.9;5;3;2;60;0;1;0;1;0;3.7;926;79
4717;The Big Brawl;80436;5.1;6;4;2;66;0;0;0;0;0;0;0;0
4718;American Pie;163651;5.7;115;67;48;58;5.5;25;13;12;52;3.4;203348;63
4719;Osmosis Jones;181739;5.5;106;57;49;53;5.5;29;16;13;55;2.8;7220;40
4720;The Others;230600;7.2;146;122;24;83;6.4;33;21;12;63;3.3;47632;75
4721;American Outlaws;244000;3.6;100;13;87;13;3;28;2;26;7;3.2;5353;69
4722;All Over the Guy;250202;4.9;47;20;27;42;4.8;17;7;10;41;3.5;1303;67
4723;The Deep End;250323;7.1;114;93;21;81;7.6;29;26;3;89;3.3;1107;58
4724;On the Edge;221559;\N;\N;\N;\N;\N;\N;\N;\N;\N;\N;\N;\N;\N
4725;Session 9;261983;6.2;63;38;25;60;4.7;17;6;11;35;3.4;5642;69
4726;The Turandot Project;262076;6.9;30;23;7;76;6.7;9;7;2;77;3.3;205;49
4727;Captain Corelli's Mandolin;238112;4.4;113;33;80;29;3.9;34;8;26;23;2.9;7435;51
4728;Rat Race;250687;4.9;124;53;71;42;4.2;28;8;20;28;3.1;23720;63
4729;Aberdeen;168446;7;38;33;5;86;8;12;12;0;100;3.7;511;77
4731;Innocence;375233;6.7;17;11;6;64;6.9;8;6;2;75;3.7;1170;73
4732;Bubble Boy;258470;3.8;81;24;57;29;3.8;19;5;14;26;2.8;14041;52
4733;The Curse of the Jade Scorpion;256524;5.2;122;55;67;45;5;36;14;22;38;3.1;4108;52
4734;Jay and Silent Bob Strike Back;261392;5.6;148;78;70;52;5.3;31;14;17;45;3.4;44787;77
4735;Ghosts of Mars;228333;3.6;100;19;81;19;3.4;22;4;18;18;2.4;6302;29
4736;Summer Catch;234829;3.1;82;6;76;7;3;27;2;25;7;2.6;6249;44
4737;An American Rhapsody;221799;0;0;0;0;0;0;0;0;0;0;0;0;0
4738;Happy Accidents;208196;6.3;60;43;17;71;6.5;19;13;6;68;3.7;1489;77
4739;Famous;233699;5.4;41;18;23;43;5.5;13;7;6;53;3.1;356;40
4740;Maybe Baby;206926;5.1;28;13;15;46;3.8;8;2;6;25;3.1;1495;50
4741;Tillsammans;203166;7.2;79;71;8;89;7.6;26;25;1;96;4;2485;87
4743;Tortilla Soup;255653;6.3;62;45;17;72;6;23;15;8;65;3.5;996;73
4744;Jeepers Creepers;263488;5.1;107;48;59;44;4.8;26;10;16;38;2.9;22835;56
4745;O;184791;6;123;78;45;63;5.2;31;16;15;51;3;4986;58
4746;Waking Up in Reno;219400;3.6;37;5;32;13;3.8;9;2;7;22;2.9;1272;36
4747;Speedway Junky;155197;4.4;6;2;4;33;0;3;1;2;33;3.2;549;52
4748;3 Ninjas;103596;3.4;5;0;5;0;0;0;0;0;0;0;0;0
4749;3 Ninjas Kick Back;109015;2.8;6;1;5;16;0;3;1;2;33;2.6;6654;39
4750;3 Ninjas Knuckle Up;112255;0;3;0;3;0;0;0;0;0;0;0;0;0
4751;The Hunter;80907;4.8;9;4;5;44;0;1;0;1;0;3.2;898;53
4752;Maniac;81114;4.9;11;5;6;45;0;0;0;0;0;0;0;0
4753;Interview with the Vampire: The Vampire Chronicles;110148;5.8;45;26;19;57;4.6;10;4;6;40;3.7;77706;85
4754;The Wicker Man;70917;7.7;45;41;4;91;0;4;4;0;100;3.6;8988;79
4755;Wish Upon a Star;118178;0;3;1;2;33;0;0;0;0;0;0;0;0
4756;The Three Musketeers;72281;7.1;11;9;2;81;0;0;0;0;0;0;0;0
4757;Rock Star;202470;0;0;0;0;0;0;0;0;0;0;0;0;0
4758;Soul Survivors;218619;2.6;47;2;45;4;2.3;11;0;11;0;2.6;2441;34
4759;Two Can Play That Game;269341;4.9;63;27;36;42;4.8;23;9;14;39;3.6;5802;82
4760;Bounce: Behind the Velvet Rope;238066;5.2;10;4;6;40;0;4;2;2;50;2.9;339;36
4761;Diamond Men;200427;7;62;50;12;80;7.1;20;17;3;85;3.2;367;49
4763;Satree lek;263957;5.2;33;18;15;54;5.4;12;7;5;58;3.6;603;71
4764;Kill Me Later;243595;4.2;20;5;15;25;5.4;6;3;3;50;3.6;530;68
4765;L.I.E.;242587;7;82;68;14;82;7.1;24;21;3;87;3.7;1868;77
4766;La virgen de los sicarios;250809;6.6;61;47;14;77;6.8;22;16;6;72;3.3;450;59
4767;Abbott and Costello Meet the Mummy;47795;4.9;9;3;6;33;0;0;0;0;0;0;0;0
4768;Dr. Mabuse, der Spieler - Ein Bild der Zeit;13086;7.4;11;10;1;90;0;1;0;1;0;4.1;721;90
4769;Into the Arms of Strangers: Stories of the Kindertransport;248912;7.7;34;32;2;94;7.4;11;10;1;90;3.8;433;82
4770;The Glass House;221218;4.2;84;18;66;21;4;20;4;16;20;2.8;7214;48
4771;Hard Ball;180734;\N;\N;\N;\N;\N;\N;\N;\N;\N;\N;\N;\N;\N
4772;Dinner Rush;229340;7.1;44;40;4;90;7.7;13;13;0;100;3.8;853;80
4773;Haiku Tunnel;273253;5.6;47;28;19;59;5.2;20;11;9;55;3.4;353;73
4774;Big Trouble;246464;5.4;110;53;57;48;4.8;31;9;22;29;2.9;3336;52
4775;Glitter;118589;2.8;85;6;79;7;2.7;27;1;26;3;2.1;7598;46
4776;Training Day;139654;6.5;151;108;43;71;6.3;34;24;10;70;3.6;50545;85
4777;The American Astronaut;243759;0;0;0;0;0;0;0;0;0;0;0;0;0
4778;Children Underground;264476;7.5;17;16;1;94;7.6;7;7;0;100;4.2;389;89
4779;Go Tigers!;270971;7.1;39;33;6;84;7.1;14;13;1;92;3.3;227;63
4780;Taken;936501;5.8;160;92;68;57;5.2;33;14;19;42;4;307912;83
4781;Megiddo: The Omega Code 2;263728;3.1;19;2;17;10;2.5;7;0;7;0;3.1;612;51
4782;Sidewalks of New York;239986;5.5;91;51;40;56;5.4;24;12;12;50;3.1;1120;50
4783;The Endurance: Shackleton's Legendary Antarctic Expedition;264578;7.7;65;62;3;95;7.9;24;24;0;100;3.8;415;79
4784;The French Lieutenant's Woman;82416;7.1;15;11;4;73;0;1;1;0;100;3.5;1859;67
4785;Il grande silenzio;63032;\N;\N;\N;\N;\N;\N;\N;\N;\N;\N;\N;\N;\N
4786;The Legend of Hell House;70294;5.7;13;6;7;46;0;1;0;1;0;3.3;1221;61
4787;Little Man Tate;102316;6.2;23;18;5;78;0;2;1;1;50;3.2;2824;62
4788;Moskva slezam ne verit;79579;0;3;1;2;33;0;0;0;0;0;0;0;0
4789;Phantom of the Paradise;71994;7.6;15;14;1;93;0;3;2;1;66;3.9;3007;81
4790;The Return of a Man Called Horse;75132;5.7;7;5;2;71;0;1;0;1;0;3.2;576;54
4791;Valdez Is Coming;67921;0;1;1;0;100;0;0;0;0;0;0;0;0
4792;Thir13en Ghosts;245674;3.4;89;11;78;12;3.4;22;3;19;13;3;20700;60
4793;Montenegro;82770;7;12;11;1;91;0;3;2;1;66;3.6;259;71
4794;The Phantom of the Opera;16220;7.9;33;29;4;87;5.8;7;4;3;57;3.7;6169;77
4795;Father Goose;58092;6.3;12;9;3;75;0;0;0;0;0;0;0;0
4796;The Grass Is Greener;53877;6.6;7;7;0;100;0;0;0;0;0;0;0;0
4797;A Hole in the Head;52896;6.2;5;4;1;80;0;0;0;0;0;0;0;0
4798;Indiscreet;51773;7.2;8;8;0;100;0;0;0;0;0;0;0;0
4799;It's a Mad Mad Mad Mad World;57193;6.7;26;20;6;76;0;3;2;1;66;3.6;5290;79
4800;King Solomon's Mines;42646;7.4;11;10;1;90;0;0;0;0;0;0;0;0
4801;The Little Foxes;33836;8.5;14;14;0;100;0;0;0;0;0;0;0;0
4802;Operation Petticoat;53143;6.6;11;9;2;81;0;0;0;0;0;0;0;0
4803;Play Misty for Me;67588;7.3;30;25;5;83;7.3;5;4;1;80;3.5;2914;70
4804;Pocketful of Miracles;55312;5.8;8;5;3;62;0;0;0;0;0;0;0;0
4805;Sayonara;50933;7.2;9;9;0;100;0;0;0;0;0;0;0;0
4806;Obchod na korze;59527;8.9;12;12;0;100;0;0;0;0;0;0;0;0
4807;The Hunting Party;455782;6;89;47;42;52;5.8;26;12;14;46;3.4;13820;67
4808;The Vanishing;108473;4.8;33;15;18;45;4;6;1;5;16;3.1;3338;51
4809;Silkwood;86312;7;22;16;6;72;0;3;1;2;33;3.7;2741;78
4810;I Never Promised You a Rose Garden;76172;0;3;2;1;66;0;1;1;0;100;3.3;304;50
4811;Quadrophenia;79766;7.2;5;5;0;100;0;0;0;0;0;0;0;0
4812;SpaceCamp;91993;4.8;10;4;6;40;0;1;0;1;0;2.9;2441;46
4813;When Worlds Collide;44207;5.9;19;15;4;78;0;3;2;1;66;3.4;786;64
4814;Don't Say a Word;260866;4.4;112;26;86;23;4.6;30;10;20;33;3;6502;55
4815;Hearts in Atlantis;252501;5.7;133;65;68;48;5.3;30;13;17;43;3.3;4981;64
4816;Zoolander;196229;5.9;127;79;48;62;6.1;29;18;11;62;3.3;107651;78
4817;Born Romantic;236034;5.5;31;18;13;58;5.3;9;5;4;55;3.3;588;56
4818;Extreme Days;245891;4.4;7;3;4;42;0;1;1;0;100;3.9;1488;85
4819;Go Figure;447987;0;0;0;0;0;0;0;0;0;0;0;0;0
4820;Won't Anybody Listen;281376;0;3;2;1;66;0;1;1;0;100;0;0;0
4821;Joy Ride;206314;6.6;111;82;29;73;6.7;29;23;6;79;3.1;9370;63
4822;Max Keeble's Big Move;273799;4.2;54;14;40;25;4;18;4;14;22;2.7;2400;42
4823;Serendipity;240890;5.7;128;74;54;57;5.8;31;19;12;61;3.4;43975;79
4824;Grateful Dawg;265212;6.2;43;30;13;69;6.8;19;15;4;78;3.6;223;69
4825;La ciénaga;240419;6.9;36;31;5;86;6.6;13;11;2;84;3.8;474;80
4826;The Big Red One;80437;7.7;44;40;4;90;7.3;13;11;2;84;3.6;2424;74
4827;Boogeyman;357507;3.4;85;11;74;12;3.2;11;0;11;0;2.5;13866;38
4828;La boum;82100;\N;\N;\N;\N;\N;\N;\N;\N;\N;\N;\N;\N;\N
4829;Lady in a Cage;58283;4.3;5;1;4;20;0;0;0;0;0;0;0;0
4830;Brubaker;80474;6.9;18;15;3;83;0;1;0;1;0;3.5;1436;73
4831;Can't Stop the Music;80492;2.3;13;1;12;7;0;2;0;2;0;2.7;850;38
4832;Carny;80500;0;4;3;1;75;0;1;0;1;0;3.3;264;53
4833;Changeling;824747;6.3;190;117;73;61;5.6;39;17;22;43;3.8;63438;84
4834;Cheech & Chong's Next Movie;80520;0;1;1;0;100;0;0;0;0;0;0;0;0
4835;Coal Miner's Daughter;80549;8.1;10;10;0;100;0;1;1;0;100;3.6;6330;80
4836;The Competition;80556;6.6;5;4;1;80;0;1;1;0;100;3.5;116;56
4837;Cruising;80569;5.3;27;16;11;59;0;3;3;0;100;3.2;1790;52
4838;DOA: Dead or Alive;398913;4.5;44;15;29;34;4.2;10;2;8;20;2.7;71044;43
4839;Death Ship;80603;0;3;1;2;33;0;0;0;0;0;0;0;0
4840;Le dernier métro;80610;7.3;17;15;2;88;0;2;1;1;50;3.9;1300;82
4841;Divine Madness;80634;0;0;0;0;0;0;0;0;0;0;0;0;0
4842;The Dogs of War;80641;6.2;9;8;1;88;0;0;0;0;0;0;0;0
4843;The Learning Curve;219126;4.3;10;2;8;20;0;3;0;3;0;3.1;147;50
4844;Bandits;219965;6.1;136;86;50;63;5.9;34;20;14;58;3.1;9238;56
4845;Corky Romano;250310;2.8;81;4;77;4;2.5;24;1;23;4;2.4;4219;42
4846;Siu nin Wong Fei Hung ji: Tit Ma Lau;108148;7.3;90;81;9;90;7.5;25;24;1;96;3.7;3899;83
4847;À ma soeur!;243255;6.4;83;60;23;72;7.4;26;23;3;88;3.4;1800;63
4848;Mulholland Dr.;166924;7.4;150;122;28;81;7.6;33;29;4;87;3.7;36399;88
4849;My First Mister;206963;5.6;79;42;37;53;5.1;24;11;13;45;3.6;1032;74
4850;Spriggan;164917;5.6;13;7;6;53;0;1;0;1;0;3.4;1591;67
4851;Things Behind the Sun;245501;7;10;10;0;100;0;1;1;0;100;3.7;309;76
4852;Bones;166110;3.8;65;14;51;21;3.8;22;5;17;22;2.7;3184;47
4853;Brannigan;72732;4.6;5;1;4;20;0;1;0;1;0;3.1;1032;48
4854;Clambake;61489;0;0;0;0;0;0;0;0;0;0;0;0;0
4855;Dirty Harry;66999;7.8;42;40;2;95;6.2;5;4;1;80;3.8;17350;86
4856;Destiny in Space;109609;0;0;0;0;0;0;0;0;0;0;0;0;0
4857;Fiddler on the Roof;67093;7.8;24;21;3;87;0;2;2;0;100;3.8;10462;87
4858;Hail Columbia!;84043;0;0;0;0;0;0;0;0;0;0;0;0;0
4859;Kansas City;116745;5.9;33;19;14;57;6.2;9;5;4;55;3;608;37
4860;Making the Grade;87666;0;1;0;1;0;0;0;0;0;0;0;0;0
4861;Mission to Mir;119682;0;0;0;0;0;0;0;0;0;0;0;0;0
4862;Not Without My Daughter;102555;4.9;14;7;7;50;0;2;1;1;50;3.4;2771;72
4863;Female Trouble;72979;6.6;19;15;4;78;0;1;1;0;100;4;2218;84
4864;Titanica;105601;6;5;3;2;60;0;1;1;0;100;3.2;184;49
4865;From Hell;120681;5.7;146;83;63;56;5.3;33;17;16;51;3.3;33233;70
4866;The Last Castle;272020;5.6;113;59;54;52;5.6;27;14;13;51;3.4;9259;73
4867;Riding in Cars with Boys;200027;5.2;107;51;56;47;4.6;31;11;20;35;3.1;12761;63
4868;Bangkok Dangerous;814022;3.4;92;8;84;8;3.3;15;1;14;6;2.8;23793;33
4869;Plata quemada;227277;6.5;29;22;7;75;6.9;13;11;2;84;3.8;917;78
4870;Dancing at the Blue Iguana;217355;4.6;22;5;17;22;5.6;5;2;3;40;3;698;44
4871;Auto Focus;298744;6.7;155;112;43;72;6.9;37;28;9;75;3.2;1283;56
4872;Intimacy;256103;6.2;68;44;24;64;6.4;22;16;6;72;3.3;918;58
4873;Waking Life;243017;7.4;137;109;28;79;7.6;32;26;6;81;4;17715;87
4874;K-PAX;272152;5.1;136;55;81;40;5.1;32;14;18;43;3.2;14543;73
4875;On the Line;279286;3.5;68;12;56;17;3.7;21;6;15;28;2.8;1493;50
4876;Thir13en Ghosts;245674;3.4;89;11;78;12;3.4;22;3;19;13;3;20700;60
4877;Better Than Sex;236019;5.2;48;23;25;47;5.2;12;6;6;50;3.7;1847;76
4878;Donnie Darko;246578;7.5;103;87;16;84;6.7;16;10;6;62;3.1;208768;77
4879;High Heels and Low Lifes;253126;4.3;30;6;24;20;4.9;5;2;3;40;3.1;929;47
4880;Life as a House;264796;5.2;102;47;55;46;4.5;30;9;21;30;3.8;11735;88
4881;The Man Who Wasn't There;243133;7.1;152;122;30;80;6.8;32;23;9;71;3.7;10358;81
4883;La ville est tranquille;234988;6.7;35;25;10;71;6.7;11;7;4;63;3.7;242;71
4884;Trembling Before G-d;278102;7.1;61;54;7;88;7.2;19;18;1;94;3.4;564;64
4885;Domestic Disturbance;249478;4;97;23;74;23;4.1;25;5;20;20;2.9;4637;45
4886;Monsters, Inc.;198781;7.9;165;157;8;95;7.1;33;29;4;87;3.8;150109;83
4887;The One;267804;3.9;83;11;72;13;3.9;22;4;18;18;3.1;16192;60
4888;Tape;275719;6.7;90;69;21;76;6.8;24;18;6;75;3.6;2260;75
4889;Heist;252503;6.2;125;82;43;65;6.3;30;18;12;60;3.2;3156;59
4890;Shallow Hal;256380;5.4;118;59;59;50;5;29;13;16;44;3;34183;52
4892;Maze;246072;\N;\N;\N;\N;\N;\N;\N;\N;\N;\N;\N;\N;\N
4893;When a Stranger Calls;455857;3.2;88;8;80;9;3.1;14;1;13;7;3.1;53427;55
4894;Timerider: The Adventure of Lyle Swann;86443;0;0;0;0;0;0;0;0;0;0;0;0;0
4895;The Wash;290332;2.9;50;4;46;8;2.7;16;1;15;6;3.4;3029;65
4896;Harry Potter and the Sorcerer's Stone;241527;7;183;143;40;78;6.7;40;30;10;75;3.6;181305;81
4897;The Fluffer;245115;\N;\N;\N;\N;\N;\N;\N;\N;\N;\N;\N;\N;\N
4898;Novocaine;234354;4.6;105;39;66;37;4.5;29;9;20;31;2.8;1635;37
4899;Black Knight;265087;3.4;94;12;82;12;3.8;27;6;21;22;2.6;9124;46
4900;Out Cold;253798;2.9;48;4;44;8;3;15;1;14;6;3.5;7234;84
4901;Spy Game;266987;6.2;128;83;45;64;6.6;29;20;9;68;3.3;15479;70
4902;El espinazo del diablo;256009;7.5;100;92;8;92;7.4;25;23;2;92;3.9;9276;89
4903;In the Bedroom;247425;7.9;137;128;9;93;7.6;31;28;3;90;3.7;4252;79
4905;Hell Up in Harlem;70169;4.2;8;1;7;12;0;0;0;0;0;0;0;0
4907;Across 110th Street;68168;0;4;4;0;100;0;0;0;0;0;0;0;0
4908;Le petit soldat;54177;6.4;10;7;3;70;0;2;1;1;50;3.7;817;76
4909;The Incredible Shrinking Woman;82558;4;5;0;5;0;0;3;0;3;0;3;943;51
4910;Keetje Tippel;73233;0;3;2;1;66;0;1;0;1;0;2.9;32;29
4911;Jabberwocky;76221;5.8;12;7;5;58;0;0;0;0;0;0;0;0
4912;Funny Girl;62994;7.6;38;35;3;92;6.7;9;7;2;77;3.7;3850;81
4914;À bout de souffle;53472;8.6;48;46;2;95;8.1;12;11;1;91;4.2;10327;90
4915;The Beastmaster;83630;5.3;10;5;5;50;0;0;0;0;0;0;0;0
4916;Midway;74899;5.9;11;6;5;54;0;1;0;1;0;3.6;1581;72
4917;MacArthur;76342;5.4;8;5;3;62;0;0;0;0;0;0;0;0
4918;The Young Lions;52415;7.6;5;4;1;80;0;0;0;0;0;0;0;0
4919;Subway;90095;5.8;7;6;1;85;0;0;0;0;0;0;0;0
4920;Now, Voyager;35140;8;19;17;2;89;0;0;0;0;0;0;0;0
4921;Little Women;110367;0;0;0;0;0;0;0;0;0;0;0;0;0
4922;Halls of Montezuma;42539;6.6;6;5;1;83;0;0;0;0;0;0;0;0
4923;Guadalcanal Diary;35957;0;2;1;1;50;0;0;0;0;0;0;0;0
4924;Lo sbarco di Anzio;62673;6.1;6;4;2;66;0;1;1;0;100;3.1;972;43
4925;The Cheap Detective;77321;5.7;12;6;6;50;0;0;0;0;0;0;0;0
4926;Iedereen beroemd!;209037;5.3;52;28;24;53;5;21;11;10;52;3.4;535;58
4927;The Last Wave;76299;7.4;15;13;2;86;0;1;0;1;0;3.7;913;79
4928;Cet obscur objet du désir;75824;9;25;25;0;100;0;3;3;0;100;4.1;2049;90
4929;Toy Story;114709;9;73;73;0;100;8.5;17;17;0;100;3.7;102338;81
4930;Funeral in Berlin;60437;5.9;7;5;2;71;0;0;0;0;0;0;0;0
4931;Don't Go in the House;80646;0;3;0;3;0;0;0;0;0;0;0;0;0
4932;Dressed to Kill;38494;6.2;5;4;1;80;0;0;0;0;0;0;0;0
4933;The Earthling;80671;0;0;0;0;0;0;0;0;0;0;0;0;0
4934;The Exterminator;80707;0;3;0;3;0;0;0;0;0;0;0;0;0
4935;Darkness Falls;282209;3.2;124;10;114;8;3;25;1;24;4;2.8;11135;46
4936;Fame;80716;6.9;28;22;6;78;0;4;2;2;50;3.2;6724;67
4937;Fatso;80724;0;3;2;1;66;0;0;0;0;0;0;0;0
4938;La femme de l'aviateur;80728;7.3;6;6;0;100;0;3;3;0;100;3.6;300;79
4939;The Final Countdown;80736;5.5;10;5;5;50;0;1;0;1;0;3.4;1797;64
4940;The First Deadly Sin;80738;5.9;7;4;3;57;0;1;1;0;100;3;424;33
4941;Flash Gordon;80745;6.3;32;26;6;81;0;3;2;1;66;3.1;6492;64
4942;The Angry Red Planet;52564;4;6;0;6;0;0;0;0;0;0;0;0;0
4943;At the Earth's Core;74157;4.4;6;2;4;33;0;1;0;1;0;2.9;800;35
4944;Empire of the Ants;75989;2.4;16;0;16;0;0;2;0;2;0;2.7;618;29
4945;The Enforcer;74483;6.3;26;20;6;76;0;1;1;0;100;3.4;3350;61
4946;Eye for an Eye;116260;0;0;0;0;0;0;0;0;0;0;0;0;0
4947;The Gauntlet;76070;6.1;16;13;3;81;0;1;1;0;100;3.2;2342;53
4948;I Bury the Living;51755;6.3;10;6;4;60;0;0;0;0;0;0;0;0
4949;Invasion U.S.A.;89348;4;10;3;7;30;0;1;0;1;0;3;1237;51
4950;Lone Wolf McQuade;85862;0;3;2;1;66;0;1;1;0;100;3.4;1315;69
4951;Lord of the Flies;100054;6.4;18;11;7;61;0;1;0;1;0;3.1;6608;54
4952;Morons from Outer Space;89622;0;3;1;2;33;0;0;0;0;0;0;0;0
4953;The People That Time Forgot;76535;0;3;1;2;33;0;0;0;0;0;0;0;0
4954;Ocean's Eleven;240772;6.9;166;135;31;81;7.2;33;28;5;84;3.6;185259;76
4955;The Sicilian;93966;4.2;8;1;7;12;0;1;0;1;0;2.9;708;42
4956;The Fall Guy;81859;\N;\N;\N;\N;\N;\N;\N;\N;\N;\N;\N;\N;\N
4957;Sudden Impact;86383;5.7;32;19;13;59;0;4;3;1;75;3.2;4154;56
4958;Behind Enemy Lines;159273;4.7;127;46;81;36;4.7;30;12;18;40;3.3;24612;65
4959;The Affair of the Necklace;242252;3.7;61;9;52;14;4.4;20;5;15;25;3.1;984;45
4960;The Independent;160403;6;48;29;19;60;6.3;13;9;4;69;3;404;46
4961;Porn Star: The Legend of Ron Jeremy;282856;6;47;32;15;68;5.5;17;8;9;47;3.3;1190;61
4962;Walker, Texas Ranger;106168;\N;\N;\N;\N;\N;\N;\N;\N;\N;\N;\N;\N;\N
4963;Ocean's Eleven;240772;6.9;166;135;31;81;7.2;33;28;5;84;3.6;185259;76
4964;Baran;233841;7.6;63;56;7;88;8;21;20;1;95;3.9;880;87
4965;The Business of Strangers;270259;6.5;91;72;19;79;7.3;29;27;2;93;3.1;808;49
4966;The Incredible Shrinking Man;50539;7.6;16;14;2;87;0;2;1;1;50;3.7;997;80
4967;No Man's Land;283509;7.8;97;90;7;92;8.2;24;23;1;95;4.1;3608;92
4968;Piñero;261066;5.4;61;26;35;42;5.3;22;10;12;45;3.7;301;70
4969;And Then There Were None;37515;8;11;11;0;100;0;0;0;0;0;0;0;0
4970;Der blaue Engel;20697;8.3;32;30;2;93;7.9;9;9;0;100;4;1414;85
4971;Moscow on the Hudson;87747;7;13;12;1;92;0;1;1;0;100;3;1498;48
4972;The Owl and the Pussycat;66195;6.5;10;8;2;80;0;0;0;0;0;0;0;0
4973;Le fabuleux destin d'Amélie Poulain;211915;7.9;140;126;14;90;7.5;28;24;4;85;4.2;149167;95
4974;Not Another Teen Movie;277371;4;94;26;68;27;4.4;22;7;15;31;3;48724;60
4975;Vanilla Sky;259711;5.2;160;63;97;39;4.4;33;8;25;24;3;44021;68
4976;Iris;280778;7.1;109;86;23;78;7.6;34;29;5;85;3.6;2908;73
4977;Safar e Ghandehar;283431;7.6;96;85;11;88;8;31;31;0;100;3.6;1057;74
4978;Lantana;259393;7.4;103;93;10;90;7.8;30;28;2;93;3.8;1926;81
4979;The Royal Tenenbaums;265666;7.2;170;135;35;79;6.7;36;27;9;75;3.6;56830;87
4980;Bill & Ted's Bogus Journey;101452;6;33;19;14;57;6;6;4;2;66;3;17201;59
4981;Clockwise;90852;0;4;3;1;75;0;0;0;0;0;0;0;0
4982;The Trollenberg Terror;52320;5.1;7;4;3;57;0;0;0;0;0;0;0;0
4983;The Holcroft Covenant;89283;0;2;1;1;50;0;0;0;0;0;0;0;0
4984;Morgan: A Suitable Case for Treatment;60714;7.3;6;6;0;100;0;0;0;0;0;0;0;0
4985;Sheena;88103;4.2;8;3;5;37;0;0;0;0;0;0;0;0
4986;Silent Rage;84684;\N;\N;\N;\N;\N;\N;\N;\N;\N;\N;\N;\N;\N
4987;Spacehunter: Adventures in the Forbidden Zone;86346;3.2;5;1;4;20;0;0;0;0;0;0;0;0
4988;White Water Summer;94318;4.5;6;2;4;33;0;0;0;0;0;0;0;0
4989;How High;278488;3.8;56;15;41;26;4.4;19;7;12;36;3.5;15720;80
4990;Jimmy Neutron: Boy Genius;268397;6.4;73;54;19;73;6.1;17;11;6;64;2.7;5010;42
4991;Joe Somebody;279889;4.5;30;12;18;40;5.5;11;6;5;54;0;0;0
4992;Kate & Leopold;35423;5.2;116;55;61;47;5.2;30;13;17;43;3;23394;64
4993;The Lord of the Rings: The Fellowship of the Ring;120737;8.1;202;186;16;92;7.9;38;35;3;92;4.1;282006;92
4994;The Majestic;268995;4.9;135;56;79;41;4;30;8;22;26;3.1;10091;60
4995;A Beautiful Mind;268978;7.1;180;140;40;77;7.2;37;30;7;81;3.9;103150;91
4996;Otesánek;228687;7;42;35;7;83;6.6;8;6;2;75;3.9;1648;84
4997;The Convent;217331;0;2;1;1;50;0;0;0;0;0;0;0;0
4998;The Defiant Ones;51525;7;14;12;2;85;0;2;2;0;100;3.7;1030;85
4999;Dodsworth;27532;7.5;15;13;2;86;0;3;3;0;100;4;490;82
5000;Medium Cool;64652;8.1;18;17;1;94;0;2;2;0;100;3.7;656;75
5001;Sahara;318649;5.2;171;66;105;38;5;34;15;19;44;3;24489;61
5002;Fritz the Cat;68612;5.4;18;10;8;55;0;2;1;1;50;3.3;1651;64
5003;The Nine Lives of Fritz the Cat;71913;5.7;7;3;4;42;0;0;0;0;0;0;0;0
5004;24 Hour Party People;274309;0;0;0;0;0;0;0;0;0;0;0;0;0
5005;Separate Tables;52182;8.1;11;10;1;90;0;0;0;0;0;0;0;0
5006;Yu pu tuan zhi: Tou qing bao jian;105287;0;0;0;0;0;0;0;0;0;0;0;0;0
5007;Topkapi;58672;7.4;18;15;3;83;0;3;3;0;100;0;0;0
5008;Witness for the Prosecution;84911;\N;\N;\N;\N;\N;\N;\N;\N;\N;\N;\N;\N;\N
5009;Ali;248667;6.3;145;97;48;66;6.5;34;25;9;73;3.3;18871;65
5010;Black Hawk Down;265086;6.9;156;119;37;76;6.5;34;25;9;73;3.7;83816;85
5011;Charlotte Gray;245046;4.7;87;27;60;31;5;32;11;21;34;3.4;2092;62
5012;Yentl;86619;6;14;10;4;71;0;1;1;0;100;3.4;1678;72
5013;Gosford Park;280707;7.5;141;121;20;85;8.1;30;29;1;96;3.5;10122;76
5014;I Am Sam;277027;4.6;141;47;94;33;4.7;38;14;24;36;3.7;51459;87
5015;Monster's Ball;285742;7.4;141;120;21;85;7.1;38;30;8;78;3.3;12025;65
5016;The Shipping News;120824;5.8;128;71;57;55;5.8;32;18;14;56;3.2;4197;62
5017;The Big Heat;45555;8.4;25;25;0;100;8.6;5;5;0;100;0;0;0
5018;Motorama;104922;5.1;5;3;2;60;0;0;0;0;0;0;0;0
5019;Queen Bee;48527;0;4;2;2;50;0;0;0;0;0;0;0;0
5020;Silent Trigger;117653;0;4;1;3;25;0;0;0;0;0;0;0;0
5021;Murder by Death;74937;6.1;16;11;5;68;0;3;2;1;66;3.9;3635;84
5022;The Servant;57490;6.6;16;12;4;75;0;3;1;2;33;4.1;746;92
5023;The Waterdance;105789;7.2;13;12;1;92;0;2;2;0;100;3.3;417;56
5024;Presque rien;242795;0;0;0;0;0;0;0;0;0;0;0;0;0
5025;Orange County;273923;5.2;119;56;63;47;5.2;29;13;16;44;3;12865;61
5026;Le pacte des loups;237534;6.2;115;82;33;71;6;30;21;9;70;3.5;10900;76
5027;Another 48 Hrs.;99044;3.8;20;4;16;20;0;2;0;2;0;2.9;6166;41
5028;Ni na bian ji dian;269746;7.1;50;42;8;84;7.4;17;15;2;88;3.9;860;81
5029;China Moon;109417;5.6;9;4;5;44;0;1;0;1;0;3;535;35
5030;The Umbrella Woman;93106;0;4;2;2;50;0;1;0;1;0;2.9;207;23
5031;Maria's Lovers;87682;0;3;1;2;33;0;0;0;0;0;0;0;0
5032;Failure to Launch;427229;4.6;147;37;110;25;5.2;33;13;20;39;3.2;86609;60
5033;The Russia House;100530;6.6;14;10;4;71;0;2;1;1;50;3;1792;42
5034;Truly Madly Deeply;103129;6.6;32;23;9;71;6.9;6;5;1;83;3.9;3004;82
5035;Wuthering Heights;32145;7.9;16;16;0;100;0;1;1;0;100;3.9;2525;84
5036;California Suite;77289;5.2;19;11;8;57;0;2;0;2;0;3.1;671;47
5037;The Long Gray Line;48312;7.1;5;5;0;100;0;0;0;0;0;0;0;0
5038;The Flight of Dragons;83951;0;0;0;0;0;0;0;0;0;0;0;0;0
5039;Dragonslayer;82288;6.1;22;18;4;81;0;1;1;0;100;3.2;8214;59
5040;Conan the Destroyer;87078;0;0;0;0;0;0;0;0;0;0;0;0;0
5041;Fire & Ice;1135493;0;0;0;0;0;0;0;0;0;0;0;0;0
5042;Spacehunter: Adventures in the Forbidden Zone;86346;3.2;5;1;4;20;0;0;0;0;0;0;0;0
5043;17 sui de tian kong;420627;4.8;9;2;7;22;5.2;5;2;3;40;3.6;656;70
5044;Foxes;80756;5.9;9;6;3;66;0;1;1;0;100;3.3;658;55
5045;Galaxina;80771;3.6;5;1;4;20;0;0;0;0;0;0;0;0
5046;Impostor;160399;3.9;91;19;72;20;3.6;25;4;21;16;3;1418;46
5047;Kung Pow: Enter the Fist;240468;2.8;53;6;47;11;2.8;12;0;12;0;3;15128;64
5048;Snow Dogs;281373;3.9;79;18;61;22;3.5;18;3;15;16;2.8;11502;55
5049;48 Hrs.;83511;7.4;33;31;2;93;0;4;3;1;75;3.2;10471;61
5050;Abschied - Brechts letzter Sommer;206608;6.5;14;10;4;71;0;4;4;0;100;2.8;129;30
5051;Italiensk for begyndere;243862;7.2;81;71;10;87;7.5;26;23;3;88;3.7;1581;77
5052;Ha-Hesder;268696;6.1;24;14;10;58;6.9;11;9;2;81;3.6;197;71
5053;Blankman;109288;3.3;15;2;13;13;0;3;1;2;33;2.3;2988;32
5054;Brainstorm;85271;5.8;14;9;5;64;0;1;0;1;0;3.1;1295;54
5055;Dragon: The Bruce Lee Story;106770;6.8;17;14;3;82;0;3;1;2;33;3.4;7771;76
5056;Jeder für sich und Gott gegen alle;71691;0;0;0;0;0;0;0;0;0;0;0;0;0
5057;4 for Texas;57071;4.1;8;1;7;12;0;0;0;0;0;0;0;0
5058;Herz aus Glas;74626;7.2;7;6;1;85;0;2;1;1;50;3.7;892;71
5059;Little Dieter Needs to Fly;145046;7.8;14;13;1;92;0;4;3;1;75;4.1;1132;93
5060;MASH;66026;8.2;35;31;4;88;0;4;3;1;75;3.7;10200;81
5061;Mrs. Soffel;87751;5.6;9;5;4;55;0;2;0;2;0;3.1;791;41
5062;Gone in Sixty Seconds;187078;4.4;133;32;101;24;4;35;8;27;22;3.5;92563;79
5063;One-Eyed Jacks;55257;6.3;12;7;5;58;0;0;0;0;0;0;0;0
5064;The Count of Monte Cristo;245844;6.6;134;99;35;73;6.3;27;18;9;66;3.6;29907;85
5065;The Mothman Prophecies;265349;5.5;133;69;64;51;4.8;31;9;22;29;3;8350;58
5066;A Walk to Remember;281358;4.1;101;28;73;27;4.1;25;6;19;24;3.3;243778;79
5067;American Adobo;294289;4.6;23;7;16;30;5;9;4;5;44;3.8;502;71
5068;Shiqi sui de dan che;276501;6.4;58;36;22;62;6.3;18;11;7;61;3.6;1036;75
5069;Escaflowne;270933;5.3;14;6;8;42;0;4;3;1;75;3.6;2839;73
5071;Maelström;220627;6.7;35;28;7;80;6.6;11;9;2;81;4;14;100
5072;Metropolis;17136;8.9;98;97;1;98;8.8;23;23;0;100;4.1;17640;90
5073;La stanza del figlio;208990;7.3;81;68;13;83;7.6;28;25;3;89;3.8;1513;80
5074;Storytelling;250081;5.6;89;47;42;52;5.8;27;15;12;55;3.5;3033;69
5075;Waydowntown;219405;6.4;33;23;10;69;6.4;7;5;2;71;3.5;496;70
5076;The Adventures of Huck Finn;106223;5.9;13;8;5;61;0;4;3;1;75;2.9;2408;47
5077;Cousins;97116;5.8;8;4;4;50;0;1;1;0;100;3.1;644;57
5078;Falling in Love;87233;5.4;10;6;4;60;0;1;0;1;0;3.5;2067;67
5079;Young @ Heart;1047007;7.5;97;85;12;87;7.7;23;21;2;91;4.2;3340;91
5080;Slackers;240900;3.1;104;11;93;10;2.4;30;1;29;3;2.8;4294;52
5081;Birthday Girl;188453;5.7;120;69;51;57;5.5;30;16;14;53;2.8;4145;40
5082;A Rumor of Angels;201899;4.7;29;10;19;34;4.7;9;3;6;33;3.6;355;74
5083;Rare Birds;295552;5.9;12;7;5;58;0;4;1;3;25;3.4;569;61
5084;Caged Heat;71266;6.4;9;7;2;77;0;1;0;1;0;2.9;988;37
5085;Carmen Jones;46828;6.1;18;13;5;72;0;3;2;1;66;3.9;1003;80
5086;The Five Heartbeats;101891;4.9;14;6;8;42;0;2;1;1;50;4.2;4599;93
5087;Préparez vos mouchoirs;78122;6.6;9;8;1;88;0;0;0;0;0;0;0;0
5088;Les valseuses;72353;6.9;6;5;1;83;0;0;0;0;0;0;0;0
5089;Honky Tonk Freeway;82525;0;2;2;0;100;0;0;0;0;0;0;0;0
5090;Notre-Dame de Paris;50781;0;0;0;0;0;0;0;0;0;0;0;0;0
5091;Le magnifique;70354;0;0;0;0;0;0;0;0;0;0;0;0;0
5092;Big Fat Liar;265298;4.9;88;38;50;43;4.5;21;7;14;33;2.9;23120;52
5093;Collateral Damage;233469;4;139;24;115;17;3.9;30;6;24;20;2.8;10885;34
5094;Rollerball;73631;6;25;17;8;68;0;4;1;3;25;3.2;2655;61
5095;Scotland, Pa.;265713;6;74;44;30;59;5.3;27;11;16;40;3.6;1222;74
5096;Baby's Day Out;109190;3.9;14;3;11;21;0;3;0;3;0;2.7;10709;54
5097;Bright Eyes;24914;6.4;8;6;2;75;0;0;0;0;0;0;0;0
5098;Dimples;27527;0;2;1;1;50;0;0;0;0;0;0;0;0
5099;Heidi;63051;0;0;0;0;0;0;0;0;0;0;0;0;0
5100;L'homme qui aimait les femmes;76155;7;9;8;1;88;0;2;2;0;100;3.9;1035;83
5101;Richard Pryor... Here and Now;86194;7.5;6;5;1;83;0;1;1;0;100;3.7;646;83
5102;Rookie of the Year;107985;4.7;17;6;11;35;0;2;1;1;50;0;0;0
5103;The Sandlot;108037;5.8;22;13;9;59;0;3;2;1;66;3.6;28919;86
5104;Vacas;103186;0;2;0;2;0;0;0;0;0;0;0;0;0
5105;Don't Look Now;69995;8.2;37;35;2;94;6.6;8;7;1;87;3.8;4354;80
5106;Crossroads;275022;3.9;101;14;87;13;3.9;24;3;21;12;2.2;15071;41
5107;Hart's War;251114;5.9;117;68;49;58;5.6;32;17;15;53;3;6114;52
5108;John Q;251160;4.4;127;28;99;22;4;33;4;29;12;3.6;18865;83
5109;Return to Never Land;280030;5.4;89;41;48;46;6.3;22;15;7;68;3.2;4974;54
5110;Super Troopers;247745;5;86;31;55;36;5.1;20;8;12;40;3.7;49372;89
5111;The Good Son;107034;4.2;24;6;18;25;3.9;8;2;6;25;3;6435;58
5112;Last Orders;253200;7;88;69;19;78;7.4;28;23;5;82;3.4;644;64
5113;Caccia alla volpe;60200;5.4;7;5;2;71;0;0;0;0;0;0;0;0
5114;The Bad and the Beautiful;44391;7.7;13;13;0;100;0;1;1;0;100;3.8;1035;83
5115;Cast a Giant Shadow;60218;0;3;1;2;33;0;0;0;0;0;0;0;0
5116;Designing Woman;50306;7;8;6;2;75;0;0;0;0;0;0;0;0
5117;Funny Lady;73026;4.4;7;2;5;28;0;1;0;1;0;3.2;1039;59
5118;The Heartbreak Kid;408839;4.7;153;47;106;30;4.6;32;9;23;28;2.9;91228;41
5119;Saturday Night and Sunday Morning;54269;8;10;10;0;100;0;0;0;0;0;0;0;0
5120;Sleuth;857265;5.1;118;42;76;35;5.1;30;10;20;33;3.2;9724;53
5121;Stroszek;75276;8.2;13;13;0;100;0;3;3;0;100;4.3;1933;93
5122;Summer of '42;67803;6.7;16;13;3;81;0;1;0;1;0;3.6;580;78
5123;A Touch of Class;70819;6.8;10;9;1;90;0;1;1;0;100;3;669;46
5124;Town Without Pity;55539;6;5;3;2;60;0;0;0;0;0;0;0;0
5125;Used Cars;81698;6.5;17;13;4;76;0;1;0;1;0;3.3;1611;63
5126;The Deadly Mantis;50294;4.2;8;2;6;25;0;0;0;0;0;0;0;0
5127;Dragonfly;259288;3.6;121;8;113;6;3.5;30;1;29;3;3.1;9426;65
5128;Queen of the Damned;238546;3.9;126;21;105;16;3.9;31;5;26;16;3.1;36894;70
5129;Big Bad Love;260746;5.4;58;24;34;41;5.3;20;7;13;35;3.7;279;74
5130;Green Dragon;229002;5.9;28;17;11;60;6.3;9;6;3;66;3.1;559;40
5131;How to Kill Your Neighbor's Dog;207524;6;31;18;13;58;5.5;9;4;5;44;3.7;569;70
5132;The Last Man on Earth;58700;6.3;15;11;4;73;0;1;0;1;0;3.6;4886;69
5133;Maryam;184719;6.8;34;26;8;76;7.1;12;10;2;83;3.8;36;83
5134;Mean Machine;291341;4.9;56;19;37;33;5.4;21;9;12;42;3.5;6547;76
5135;Monsoon Wedding;265343;7.9;116;110;6;94;8;35;33;2;94;3.8;5868;85
5136;Wendigo;275067;6.2;50;29;21;58;5.9;13;6;7;46;2.4;773;27
5137;Scratch;143861;\N;\N;\N;\N;\N;\N;\N;\N;\N;\N;\N;\N;\N
5138;State Property;301893;2;12;0;12;0;0;3;0;3;0;3.7;1134;75
5139;Bad News Bears;408524;0;0;0;0;0;0;0;0;0;0;0;0;0
5140;The Bad News Bears Go to Japan;77199;2.9;10;0;10;0;0;0;0;0;0;0;0;0
5141;The Bad News Bears in Breaking Training;75718;6;8;4;4;50;0;0;0;0;0;0;0;0
5142;Horí, má panenko;61781;7.7;16;14;2;87;0;1;1;0;100;3.9;578;83
5143;The Lone Ranger;41038;\N;\N;\N;\N;\N;\N;\N;\N;\N;\N;\N;\N;\N
5144;The Lone Ranger and the Lost City of Gold;51876;0;4;2;2;50;0;0;0;0;0;0;0;0
5145;Lásky jedné plavovlásky;59415;8;13;12;1;92;0;0;0;0;0;0;0;0
5146;Vampire Hunter D: Bloodlust;216651;6.4;32;23;9;71;6.3;12;8;4;66;3.8;11019;83
5147;Smultronstället;50986;8.8;31;29;2;93;0;2;1;1;50;4.4;6409;94
5148;Black Like Me;57889;0;0;0;0;0;0;0;0;0;0;0;0;0
5149;Cattle Queen of Montana;46839;0;1;1;0;100;0;0;0;0;0;0;0;0
5150;Under the Skin;124185;6.8;22;19;3;86;7.7;9;9;0;100;3.4;239;67
5151;40 Days and 40 Nights;243736;4.8;134;51;83;38;4.5;34;9;25;26;3.1;33188;53
5152;We Were Soldiers;277434;6.4;141;88;53;62;6.9;36;27;9;75;3.6;36901;84
5153;Trouble Every Day;204700;5.6;45;20;25;44;4.5;11;3;8;27;3.5;756;63
5154;Arena;101366;0;0;0;0;0;0;0;0;0;0;0;0;0
5155;The Big Bird Cage;68273;0;3;3;0;100;0;0;0;0;0;0;0;0
5156;The Big Doll House;66830;0;4;4;0;100;0;0;0;0;0;0;0;0
5157;La chiesa;94860;5.8;9;6;3;66;0;0;0;0;0;0;0;0
5158;Cross Creek;85380;5.4;10;6;4;60;0;2;1;1;50;3.4;269;59
5159;FernGully: The Last Rainforest;104254;6.3;13;9;4;69;0;1;1;0;100;3.1;10187;62
5160;Night of the Zombies;82815;0;0;0;0;0;0;0;0;0;0;0;0;0
5161;Intersection;110146;3.4;27;2;25;7;3.1;8;0;8;0;2.8;1105;40
5162;Jo Jo Dancer, Your Life Is Calling;91295;5.6;11;6;5;54;0;1;1;0;100;3.4;747;66
5163;Deliria;92576;0;2;1;1;50;0;0;0;0;0;0;0;0
5164;A Troll in Central Park;108395;3.1;5;0;5;0;0;0;0;0;0;0;0;0
5165;Zombi 2;80057;4.6;14;5;9;35;0;0;0;0;0;0;0;0
5167;My Favorite Brunette;39645;5.9;7;5;2;71;0;0;0;0;0;0;0;0
5168;Royal Wedding;43983;6.7;14;12;2;85;0;0;0;0;0;0;0;0
5169;Scarlet Street;38057;8;11;11;0;100;0;0;0;0;0;0;0;0
5170;All About the Benjamins;278295;4.3;75;22;53;29;4.2;21;6;15;28;3.4;6169;77
5171;The Time Machine;268695;4.8;146;41;105;28;5;32;6;26;18;2.7;10389;45
5172;Full Frontal;290212;5.2;140;52;88;37;5.2;35;12;23;34;2.6;1893;27
5173;Divorcing Jack;127516;0;0;0;0;0;0;0;0;0;0;0;0;0
5174;The Field;99566;5.2;14;6;8;42;3.3;6;1;5;16;3.8;615;80
5175;Hidden Agenda;99768;6.6;18;14;4;77;6.5;5;4;1;80;3.7;279;75
5176;Luminarias;160498;6.1;15;10;5;66;0;2;0;2;0;3.1;147;43
5177;The Magnificent Ambersons;35015;8.4;23;22;1;95;7.6;6;6;0;100;4.1;1662;86
5178;He's Just Not That Into You;1001508;5.2;152;64;88;42;5;37;12;25;32;3.4;219066;60
5179;Gloria;120683;4.1;27;5;22;18;5.1;6;1;5;16;2.7;660;31
5180;The Great Rock 'n' Roll Swindle;80813;6.9;6;6;0;100;0;0;0;0;0;0;0;0
5181;Hangar 18;80836;0;3;1;2;33;0;0;0;0;0;0;0;0
5182;Hawk the Slayer;80846;0;3;1;2;33;0;0;0;0;0;0;0;0
5183;He Knows You're Alone;80850;4.8;5;1;4;20;0;0;0;0;0;0;0;0
5184;Heaven's Gate;80855;5;20;9;11;45;0;3;1;2;33;3.1;1241;52
5185;Hero at Large;80863;0;0;0;0;0;0;0;0;0;0;0;0;0
5186;Honeysuckle Rose;80888;0;4;3;1;75;0;1;1;0;100;3.9;189;78
5187;Hopscotch;80889;6.1;12;9;3;75;0;1;1;0;100;3.6;761;72
5188;How to Beat the High Co$t of Living;80895;\N;\N;\N;\N;\N;\N;\N;\N;\N;\N;\N;\N;\N
5189;Humanoids from the Deep;80904;4.9;8;4;4;50;0;0;0;0;0;0;0;0
5190;Inside Moves;80928;0;2;1;1;50;0;0;0;0;0;0;0;0
5192;The Island;399201;5.4;184;74;110;40;5.2;36;14;22;38;3.3;41199;67
5193;The Jazz Singer;80948;3.7;20;3;17;15;0;3;1;2;33;3.4;857;71
5194;Ko to tamo peva;76276;0;0;0;0;0;0;0;0;0;0;0;0;0
5195;Le lac des morts vivants;81027;0;2;0;2;0;0;0;0;0;0;0;0;0
5196;Lion of the Desert;81059;0;4;3;1;75;0;0;0;0;0;0;0;0
5197;Little Darlings;81060;0;4;3;1;75;0;1;0;1;0;3.4;1497;71
5198;The Long Good Friday;81070;8.1;20;19;1;95;0;3;3;0;100;4.1;2936;88
5199;The Long Riders;81071;6.4;19;15;4;78;0;2;0;2;0;3.5;1258;71
5200;The Man Who Saw Tomorrow;81109;0;0;0;0;0;0;0;0;0;0;0;0;0
5201;Mangiati vivi!;81112;0;2;0;2;0;0;0;0;0;0;0;0;0
5202;Mon oncle d'Amérique;81176;8.1;9;9;0;100;0;2;2;0;100;3.9;640;84
5203;The Monster Club;81178;5.9;7;5;2;71;0;0;0;0;0;0;0;0
5204;La mort en direct;81182;0;0;0;0;0;0;0;0;0;0;0;0;0
5205;Motel Hell;81184;5.7;16;11;5;68;0;1;1;0;100;3.1;1573;52
5206;Mother's Day;81186;5.2;7;3;4;42;0;0;0;0;0;0;0;0
5207;The Mountain Men;81187;4.9;6;3;3;50;0;0;0;0;0;0;0;0
5208;The Ninth Configuration;81237;6.3;9;6;3;66;0;0;0;0;0;0;0;0
5209;North Sea Hijack;81809;0;4;1;3;25;0;0;0;0;0;0;0;0
5210;Le notti del terrore;81248;0;2;1;1;50;0;0;0;0;0;0;0;0
5211;The Nude Bomb;81249;3.2;16;3;13;18;0;1;0;1;0;3;745;40
5212;The Octagon;81259;3.6;5;1;4;20;0;0;0;0;0;0;0;0
5213;Oh, God! Book II;81268;5.1;6;3;3;50;0;1;0;1;0;2.8;490;44
5214;Oh, God! You Devil;87835;5.1;7;2;5;28;0;0;0;0;0;0;0;0
5215;Oh Heavenly Dog;81269;0;4;0;4;0;0;2;0;2;0;2.8;693;42
5216;Pepi, Luci, Bom y otras chicas del montón;81323;4.3;6;2;4;33;0;3;0;3;0;0;0;0
5217;Poliziotto superpiù;82924;3.5;6;0;6;0;0;1;0;1;0;3.2;682;52
5218;Ice Age;268380;6.8;161;124;37;77;7.3;32;25;7;78;3.7;146598;81
5219;Resident Evil;120804;4.5;120;41;79;34;3.8;23;4;19;17;3.4;69489;73
5220;Showtime;284490;4.7;120;29;91;24;4;31;4;27;12;2.5;5638;30
5221;Harrison's Flowers;216799;5.6;83;40;43;48;5.4;27;12;15;44;3.6;1213;75
5222;Kissing Jessica Stein;264761;7;115;97;18;84;7.6;30;27;3;90;3.2;3869;61
5223;Pauline & Paulette;256259;6.9;53;44;9;83;7.5;15;14;1;93;3.8;211;80
5224;Eastern Promises;765443;7.6;190;169;21;88;7.4;35;30;5;85;3.8;66267;82
5225;Y tu mamá también;245574;8;126;115;11;91;8.8;29;28;1;96;3.9;22998;87
5226;All the Right Moves;85154;4.9;19;10;9;52;0;3;2;1;66;2.9;2666;39
5227;Barabba;55774;6.8;6;6;0;100;0;0;0;0;0;0;0;0
5228;The Ghost Breakers;32520;7.7;5;5;0;100;0;0;0;0;0;0;0;0
5229;I Think I Do;125209;0;4;1;3;25;0;1;0;1;0;3.5;349;64
5230;The Paleface;40679;6.9;7;7;0;100;0;0;0;0;0;0;0;0
5231;Road to Morocco;35262;7.8;12;11;1;91;0;0;0;0;0;0;0;0
5232;Road to Singapore;32993;6.4;9;9;0;100;0;0;0;0;0;0;0;0
5233;Road to Utopia;38032;7.5;6;6;0;100;0;0;0;0;0;0;0;0
5234;Road to Zanzibar;34116;7;6;6;0;100;0;0;0;0;0;0;0;0
5235;Split Second;105459;0;2;0;2;0;0;0;0;0;0;0;0;0
5236;Conte de printemps;97106;6.9;11;10;1;90;0;4;4;0;100;3.6;251;72
5237;Taps;83169;6;14;11;3;78;0;1;1;0;100;3.4;2747;63
5238;Return of the Secaucus Seven;81420;6.7;15;12;3;80;0;1;1;0;100;3.5;323;73
5239;Rude Boy;81441;0;0;0;0;0;0;0;0;0;0;0;0;0
5240;Running Scared;404390;4.5;128;51;77;39;4.4;31;10;21;32;3.6;35992;77
5241;Seems Like Old Times;81480;6;11;8;3;72;0;1;0;1;0;3.3;1129;62
5242;Serial;81485;\N;\N;\N;\N;\N;\N;\N;\N;\N;\N;\N;\N;\N
5243;Shi di chu ma;81499;0;1;1;0;100;0;0;0;0;0;0;0;0
5244;Shogun Assassin;81506;0;3;3;0;100;0;0;0;0;0;0;0;0
5245;Simon;393775;5.6;5;3;2;60;0;4;2;2;50;4.1;338;87
5246;Smokey and the Bandit II;81529;4;5;1;4;20;0;1;0;1;0;2.8;3299;55
5247;Smokey and the Bandit;76729;6.2;22;17;5;77;0;1;0;1;0;3.4;8794;80
5248;Smokey and the Bandit Part 3;86325;\N;\N;\N;\N;\N;\N;\N;\N;\N;\N;\N;\N;\N
5249;Spetters;81547;6.8;5;4;1;80;0;0;0;0;0;0;0;0
5250;Stir Crazy;81562;6.2;14;10;4;71;0;1;0;1;0;3.4;3164;77
5251;Sällskapsresan eller Finns det svenskt kaffe på grisfesten;81590;0;0;0;0;0;0;0;0;0;0;0;0;0
5252;Tegeran-43;81609;\N;\N;\N;\N;\N;\N;\N;\N;\N;\N;\N;\N;\N
5253;Cousins;97116;5.8;8;4;4;50;0;1;1;0;100;3.1;644;57
5254;Blade II;187738;6;134;78;56;58;5.5;27;13;14;48;3.4;60022;72
5255;Sorority Boys;279781;3.2;62;8;54;12;3.2;16;2;14;12;2.8;5444;57
5256;Stolen Summer;286162;5;57;20;37;35;4.7;21;8;13;38;3.5;439;69
5258;George Washington;262432;7.3;56;46;10;82;7.4;12;10;2;83;4;1443;86
5259;Homicide: The Movie;226771;0;1;1;0;100;0;0;0;0;0;0;0;0
5260;La vida es silbar;192745;0;3;1;2;33;0;0;0;0;0;0;0;0
5262;Mr. Sardonicus;55200;4.6;8;3;5;37;0;0;0;0;0;0;0;0
5263;Strait-Jacket;58620;6.4;5;4;1;80;0;0;0;0;0;0;0;0
5264;Clockstoppers;157472;4.7;83;23;60;27;4.5;20;4;16;20;2.6;4856;35
5265;Death to Smoochy;266452;5.3;119;50;69;42;4;26;3;23;11;3;10569;61
5266;Panic Room;258000;6.9;178;136;42;76;6.6;34;24;10;70;3;19615;61
5267;The Rookie;265662;7.2;140;115;25;82;7.4;32;29;3;90;3.3;10597;68
5268;No Such Thing;248190;5;42;12;30;28;4.9;15;4;11;26;3.3;777;60
5269;La pianiste;254686;6.9;81;59;22;72;7.7;25;21;4;84;3.8;5369;81
5272;L'emploi du temps;279065;8;82;79;3;96;8.2;25;23;2;92;3.8;613;76
5273;Very Annie Mary;188128;4.9;27;8;19;29;4.8;9;2;7;22;3.8;488;75
5274;Bar Girls;109217;5;6;1;5;16;0;2;0;2;0;3;635;46
5275;Boxcar Bertha;68309;4.9;20;9;11;45;0;4;2;2;50;2.9;1317;34
5276;Crimes of Passion;87100;4.9;9;3;6;33;0;1;0;1;0;3.2;217;54
5277;The Evil That Men Do;87222;4.8;5;2;3;40;0;0;0;0;0;0;0;0
5278;Fraternity Vacation;89167;0;3;0;3;0;0;2;0;2;0;3;279;47
5279;Impromptu;102103;6.2;15;12;3;80;5.7;6;4;2;66;3.6;1242;73
5280;Salmonberries;102829;6.2;7;5;2;71;0;0;0;0;0;0;0;0
5281;The Wrong Guy;120536;0;3;0;3;0;0;1;0;1;0;3.6;826;81
5282;High Crimes;257756;0;0;0;0;0;0;0;0;0;0;0;0;0
5283;Van Wilder;283111;3.5;86;16;70;18;3.1;21;2;19;9;3.3;23872;78
5284;Crush;245407;\N;\N;\N;\N;\N;\N;\N;\N;\N;\N;\N;\N;\N
5285;Lucky Break;246134;5.6;44;21;23;47;5.6;17;8;9;47;3.2;389;53
5286;Les destinées sentimentales;216689;6;49;30;19;61;6.1;18;11;7;61;3.1;243;41
5287;After Dark, My Sweet;98994;6.7;15;13;2;86;6.9;5;4;1;80;3.3;506;57
5288;The Atomic Cafe;83590;7.4;14;14;0;100;0;0;0;0;0;0;0;0
5289;Body and Soul;39204;7.7;8;8;0;100;0;2;2;0;100;4;268;88
5290;First Men in the Moon;58100;6.1;6;4;2;66;0;0;0;0;0;0;0;0
5291;Rashômon;42876;0;0;0;0;0;0;0;0;0;0;0;0;0
5292;Slap Shot;76723;6.8;24;20;4;83;0;3;1;2;33;0;0;0
5293;Changing Lanes;264472;7;149;115;34;77;6.7;30;22;8;73;3;7920;49
5294;Frailty;264616;6.9;133;98;35;73;6.6;31;22;9;70;3.5;8605;78
5295;New Best Friend;191074;2.9;38;2;36;5;2.6;10;1;9;10;3;636;42
5296;The Sweetest Thing;253867;4.2;104;26;78;25;4.2;26;7;19;26;3;21858;68
5297;The Cat's Meow;266391;6.5;119;89;30;74;7.1;33;28;5;84;3.1;1938;48
5298;Human Nature;219822;5.8;94;46;48;48;5.4;25;9;16;36;3.3;3892;62
5299;My Big Fat Greek Wedding;259446;6.7;121;91;30;75;6.3;25;18;7;72;3.2;49673;69
5300;3:10 to Yuma;381849;7.5;205;182;23;88;7.3;42;36;6;85;3.9;139372;85
5301;Bite the Bullet;72705;6.6;14;10;4;71;0;3;2;1;66;3.2;558;50
5302;Breakout;72737;5.3;7;3;4;42;0;1;0;1;0;0;0;0
5303;Joe Versus the Volcano;99892;5.4;24;14;10;58;0;3;2;1;66;2.7;6794;45
5304;Roma, città aperta;38890;8.8;22;22;0;100;0;4;4;0;100;4.2;1681;90
5305;Return of the Killer Tomatoes!;95989;2.8;5;0;5;0;0;0;0;0;0;0;0;0
5306;Return to Horror High;93854;0;4;0;4;0;0;0;0;0;0;0;0;0
5307;Taking Care of Business;103035;2.6;5;0;5;0;0;1;0;1;0;2.8;695;48
5308;3 Men and a Baby;94137;5.7;24;17;7;70;0;4;3;1;75;2.9;11309;51
5309;3 Men and a Little Lady;98966;3.9;13;3;10;23;0;1;1;0;100;2.8;6348;48
5310;Transylvania 6-5000;90196;4.2;10;2;8;20;0;0;0;0;0;0;0;0
5311;The Watcher in the Woods;81738;4.9;13;6;7;46;0;1;0;1;0;0;0;0
5312;Murder by Numbers;264935;0;0;0;0;0;0;0;0;0;0;0;0;0
5313;The Scorpion King;277296;4.9;130;52;78;40;4.5;27;8;19;29;2.9;30398;53
5314;Abril Despedaçado;291003;6.7;46;34;12;73;6.7;18;13;5;72;3.9;968;86
5315;Chelsea Walls;226935;4.1;46;12;34;26;4.5;15;5;10;33;3;515;43
5316;Enigma;157583;6.6;104;75;29;72;6.8;29;22;7;75;3.2;2061;52
5317;Les filles ne savent pas nager;239507;5.9;34;24;10;70;6.5;14;11;3;78;2.9;255;37
5318;Joshua;808331;6.3;97;61;36;62;6.9;31;24;7;77;2.9;13913;40
5319;Nueve reinas;247586;7.5;91;84;7;92;8;27;26;1;96;4.2;4937;93
5321;The Triumph of Love;253840;5.5;70;33;37;47;5.7;27;13;14;48;3.1;452;49
5322;World Traveler;262911;4.9;66;23;43;34;4.8;23;8;15;34;2.8;516;26
5323;Jason X;211443;3.6;101;21;80;20;3.1;20;2;18;10;2.5;10745;38
5324;Life or Something Like It;282687;4.5;117;32;85;27;4.4;30;7;23;23;2.8;6498;48
5325;Dogtown and Z-Boys;275309;7.5;93;85;8;91;7.5;29;27;2;93;3.9;3418;86
5326;Frank McKlusky, C.I.;281865;0;3;0;3;0;0;0;0;0;0;0;0;0
5327;Éloge de l'amour;181912;5.7;72;37;35;51;6.1;26;15;11;57;3.4;600;59
5328;Singin' in the Rain;45152;9.2;44;44;0;100;8.8;9;9;0;100;3.9;28033;91
5329;The Salton Sea;235737;5.8;84;53;31;63;5.5;25;14;11;56;3.7;4972;81
5331;Vulgar;120467;3.2;26;6;20;23;2.2;7;1;6;14;2.8;944;40
5332;The Aviator;338751;7.8;212;185;27;87;7.5;44;36;8;81;3.4;27084;73
5333;Bob le flambeur;47892;8.1;29;28;1;96;7.2;6;5;1;83;4;1464;88
5334;Cadillac Man;99204;5.3;10;5;5;50;0;2;1;1;50;2.7;1895;29
5335;The Coca-Cola Kid;88931;5.1;16;7;9;43;0;4;1;3;25;2.9;374;35
5336;Soy Cuba;58604;8.6;31;31;0;100;8.9;7;7;0;100;4.2;1082;91
5337;Delirious;412637;6.8;56;47;9;83;6.9;20;17;3;85;3.2;2792;52
5338;Full Moon in Blue Water;95186;4.2;6;1;5;16;0;1;0;1;0;2.9;281;30
5339;Husbands and Wives;104466;8.3;35;35;0;100;7.9;9;9;0;100;3.8;3905;83
5340;G.I. Joe: The Rise of Cobra;1046173;4.6;153;52;101;33;3.8;25;6;19;24;3.3;302453;62
5341;Lenny;71746;8.1;16;16;0;100;0;0;0;0;0;0;0;0
5342;Nomads;720339;\N;\N;\N;\N;\N;\N;\N;\N;\N;\N;\N;\N;\N
5343;The Temp;108311;4;19;6;13;31;0;4;0;4;0;2.6;338;16
5344;Thief of Hearts;88256;3.2;6;0;6;0;0;0;0;0;0;0;0;0
5345;Triumph of the Spirit;98513;4.9;6;3;3;50;0;1;0;1;0;3.2;317;53
5346;Wild Orchid;100934;3;13;1;12;7;0;1;0;1;0;0;0;0
5347;Deuces Wild;231448;2.9;65;2;63;3;2.9;17;0;17;0;3;2133;52
5348;Hollywood Ending;278823;5.4;130;60;70;46;5.3;35;13;22;37;3.2;3322;50
5349;Spider-Man;145487;0;0;0;0;0;0;0;0;0;0;0;0;0
5350;The Mystic Masseur;282771;5.8;64;33;31;51;6.1;23;14;9;60;3;60;36
5351;Akai hashi no shita no nurui mizu;289054;6.9;42;33;9;78;6.6;10;7;3;70;3.6;563;72
5352;The Big Sleep;38355;8.6;43;41;2;95;7.5;8;7;1;87;4.1;7772;91
5353;Butterflies Are Free;68326;6.1;7;5;2;71;0;0;0;0;0;0;0;0
5354;Cactus Flower;64117;7.1;10;10;0;100;0;1;1;0;100;3.6;1005;73
5355;The Cassandra Crossing;74292;4.9;7;2;5;28;0;0;0;0;0;0;0;0
5356;The Giant Spider Invasion;73043;0;1;0;1;0;0;0;0;0;0;0;0;0
5357;Iron Will;110157;5.8;12;7;5;58;0;2;0;2;0;3.1;3444;61
5358;Mountains of the Moon;100196;6.6;12;9;3;75;0;2;1;1;50;3.7;432;74
5359;Rambling Rose;102753;7.2;17;17;0;100;7.4;5;5;0;100;3;541;40
5360;Soul Survivors;218619;2.6;47;2;45;4;2.3;11;0;11;0;2.6;2441;34
5361;White Fang;103247;5.9;18;12;6;66;0;4;3;1;75;3.1;4170;62
5362;White Fang 2: Myth of the White Wolf;111701;6.4;6;4;2;66;0;2;2;0;100;3.2;1366;56
5363;The New Guy;241760;3.1;91;6;85;6;3.5;22;3;19;13;3;9884;60
5364;Unfaithful;250797;5.7;159;77;82;48;5.8;35;16;19;45;3.3;12656;70
5365;L'anglaise et le duc;239234;6.6;70;50;20;71;7;25;21;4;84;3.4;337;55
5366;Whore;1210120;0;1;0;1;0;0;0;0;0;0;0;0;0
5367;My Beautiful Laundrette;91578;8.1;18;18;0;100;0;1;1;0;100;3.7;1973;75
5368;Ballada o soldate;52600;8.5;12;12;0;100;0;1;1;0;100;4.2;814;91
5369;Big Bad Mama;71216;5.5;11;7;4;63;0;0;0;0;0;0;0;0
5370;Big Bad Mama II;92652;0;0;0;0;0;0;0;0;0;0;0;0;0
5371;Buio Omega;78916;0;0;0;0;0;0;0;0;0;0;0;0;0
5372;Calamity Jane;45591;5.7;9;6;3;66;0;0;0;0;0;0;0;0
5373;Letyat zhuravli;50634;8.1;17;16;1;94;0;2;1;1;50;4.2;1056;93
5374;The Devil-Doll;27521;0;0;0;0;0;0;0;0;0;0;0;0;0
5375;The Harvey Girls;38589;7.5;6;6;0;100;0;0;0;0;0;0;0;0
5376;The Lady in Red;79429;0;2;1;1;50;0;0;0;0;0;0;0;0
5377;About a Boy;276751;7.7;159;148;11;93;7.5;35;32;3;91;2.8;137687;51
5378;Star Wars: Episode II - Attack of the Clones;121765;6.5;215;142;73;66;5.5;40;16;24;40;3.3;108730;69
5379;Believers;878652;0;3;0;3;0;0;0;0;0;0;0;0;0
5380;The Importance of Being Earnest;278500;\N;\N;\N;\N;\N;\N;\N;\N;\N;\N;\N;\N;\N
5381;The Charge of the Light Brigade;62790;0;0;0;0;0;0;0;0;0;0;0;0;0
5382;Every Which Way But Loose;77523;4.5;13;4;9;30;0;0;0;0;0;0;0;0
5383;The Hound of the Baskervilles;52905;7.8;11;11;0;100;0;0;0;0;0;0;0;0
5384;I Want to Live!;51758;7.9;11;11;0;100;0;0;0;0;0;0;0;0
5385;The Last Waltz;77838;8.4;39;38;1;97;8.1;12;11;1;91;4.3;3891;92
5386;The Pride and the Passion;50858;4.8;7;1;6;14;0;1;1;0;100;3;672;35
5387;Enough;278435;4;121;26;95;21;3.9;30;5;25;16;3.1;15185;71
5388;Insomnia;278504;7.7;166;153;13;92;7.8;33;31;2;93;3.2;18085;66
5389;Spirit: Stallion of the Cimarron;166813;6.4;125;86;39;68;6.9;29;23;6;79;3.3;8302;72
5390;CQ;254199;6.2;73;48;25;65;5.8;22;14;8;63;3.4;1171;66
5391;Thirteen Conversations About One Thing;268690;7.4;108;89;19;82;6.9;25;19;6;76;3.4;2120;65
5392;Bus Stop;49038;7.6;10;9;1;90;0;0;0;0;0;0;0;0
5393;Midnight Cowboy;64665;8.3;49;44;5;89;6.8;6;5;1;83;3.9;8994;87
5394;Don't Bother to Knock;44557;6.8;7;7;0;100;0;0;0;0;0;0;0;0
5395;Dr. Mabuse, der Spieler - Ein Bild der Zeit;13086;7.4;11;10;1;90;0;1;0;1;0;4.1;721;90
5396;Let's Make Love;54022;5.5;11;7;4;63;0;0;0;0;0;0;0;0
5397;Monkey Business;22158;7.8;12;11;1;91;0;0;0;0;0;0;0;0
5398;Requiem for a Heavyweight;56406;7.6;8;7;1;87;0;0;0;0;0;0;0;0
5399;River of No Return;47422;5.8;13;8;5;61;0;3;3;0;100;3.4;1421;59
5400;The Sum of All Fears;164184;6;166;98;68;59;5.6;35;16;19;45;3;11603;53
5401;Undercover Brother;279493;6.6;126;96;30;76;6.1;24;17;7;70;2.8;7732;60
5402;The Diaries of Vaslav Nijinsky;295480;0;0;0;0;0;0;0;0;0;0;0;0;0
5403;The Sleepy Time Gal;277322;6.9;19;15;4;78;7.5;7;6;1;85;3.3;174;45
5404;84 Charing Cross Road;90570;7.4;15;12;3;80;0;2;0;2;0;3.7;1344;76
5405;Dakota;37627;0;2;0;2;0;0;0;0;0;0;0;0;0
5406;The Desert Rats;45679;6.3;5;4;1;80;0;0;0;0;0;0;0;0
5407;La bûche;211286;6.4;20;14;6;70;6.6;7;5;2;71;3.4;364;60
5408;Nora inu;41699;7.4;15;14;1;93;0;0;0;0;0;0;0;0
5409;Rapid Fire;105219;4.7;14;4;10;28;0;4;0;4;0;3.1;3041;51
5410;Silent Running;67756;6.6;25;17;8;68;0;4;3;1;75;3.5;2762;69
5411;Summer Holiday;57541;0;1;0;1;0;0;0;0;0;0;0;0;0
5412;The Villain;80097;3.7;7;0;7;0;0;0;0;0;0;0;0;0
5413;Zombi Holocaust;79788;0;2;0;2;0;0;0;0;0;0;0;0;0
5414;Bad Company;280486;3.9;134;14;120;10;4;31;5;26;16;2.8;6415;42
5415;Divine Secrets of the Ya-Ya Sisterhood;279778;5.3;142;62;80;43;5.3;34;17;17;50;3.2;12363;63
5416;Cherish;298798;5.7;76;36;40;47;5.8;23;11;12;47;3.4;572;60
5417;Atanarjuat;285441;8;94;85;9;90;8.5;26;25;1;96;3.8;1275;80
5418;The Bourne Identity;258463;7;180;148;32;82;6.9;37;30;7;81;3.9;125823;91
5419;Scooby-Doo;267913;4.4;138;39;99;28;4.8;29;12;17;41;2.7;20362;49
5420;Windtalkers;245562;5.1;164;53;111;32;5.3;37;13;24;35;3.2;15905;57
5421;The Dangerous Lives of Altar Boys;238924;0;0;0;0;0;0;0;0;0;0;0;0;0
5422;The Emperor's New Clothes;282768;6.6;84;62;22;73;6.6;26;19;7;73;3.4;293;61
5423;Gangster No. 1;210065;6.4;51;37;14;72;6.3;12;8;4;66;3.7;2271;76
5424;Harvard Man;242508;4.6;36;12;24;33;5.3;14;6;8;42;2.7;1487;34
5425;Tmavomodrý svet;244479;6.2;58;36;22;62;6.5;20;13;7;65;3.8;719;82
5426;Bad Company;280486;3.9;134;14;120;10;4;31;5;26;16;2.8;6415;42
5427;Caveman;82146;4.1;15;3;12;20;0;2;1;1;50;3;1935;52
5428;Cheech & Chong's The Corsican Brothers;87042;0;1;0;1;0;0;0;0;0;0;0;0;0
5429;5 Card Stud;62626;0;1;1;0;100;0;1;1;0;100;3.3;527;55
5431;Goin' South;77621;6.6;10;9;1;90;0;0;0;0;0;0;0;0
5432;Hero and the Terror;95296;3.6;5;0;5;0;0;1;0;1;0;2.9;782;45
5433;Silver Bullet;90021;5.2;14;7;7;50;0;1;1;0;100;3.2;3559;59
5434;Sorry, Wrong Number;40823;6.8;21;18;3;85;0;3;1;2;33;3.6;1027;78
5435;Pirates of the Caribbean: Dead Man's Chest;383574;6;217;117;100;53;5.2;39;16;23;41;3.9;395865;86
5436;The Horse's Mouth;51739;7.5;14;13;1;92;0;0;0;0;0;0;0;0
5437;The Manhattan Project;91472;5.5;17;8;9;47;0;1;1;0;100;3;744;47
5438;Men at Work;100135;4.2;22;7;15;31;0;4;2;2;50;2.7;3778;43
5439;S.O.B.;83015;7.1;14;14;0;100;0;0;0;0;0;0;0;0
5440;She Wore a Yellow Ribbon;41866;8.3;14;14;0;100;0;0;0;0;0;0;0;0
5441;Traces of Red;105631;3.5;6;1;5;16;0;2;1;1;50;3;197;35
5442;V.I. Warshawski;103184;3.6;20;4;16;20;0;2;1;1;50;2.4;698;25
5443;Juwanna Mann;247444;3.2;82;7;75;8;3.2;24;2;22;8;2.5;1219;46
5444;Lilo & Stitch;275847;7.3;144;123;21;85;7.2;29;22;7;75;3.2;36598;65
5445;Minority Report;181689;8;222;203;19;91;7.9;38;34;4;89;3.4;69660;74
5446;Rabbit-Proof Fence;252444;7.6;133;116;17;87;7.6;29;25;4;86;3.8;5026;85
5447;Sunshine State;286179;7;106;85;21;80;7;29;23;6;79;3.1;607;50
5448;Hey Arnold! The Movie;314166;4.6;76;23;53;30;4.7;19;6;13;31;2.8;2763;37
5449;Mr. Deeds;280590;4;153;33;120;21;3.6;30;5;25;16;3.3;69840;68
5450;Lovely & Amazing;258273;7.3;119;102;17;85;7.3;28;25;3;89;3.4;1223;62
5451;Pumpkin;265591;4.9;71;27;44;38;5.3;23;10;13;43;3.2;2927;56
5452;Look Who's Talking Now;107438;2.5;23;0;23;0;3.2;6;0;6;0;2.5;9093;41
5453;Lost in Yonkers;107443;5.8;16;11;5;68;0;3;1;2;33;3.4;491;70
5454;Mo' Money;104897;4;22;3;19;13;0;4;1;3;25;2.9;1450;51
5455;The Object of Beauty;102573;6.1;12;9;3;75;0;2;2;0;100;2.9;442;29
5456;Wagons East;111653;1.8;10;0;10;0;0;2;0;2;0;2.5;1055;33
5457;Zebrahead;105885;6.1;14;10;4;71;0;4;3;1;75;3.3;221;62
5458;Like Mike;308506;5.5;96;54;42;56;5.7;28;13;15;46;2.8;7917;55
5459;Men in Black II;120912;5.2;187;72;115;38;5.5;34;14;20;41;3.1;54446;57
5460;The Powerpuff Girls;289408;6.1;99;63;36;63;6.2;24;17;7;70;3.1;2190;53
5461;Me Without You;263725;6.2;65;43;22;66;6.3;22;16;6;72;3.8;1522;78
5462;The Crocodile Hunter: Collision Course;305396;5.2;81;42;39;51;5.7;20;12;8;60;2.8;4549;51
5463;Reign of Fire;253556;5.2;149;59;90;39;4.7;31;13;18;41;3;15531;55
5464;Road to Perdition;257044;7.5;205;169;36;82;7.1;37;29;8;78;3.5;23335;81
5465;Riri Shushu no subete;297721;6.7;37;25;12;67;7.3;11;8;3;72;4.1;2372;88
5466;Ma femme est une actrice;269499;6.2;72;47;25;65;6.7;23;17;6;73;3.4;747;66
5467;Never Say Never Again;86006;5.9;34;22;12;64;6.2;5;3;2;60;3.1;7414;48
5468;20 Million Miles to Earth;50084;6.4;8;7;1;87;0;0;0;0;0;0;0;0
5469;Grand Theft Auto;76100;4.8;11;3;8;27;0;0;0;0;0;0;0;0
5470;The Importance of Being Earnest;278500;\N;\N;\N;\N;\N;\N;\N;\N;\N;\N;\N;\N;\N
5471;A Perfect Getaway;971209;5.8;124;76;48;61;5.9;29;18;11;62;3.2;102622;50
5472;1776;68156;6.8;14;8;6;57;0;1;0;1;0;3.8;2415;80
5473;Faustrecht der Freiheit;72976;7.8;15;13;2;86;0;3;2;1;66;0;0;0
5474;The Legend of Boggy Creek;68837;0;0;0;0;0;0;0;0;0;0;0;0;0
5475;Dragon Ball Z;214341;\N;\N;\N;\N;\N;\N;\N;\N;\N;\N;\N;\N;\N
5476;Halloween: Resurrection;220506;3.4;57;6;51;10;3.4;16;2;14;12;2.8;14228;46
5477;Lucía y el sexo;254455;6.5;69;49;20;71;5.8;20;12;8;60;3.9;6145;85
5478;Eight Legged Freaks;271367;5.5;140;66;74;47;5;25;9;16;36;2.5;10925;36
5479;K-19: The Widowmaker;267626;6.1;165;100;65;60;6.3;33;21;12;63;3;6024;50
5480;Stuart Little 2;243585;6.9;114;95;19;83;6.9;29;26;3;89;2.7;10893;44
5481;Austin Powers in Goldmember;295178;5.8;179;97;82;54;5.8;37;22;15;59;3;145625;47
5482;The Country Bears;276033;4.3;77;21;56;27;4.2;21;4;17;19;2.7;2600;39
5483;The Kid Stays in the Picture;303353;0;0;0;0;0;0;0;0;0;0;0;0;0
5484;Xingfu shiguang;303243;6.4;60;43;17;71;6.7;20;16;4;80;3.7;927;76
5485;Tadpole;271219;6.7;104;81;23;77;6.7;31;24;7;77;3.2;888;56
5486;Who Is Cletis Tout?;246500;4.3;55;13;42;23;4.4;20;6;14;30;3.1;596;48
5487;Harry and Walter Go to New York;74608;5.9;7;4;3;57;0;1;0;1;0;3.3;105;44
5488;Händler der vier Jahreszeiten;67227;7.9;12;11;1;91;0;2;1;1;50;0;0;0
5489;Nosferatu: Phantom der Nacht;79641;7.6;34;32;2;94;0;4;4;0;100;3.7;5091;81
5490;The Big Bus;74205;5.9;5;3;2;60;0;0;0;0;0;0;0;0
5491;The Eddy Duchin Story;49170;0;2;0;2;0;0;0;0;0;0;0;0;0
5492;Fathom;61653;5;5;2;3;40;0;0;0;0;0;0;0;0
5493;In Like Flint;61810;6.2;15;11;4;73;0;1;0;1;0;3.3;618;53
5494;La terra trema: Episodio del mare;40866;8.5;6;6;0;100;0;0;0;0;0;0;0;0
5495;Modesty Blaise;60708;0;4;1;3;25;0;0;0;0;0;0;0;0
5496;Ossessione;35160;8.2;9;9;0;100;0;2;2;0;100;3.9;583;83
5497;Our Man Flint;59557;6.6;18;15;3;83;0;0;0;0;0;0;0;0
5498;Akahige;58888;7.8;11;9;2;81;0;2;2;0;100;4.3;2413;94
5499;The Adventures of Robin Hood;29843;8.9;43;43;0;100;8.6;7;7;0;100;3.7;6404;84
5500;Top Secret!;88286;6.4;25;19;6;76;0;1;1;0;100;3.4;8375;77
5501;The Master of Disguise;295427;2.2;97;2;95;2;2.2;26;0;26;0;2.3;6303;39
5502;Signs;286106;6.8;223;164;59;73;5.9;39;22;17;56;3.2;63081;65
5503;L'ultimo bacio;265930;6.4;78;57;21;73;6.4;25;17;8;68;3.8;2248;77
5504;Spy Kids 2: Island of Lost Dreams;287717;6.6;127;95;32;74;6.7;30;23;7;76;2.6;12329;43
5505;The Good Girl;279113;0;0;0;0;0;0;0;0;0;0;0;0;0
5506;Blood Work;309377;5.6;147;79;68;53;6.3;34;24;10;70;3;4504;42
5507;xXx;295701;5.6;174;83;91;47;5;32;11;21;34;3.2;47523;69
5508;24 Hour Party People;274309;0;0;0;0;0;0;0;0;0;0;0;0;0
5509;Biggie and Tupac;303356;6.7;47;38;9;80;5.9;15;10;5;66;3.8;1434;79
5510;The Château;283288;5.3;52;26;26;50;5;15;6;9;40;2.7;261;28
5511;Die Büchse der Pandora;18737;8.5;23;21;2;91;8.1;8;6;2;75;4.1;1316;88
5512;Raye makhfi;290823;7;57;47;10;82;6.8;16;13;3;81;3.4;349;62
5513;Martin Lawrence Live: Runteldat;327036;5;56;21;35;37;5.6;22;11;11;50;3.8;23;71
5514;Lan yu;292066;6.2;34;22;12;64;6.1;13;8;5;61;3.9;584;83
5515;Sånger från andra våningen;120263;7.4;33;29;4;87;8;11;11;0;100;4.2;2079;90
5516;Sur mes lèvres;274117;7.8;95;92;3;96;8.1;26;25;1;96;3.8;1495;81
5517;Merci pour le chocolat;232083;7.2;50;42;8;84;7.8;15;15;0;100;3.5;668;64
5518;Beau-père;82054;6.6;5;4;1;80;0;1;1;0;100;3.5;254;73
5519;Change of Habit;65537;4;10;1;9;10;0;0;0;0;0;0;0;0
5520;Une affaire de goût;217119;0;0;0;0;0;0;0;0;0;0;0;0;0
5521;Lean on Me;97722;5.8;14;9;5;64;0;1;0;1;0;3.7;5235;86
5522;Rollerball;73631;6;25;17;8;68;0;4;1;3;25;3.2;2655;61
5523;The Adventures of Pluto Nash;180052;2.7;72;4;68;5;2.2;13;0;13;0;2;3816;20
5524;Blue Crush;300532;5;78;27;51;34;5;24;8;16;33;3.2;804;58
5525;Bella Martha;246772;7.2;82;75;7;91;7;25;22;3;88;4;2477;88
5526;Seom;255589;6.2;32;24;8;75;7;8;7;1;87;3.7;1897;73
5527;Possession;368563;0;2;0;2;0;0;1;0;1;0;2.9;4231;34
5528;One Hour Photo;265459;0;0;0;0;0;0;0;0;0;0;0;0;0
5529;Serving Sara;261289;3;105;5;100;4;3.1;24;2;22;8;2.4;2909;31
5530;S1m0ne;258153;5.8;154;78;76;50;5;34;12;22;35;2.8;2552;33
5531;Undisputed;281322;5.5;103;50;53;48;6.1;29;19;10;65;3.2;2298;56
5532;Amy's Orgasm;280424;4.4;30;8;22;26;5.4;8;4;4;50;2.8;555;33
5533;Children on Their Birthdays;283991;0;3;0;3;0;0;1;0;1;0;3.3;281;57
5534;Hush;118744;3.4;37;4;33;10;3.2;8;0;8;0;2.9;1448;43
5535;Comment j'ai tué mon père;268219;0;0;0;0;0;0;0;0;0;0;0;0;0
5537;Satin rouge;300453;6.9;47;39;8;82;7.1;19;17;2;89;3.5;291;64
5538;The Care Bears Movie;88885;0;0;0;0;0;0;0;0;0;0;0;0;0
5539;Care Bears Movie II: A New Generation;90799;0;0;0;0;0;0;0;0;0;0;0;0;0
5540;Clash of the Titans;82186;5.8;37;24;13;64;0;2;1;1;50;3.4;10585;70
5541;Hot Shots!;102059;6.5;22;18;4;81;0;1;1;0;100;3;14175;63
5542;Nightmare City 2035;910868;0;0;0;0;0;0;0;0;0;0;0;0;0
5543;Shark Swarm;1078927;0;1;0;1;0;0;0;0;0;0;0;0;0
5544;Time After Time;80025;7.2;28;24;4;85;0;4;3;1;75;3.5;1546;68
5545;The Unearthly;51134;0;2;1;1;50;0;0;0;0;0;0;0;0
5546;976-Evil II;101256;0;0;0;0;0;0;0;0;0;0;0;0;0
5547;Camilla;109368;5.2;5;2;3;40;0;2;0;2;0;3;598;31
5548;Down and Out in Beverly Hills;90966;6.8;24;20;4;83;0;4;3;1;75;2.9;2039;49
5549;Flaming Star;53825;7.3;10;9;1;90;0;0;0;0;0;0;0;0
5550;Love Me Tender;49452;5.4;8;3;5;37;0;0;0;0;0;0;0;0
5551;The Return of the Vampire;37219;5.3;5;3;2;60;0;0;0;0;0;0;0;0
5552;The Revenge of Frankenstein;50894;6.2;7;6;1;85;0;0;0;0;0;0;0;0
5553;Stakeout;94025;6.5;18;15;3;83;0;1;1;0;100;2.9;2040;50
5554;Wild in the Country;55623;5.8;8;4;4;50;0;0;0;0;0;0;0;0
5555;Wolfen;83336;5.8;22;16;6;72;0;1;1;0;100;3;988;45
5556;FeardotCom;295254;2.6;87;3;84;3;3;15;0;15;0;2.3;7455;28
5557;Slap Her... She's French;187512;4.7;25;9;16;36;0;2;0;2;0;2.9;1785;45
5558;Love and a Bullet;235553;0;2;0;2;0;0;0;0;0;0;0;0;0
5559;Juana la Loca;270480;5.3;49;23;26;46;5.6;14;6;8;42;3.6;465;67
5560;À nous la liberté;22599;8.3;16;16;0;100;0;2;2;0;100;3.7;914;76
5561;True Colors;103125;5;14;7;7;50;0;4;0;4;0;3;876;47
5562;Blade;120611;5.7;83;46;37;55;4.6;24;7;17;29;3.6;87683;78
5563;City by the Sea;269095;5.8;140;67;73;47;5.8;33;17;16;51;2.9;3070;41
5564;Swimfan;283026;3.9;89;13;76;14;4.3;16;4;12;25;2.5;5068;38
5567;Incubus;462359;0;3;0;3;0;0;0;0;0;0;0;0;0
5568;Johnny Dangerously;87507;5;15;7;8;46;0;1;0;1;0;3.2;1967;60
5569;The Last House on the Left;844708;4.9;143;60;83;41;4.5;29;12;17;41;2.7;137767;55
5570;Tesis;117883;6.8;7;5;2;71;0;0;0;0;0;0;0;0
5572;Barbershop 2: Back in Business;337579;6.3;123;84;39;68;6.4;34;23;11;67;3.1;7601;58
5573;Stealing Harvard;265808;3.2;102;8;94;7;3.2;25;1;24;4;2.7;2451;42
5574;The Transporter;293662;5.6;122;65;57;53;5.1;28;13;15;46;3.5;52782;78
5575;Betty Fisher et autres histoires;269329;7.2;51;47;4;92;7.3;19;18;1;94;3.4;366;57
5576;Les enfants du siècle;177746;5.2;42;18;24;42;5.4;12;5;7;41;3.6;422;71
5577;Igby Goes Down;280760;6.9;126;96;30;76;6.9;32;24;8;75;3.4;8640;77
5580;Aspen Extreme;106315;3.8;9;2;7;22;0;1;0;1;0;2.9;1218;51
5581;Betsy's Wedding;99128;5.3;7;3;4;42;0;2;1;1;50;2.8;904;41
5582;Captain Ron;103924;4.2;13;3;10;23;0;2;0;2;0;2.7;4124;44
5583;The Devil Bat;32390;5.6;9;5;4;55;0;0;0;0;0;0;0;0
5584;Ernest Goes to Jail;99512;3.8;8;1;7;12;0;0;0;0;0;0;0;0
5585;Ernest Scared Stupid;101821;3.2;5;1;4;20;0;0;0;0;0;0;0;0
5586;The Gypsy Moths;64397;0;0;0;0;0;0;0;0;0;0;0;0;0
5587;The Hills Have Eyes II;800069;3.2;64;7;57;10;3.6;16;2;14;12;2.9;63799;50
5588;The Hills Have Eyes;454841;5.3;133;65;68;48;5;30;12;18;40;3.1;75042;64
5589;Indian Summer;116631;6.7;6;5;1;83;0;2;2;0;100;3.2;492;45
5590;The Mack;70350;0;3;2;1;66;0;0;0;0;0;0;0;0
5591;Monkey Trouble;110557;5.6;11;6;5;54;0;2;2;0;100;2.5;2170;39
5592;Monster in the Closet;91544;0;1;0;1;0;0;0;0;0;0;0;0;0
5593;No Way to Treat a Lady;63356;7.8;9;8;1;88;0;0;0;0;0;0;0;0
5595;Shock Waves;76704;0;2;2;0;100;0;0;0;0;0;0;0;0
5596;Spaced Invaders;100666;3.3;11;1;10;9;0;2;0;2;0;2.7;834;43
5597;Suburban Commando;103003;3.7;10;2;8;20;0;1;0;1;0;2.3;2563;31
5598;Surf Ninjas;108258;3.3;12;1;11;8;0;4;1;3;25;3.1;2874;64
5599;Tabu: A Story of the South Seas;22458;8.2;8;8;0;100;0;2;2;0;100;3.8;448;76
5600;The Wanderers;80117;6.8;17;15;2;88;0;0;0;0;0;0;0;0
5601;The Yearling;39111;8.4;11;11;0;100;0;0;0;0;0;0;0;0
5602;The Ladykillers;335245;6.1;185;101;84;54;5.8;39;18;21;46;2.8;12107;40
5603;The Lavender Hill Mob;44829;8.2;18;18;0;100;0;0;0;0;0;0;0;0
5604;The Man in the White Suit;44876;8.4;8;8;0;100;0;0;0;0;0;0;0;0
5605;Ratcatcher;171685;\N;\N;\N;\N;\N;\N;\N;\N;\N;\N;\N;\N;\N
5606;Society;98354;5.2;7;3;4;42;0;0;0;0;0;0;0;0
5607;El hijo de la novia;292542;7.3;57;49;8;85;6.8;18;13;5;72;4.2;1942;91
5608;Das Experiment;250258;6.6;64;46;18;71;5.9;19;10;9;52;3.9;5538;88
5609;Ballistic: Ecks vs. Sever;308208;2.6;108;0;108;0;2.4;28;0;28;0;2.2;3969;25
5610;The Banger Sisters;280460;5.3;140;66;74;47;5.1;34;14;20;41;2.7;4139;45
5611;The Four Feathers;240510;5.4;149;61;88;40;5.6;32;13;19;40;3.2;6862;65
5612;Trapped;280380;4.1;56;10;46;17;4;12;2;10;16;3.1;4086;56
5613;8 femmes;283832;6.9;111;87;24;78;6.8;30;24;6;80;3.6;5397;74
5614;Le fate ignoranti;274497;6.5;34;25;9;73;6.9;13;11;2;84;4.1;1356;89
5615;Invincible;445990;6.4;132;94;38;71;6.2;32;19;13;59;3.6;34698;75
5616;The Mesmerist;272730;0;2;0;2;0;0;0;0;0;0;0;0;0
5617;Secretary;274812;6.7;140;104;36;74;6.5;30;22;8;73;3.7;16511;84
5618;Sen to Chihiro no kamikakushi;245429;8.5;154;150;4;97;8.7;31;31;0;100;4.1;72315;95
5619;The Trials of Henry Kissinger;326306;7.2;57;54;3;94;7.8;17;17;0;100;3.6;328;74
5620;Sweet Home Alabama;256415;5.2;154;57;97;37;5.1;33;13;20;39;3.3;82825;77
5621;The Tuxedo;290095;4.4;136;30;106;22;4.1;28;3;25;10;2.6;12285;43
5622;Charlie and the Chocolate Factory;367594;0;0;0;0;0;0;0;0;0;0;0;0;0
5623;Crazy as Hell;285487;5.3;14;7;7;50;4.6;5;2;3;40;3.2;275;55
5624;Ae Fond Kiss...;380366;7.4;24;21;3;87;0;4;4;0;100;3.7;1269;73
5625;Moonlight Mile;179098;6.4;145;90;55;62;6.2;33;18;15;54;3.4;3000;64
5626;Shanghai Ghetto;318068;6.8;44;36;8;81;6.7;21;18;3;85;3.6;181;67
5627;Skins;284494;5.9;58;34;24;58;5.6;19;10;9;52;4.1;578;86
5628;Wasabi;281364;5.1;42;18;24;42;5.5;13;7;6;53;3.5;3717;69
5629;Jonah: A VeggieTales Movie;298388;5.8;54;35;19;64;6.1;18;14;4;77;3.4;4629;70
5630;Red Dragon;289765;6.4;183;125;58;68;5.9;35;19;16;54;3.4;39977;74
5631;Between Strangers;289668;4.3;8;2;6;25;0;2;0;2;0;3.3;164;52
5632;Bloody Sunday;280491;7.9;102;94;8;92;8.2;30;28;2;93;4;2812;89
5633;Heaven;246677;6.7;86;63;23;73;6.4;25;17;8;68;3.7;3048;77
5634;Pipe Dream;164810;6.4;18;13;5;72;6.6;7;5;2;71;2.8;194;26
5635;The Man from Elysian Fields;265307;5.9;70;36;34;51;5.6;25;11;14;44;3.3;426;54
5636;Welcome to Collinwood;271259;5.9;64;34;30;53;6;22;11;11;50;3.2;1767;54
5637;Flirting with Disaster;116324;7.4;42;36;6;85;8.5;6;6;0;100;3.3;2127;65
5638;Mosura tai Gojira;58379;6.7;9;8;1;88;0;0;0;0;0;0;0;0
5639;Gojira-Minira-Gabara: Oru kaijû daishingeki;64373;4.8;6;2;4;33;0;1;0;1;0;2.7;774;30
5640;Godzilla, King of the Monsters!;197521;6.9;20;16;4;80;0;3;2;1;66;3.6;2215;73
5641;Modern Times;27977;8.9;47;47;0;100;8.2;11;11;0;100;4.2;9563;95
5642;The Onion Field;79668;8.2;5;5;0;100;0;0;0;0;0;0;0;0
5643;Powaqqatsi;95895;6.8;8;5;3;62;0;1;0;1;0;3.9;1251;83
5644;The Pride of the Yankees;35211;7.4;20;18;2;90;0;3;3;0;100;3.9;1471;88
5645;Texasville;103069;5.6;21;12;9;57;4.5;5;2;3;40;2.9;302;45
5646;Dangerous Liaisons;94947;7.7;27;25;2;92;6.5;6;5;1;83;3.7;11359;84
5647;Ernest Goes to Africa;119068;0;0;0;0;0;0;0;0;0;0;0;0;0
5648;Ernest in the Army;129908;3;6;1;5;16;0;0;0;0;0;0;0;0
5649;Dracula;51554;7.5;27;24;3;88;0;3;2;1;66;3.6;3118;73
5650;The Adventures of Bob & Doug McKenzie: Strange Brew;86373;6.5;20;14;6;70;0;1;0;1;0;3.4;4156;80
5651;The Incredible Mr. Limpet;58230;5.3;7;3;4;42;0;0;0;0;0;0;0;0
5652;Claire of the Moon;103977;\N;\N;\N;\N;\N;\N;\N;\N;\N;\N;\N;\N;\N
5653;Sukiyaki Western Django;906665;5.7;49;28;21;57;5.2;10;4;6;40;3.4;5732;59
5654;Django 2: il grande ritorno;93113;\N;\N;\N;\N;\N;\N;\N;\N;\N;\N;\N;\N;\N
5655;The Fan;116277;4.8;25;10;15;40;5.3;5;2;3;40;2.8;5593;37
5656;Festival in Cannes;273607;6.1;54;35;19;64;6;20;12;8;60;2.8;203;32
5657;Flashback;99581;4.9;13;5;8;38;0;1;1;0;100;3;804;54
5658;Hanky Panky;84049;4.8;8;3;5;37;0;0;0;0;0;0;0;0
5659;The Rocking Horse Winner;42898;7.7;6;5;1;83;0;0;0;0;0;0;0;0
5660;Seance on a Wet Afternoon;58557;7.2;9;7;2;77;0;0;0;0;0;0;0;0
5661;Shamus;70680;5;7;3;4;42;0;1;0;1;0;3;301;34
5662;The Wrong Guy;120536;0;3;0;3;0;0;1;0;1;0;3.6;826;81
5663;Eight Below;397313;6.5;139;99;40;71;6.1;31;16;15;51;3.4;27593;80
5664;Brown Sugar;297037;6.2;84;54;30;64;6.5;28;20;8;71;3.8;11172;88
5665;Knockaround Guys;211465;4.3;97;19;78;19;4.2;25;4;21;16;3.1;4913;58
5666;The Rules of Attraction;292644;5.3;134;59;75;44;4.9;27;9;18;33;3.2;10253;71
5667;Tuck Everlasting;283084;6.3;114;69;45;60;6.2;28;16;12;57;3.3;22077;66
5668;White Oleander;283139;6.5;131;91;40;69;6;31;18;13;58;3.5;9063;79
5669;Bowling for Columbine;310793;8.2;160;154;6;96;7.7;30;28;2;93;3.5;24080;81
5670;Comedian;328962;6.8;88;67;21;76;6.9;27;22;5;81;3.4;1389;66
5671;Le bossu;118756;7;30;26;4;86;7;14;12;2;85;3.7;406;70
5672;Pokémon 4Ever;313487;3.5;36;5;31;13;3.1;16;1;15;6;3.2;4367;58
5673;Punch-Drunk Love;272338;7.4;179;141;38;78;7.4;36;29;7;80;3.2;24379;72
5675;Swept Away;291502;2.8;77;4;73;5;3;28;4;24;14;2.2;2205;28
5676;The Young Unknowns;186719;4;28;3;25;10;4;12;2;10;16;2.6;115;33
5677;Abandon;267248;4.3;109;18;91;16;4.1;26;6;20;23;2.7;2670;37
5678;The 51st State;227984;4.3;101;26;75;25;3.9;27;5;22;18;3.1;5566;61
5679;The Ring;298130;6.6;169;120;49;71;6.3;32;18;14;56;3;146246;50
5680;Auto Focus;298744;6.7;155;112;43;72;6.9;37;28;9;75;3.2;1283;56
5681;La faute à Fidel!;792966;7.4;43;40;3;93;7.8;12;11;1;91;4.1;2344;90
5682;The Grey Zone;252480;7;80;55;25;68;6.7;26;17;9;65;3.5;1987;71
5683;Hansel & Gretel;293832;3.2;5;0;5;0;0;3;0;3;0;3.1;1129;50
5684;Naqoyqatsi;145937;5.8;52;25;27;48;5.8;16;9;7;56;3.7;1161;74
5685;Real Women Have Curves;296166;6.8;82;68;14;82;7.2;23;21;2;91;3.6;2864;73
5686;Russkiy kovcheg;318034;7.8;93;82;11;88;8.3;24;22;2;91;3.9;2668;80
5687;Goyangileul butaghae;296658;6.8;27;22;5;81;6.5;8;5;3;62;3.7;622;80
5688;Tully;212604;6.9;52;42;10;80;6.8;20;16;4;80;3.6;374;78
5689;Billy Bathgate;101453;5.2;18;9;9;50;0;2;0;2;0;2.8;1397;32
5690;Hotaru no haka;95327;8.9;22;20;2;90;0;2;2;0;100;4.3;17989;93
5691;Jason Goes to Hell: The Final Friday;107254;4.1;15;4;11;26;0;2;0;2;0;2.8;9066;47
5692;The Mechanic;68931;0;3;1;2;33;0;1;0;1;0;3.5;913;70
5693;Saturday Night Fever;76666;7.4;38;34;4;89;0;4;3;1;75;3.1;13427;67
5694;Stay Alive;441796;3;57;5;52;8;2.8;14;1;13;7;3.3;40388;60
5695;To the Devil a Daughter;75334;4;6;1;5;16;0;1;0;1;0;3.1;703;44
5696;Urban Cowboy;81696;6.5;13;10;3;76;0;0;0;0;0;0;0;0
5697;Terror Train;81617;4.6;9;3;6;33;0;1;0;1;0;2.9;1162;40
5698;Times Square;81635;0;4;1;3;25;0;1;0;1;0;3.6;569;66
5699;Tom Horn;80031;0;4;4;0;100;0;0;0;0;0;0;0;0
5700;L'uomo puma;81693;\N;\N;\N;\N;\N;\N;\N;\N;\N;\N;\N;\N;\N
5701;Up the Academy;81695;0;4;0;4;0;0;1;0;1;0;3.2;244;51
5702;When Time Ran Out...;81747;0;4;0;4;0;0;0;0;0;0;0;0;0
5703;Wholly Moses!;81751;0;0;0;0;0;0;0;0;0;0;0;0;0
5705;Xanadu;81777;4.5;22;9;13;40;0;2;1;1;50;3;3569;60
5706;...All the Marbles;81964;0;0;0;0;0;0;0;0;0;0;0;0;0
5707;Absence of Malice;81974;6.6;22;19;3;86;6.6;5;4;1;80;3.3;1000;55
5708;All Night Long;54614;0;0;0;0;0;0;0;0;0;0;0;0;0
5709;The Moguls;405163;3.9;24;4;20;16;0;4;1;3;25;3;8866;46
5710;Banana Joe;82045;0;0;0;0;0;0;0;0;0;0;0;0;0
5711;Die bleierne Zeit;82081;0;1;1;0;100;0;0;0;0;0;0;0;0
5712;Blow Out;82085;7.5;36;32;4;88;7.1;5;4;1;80;3.6;2727;74
5714;Buddy;118787;5.4;19;5;14;26;6.2;6;2;4;33;2.8;1106;37
5715;Burn After Reading;887883;6.8;217;169;48;77;6.2;42;26;16;61;3.4;71248;64
5716;The Butterfly Effect;289879;4.8;166;55;111;33;3.8;34;6;28;17;3.6;109956;81
5717;Cannibal ferox;82700;0;3;0;3;0;0;0;0;0;0;0;0;0
5718;Carbon Copy;82138;0;1;0;1;0;0;0;0;0;0;0;0;0
5719;Charlie Chan and the Curse of the Dragon Queen;82159;5.5;5;2;3;40;0;0;0;0;0;0;0;0
5720;Chi trova un amico, trova un tesoro;85327;\N;\N;\N;\N;\N;\N;\N;\N;\N;\N;\N;\N;\N
5721;The Chosen;82175;5.6;9;7;2;77;0;2;2;0;100;3.8;256;78
5722;The Goat;12224;0;0;0;0;0;0;0;0;0;0;0;0;0
5723;Continental Divide;82200;6.2;9;7;2;77;0;2;1;1;50;3;537;48
5724;The Creature Wasn't Nice;82213;0;0;0;0;0;0;0;0;0;0;0;0;0
5725;Czlowiek z zelaza;82222;0;1;1;0;100;0;0;0;0;0;0;0;0
5726;Dead & Buried;82242;6.2;11;8;3;72;0;0;0;0;0;0;0;0
5727;Deadly Blessing;82245;4.4;5;1;4;20;0;0;0;0;0;0;0;0
5728;Death Hunt;82247;0;3;1;2;33;0;1;0;1;0;3.5;872;71
5729;Endless Love;82329;3.9;13;3;10;23;0;3;0;3;0;0;0;0
5730;Enter the Ninja;82332;0;1;0;1;0;0;0;0;0;0;0;0;0
5731;The Entity;82334;0;2;2;0;100;0;0;0;0;0;0;0;0
5732;Eye of the Needle;82351;6.5;13;11;2;84;0;1;1;0;100;3.4;963;61
5733;Eyewitness;66420;0;0;0;0;0;0;0;0;0;0;0;0;0
5734;Faces of Death II;85518;0;0;0;0;0;0;0;0;0;0;0;0;0
5735;Faces of Death;77533;\N;\N;\N;\N;\N;\N;\N;\N;\N;\N;\N;\N;\N
5736;Faces of Death III;121261;0;0;0;0;0;0;0;0;0;0;0;0;0
5737;Faces of Death IV;121262;0;0;0;0;0;0;0;0;0;0;0;0;0
5738;Faces of Death V;160303;0;0;0;0;0;0;0;0;0;0;0;0;0
5739;Faces of Death VI;223250;0;0;0;0;0;0;0;0;0;0;0;0;0
5740;Faces of Death: Fact or Fiction?;223251;2.6;11;2;9;18;0;0;0;0;0;0;0;0
5741;La femme d'à côté;82370;7.7;10;9;1;90;0;3;3;0;100;3.8;931;80
5742;First Monday in October;82382;0;4;1;3;25;0;0;0;0;0;0;0;0
5743;Fort Apache the Bronx;82402;6.6;11;9;2;81;0;1;0;1;0;3.2;1172;57
5744;Four Friends;82404;6.9;7;5;2;71;0;1;1;0;100;3.6;291;69
5745;Händler der vier Jahreszeiten;67227;7.9;12;11;1;91;0;2;1;1;50;0;0;0
5746;Galaxy of Terror;82431;5.1;10;4;6;40;0;0;0;0;0;0;0;0
5747;Gallipoli;82432;7.4;21;18;3;85;0;2;1;1;50;3.6;5646;77
5748;Zork: Grand Inquisitor;132641;\N;\N;\N;\N;\N;\N;\N;\N;\N;\N;\N;\N;\N
5749;Sien nui yau wan;93978;7.8;8;6;2;75;0;0;0;0;0;0;0;0
5750;Going Ape!;82457;0;0;0;0;0;0;0;0;0;0;0;0;0
5751;Goodbye Pork Pie;82464;\N;\N;\N;\N;\N;\N;\N;\N;\N;\N;\N;\N;\N
5752;Gregory's Girl;82477;7.7;13;12;1;92;0;4;4;0;100;3.7;1117;79
5753;Göta kanal eller Vem drog ur proppen?;82490;0;0;0;0;0;0;0;0;0;0;0;0;0
5754;Cool Hand Luke;61512;8.8;44;44;0;100;8.5;6;6;0;100;4.1;17521;93
5755;Happy Birthday to Me;82498;5.2;8;2;6;25;0;0;0;0;0;0;0;0
5756;Heartbeeps;82507;1.6;5;0;5;0;0;0;0;0;0;0;0;0
5759;Ladies and Gentlemen, the Fabulous Stains;82639;0;0;0;0;0;0;0;0;0;0;0;0;0
5760;Lady Chatterley's Lover;82640;0;0;0;0;0;0;0;0;0;0;0;0;0
5761;The Legend of the Lone Ranger;82648;0;0;0;0;0;0;0;0;0;0;0;0;0
5762;Lili Marleen;82661;5.8;5;2;3;40;0;3;1;2;33;3.8;317;79
5763;Lola;82671;8.1;6;6;0;100;0;1;1;0;100;3.9;529;82
5764;Looker;82677;4.4;17;5;12;29;0;2;0;2;0;3.2;1109;50
5765;Looney, Looney, Looney Bugs Bunny Movie;82679;0;3;2;1;66;0;0;0;0;0;0;0;0
5766;I, Madman;97557;0;4;3;1;75;0;1;1;0;100;3;387;44
5767;Mis;82755;0;0;0;0;0;0;0;0;0;0;0;0;0
5768;Modern Problems;82763;0;3;0;3;0;0;0;0;0;0;0;0;0
5769;Modern Romance;82764;6.4;20;17;3;85;0;1;1;0;100;3.6;466;72
5770;Ms. 45;82776;6.9;9;7;2;77;0;0;0;0;0;0;0;0
5771;My Bloody Valentine;1179891;5.7;85;48;37;56;5.2;8;3;5;37;3.1;111307;49
5772;My Dinner with Andre;82783;7.1;18;16;2;88;0;1;1;0;100;4;1441;85
5773;Your Friends & Neighbors;119517;7;55;42;13;76;6.4;20;13;7;65;3.3;1418;60
5774;Night of the Zombies;82815;0;0;0;0;0;0;0;0;0;0;0;0;0
5775;The Night the Lights Went Out in Georgia;82816;0;1;1;0;100;0;0;0;0;0;0;0;0
5776;Only When I Laugh;82853;4.9;6;3;3;50;0;1;0;1;0;3.1;189;39
5777;Pennies from Heaven;82894;7;24;20;4;83;4.3;5;1;4;20;3.3;851;58
5778;Five Easy Pieces;65724;8.2;30;25;5;83;6.5;5;3;2;60;3.9;4148;85
5779;Piranha Part Two: The Spawning;82910;3.4;13;1;12;7;0;1;0;1;0;2;692;11
5780;Polyester;82926;7.1;17;15;2;88;0;0;0;0;0;0;0;0
5781;Private Lessons;82948;2.7;6;0;6;0;0;1;0;1;0;2.9;1236;38
5782;Le professionnel;82949;0;1;0;1;0;0;0;0;0;0;0;0;0
5783;Derrida;303326;6.7;34;28;6;82;7.2;11;10;1;90;3.3;333;59
5784;Ghost Ship;288477;3.8;119;15;104;12;3.5;28;3;25;10;2.9;21180;53
5785;Jackass: The Movie;322802;5.1;93;46;47;49;4.1;17;6;11;35;3.4;50664;78
5786;Paid in Full;259484;5.8;41;21;20;51;5.7;16;7;9;43;4.3;4068;94
5787;The Truth About Charlie;270707;4.8;130;43;87;33;4.9;35;14;21;40;2.7;2359;29
5788;All or Nothing;286261;7.1;88;73;15;82;6.8;24;18;6;75;3.8;907;82
5789;All the Queen's Men;252223;3.3;29;2;27;6;2.8;11;0;11;0;3.1;969;51
5790;Food of Love;309600;5.3;28;13;15;46;5.4;10;5;5;50;3;360;47
5791;Frida;120679;6.9;148;112;36;75;6.8;36;23;13;63;3.7;14440;84
5792;Roger Dodger;299117;7.4;121;106;15;87;7.4;30;28;2;93;3.6;1712;75
5793;Time Changer;295725;3.9;9;2;7;22;0;1;0;1;0;3.6;571;72
5794;Beau travail;209933;7.6;29;23;6;79;0;4;4;0;100;3.9;709;79
5795;The Big Knife;47880;0;4;3;1;75;0;0;0;0;0;0;0;0
5796;Casino Royale;381061;7.8;214;202;12;94;7.8;43;41;2;95;3.9;155430;87
5797;The Company of Wolves;87075;6.5;13;10;3;76;0;1;1;0;100;3.5;2206;71
5798;Escanaba in da Moonlight;180679;0;3;1;2;33;0;1;0;1;0;0;0;0
5799;Exodus;53804;6;12;8;4;66;0;2;2;0;100;3.6;904;71
5800;How to Murder Your Wife;58212;5.9;8;5;3;62;0;0;0;0;0;0;0;0
5801;The Russians Are Coming the Russians Are Coming;60921;6.8;17;14;3;82;0;1;0;1;0;3.5;861;74
5802;The World of Henry Orient;58756;7.6;8;7;1;87;0;0;0;0;0;0;0;0
5803;I Spy;297181;0;0;0;0;0;0;0;0;0;0;0;0;0
5804;The Santa Clause 2;304669;5.6;111;61;50;54;5.4;28;13;15;46;2.9;17510;59
5806;Takhté siah;246266;6.8;34;25;9;73;7.1;11;9;2;81;3.6;447;67
5807;Love in the Time of Money;292501;4.2;39;7;32;17;3.1;12;1;11;8;3;203;28
5808;The Weight of Water;210382;5.1;62;20;42;32;5.3;21;8;13;38;3;1230;40
5809;Femme Fatale;280665;5.4;133;64;69;48;5.5;32;16;16;50;2.9;3552;49
5810;8 Mile;298203;6.7;179;133;46;74;7.2;38;32;6;84;3.1;199023;54
5811;Tout près des étoiles: Les danseurs de l'Opéra de Paris;260713;6.1;13;8;5;61;6;6;3;3;50;4.4;11;100
5812;Far from Heaven;297884;8.1;188;168;20;89;8.4;37;35;2;94;3.6;5103;77
5813;Dieu est grand, je suis toute petite;287986;4.5;25;6;19;24;4.1;11;1;10;9;3;1107;39
5814;The Rising Place;201020;4.3;16;2;14;12;3.2;6;0;6;0;3.6;47;75
5815;Half Past Dead 2;871867;\N;\N;\N;\N;\N;\N;\N;\N;\N;\N;\N;\N;\N
5816;Harry Potter and the Chamber of Secrets;295297;7.1;199;164;35;82;6.6;39;27;12;69;3.6;176055;80
5817;Ararat;273435;6.4;75;42;33;56;6.3;22;10;12;45;3.6;923;70
5818;El crimen del padre Amaro;313196;6.2;82;51;31;62;6.3;29;19;10;65;3.7;3433;73
5819;Interview with the Assassin;308411;6.5;57;38;19;66;6.1;17;10;7;58;3.3;332;52
5820;Standing in the Shadows of Motown;314725;7.5;88;81;7;92;7.5;26;24;2;92;4;660;87
5821;Jibeuro;312841;6.6;55;41;14;74;6.5;18;13;5;72;4.2;1280;91
5822;Acción mutante;106215;0;0;0;0;0;0;0;0;0;0;0;0;0
5823;Eyes of an Angel;101844;0;3;0;3;0;0;0;0;0;0;0;0;0
5824;Liberty Stands Still;280870;0;4;0;4;0;0;0;0;0;0;0;0;0
5825;The Life and Death of Colonel Blimp;36112;8.7;11;10;1;90;0;1;1;0;100;4.2;1070;93
5826;Rio Grande;42895;6.7;12;9;3;75;0;0;0;0;0;0;0;0
5827;Young Americans;220178;\N;\N;\N;\N;\N;\N;\N;\N;\N;\N;\N;\N;\N
5828;Bad Day at Black Rock;47849;8.2;25;24;1;96;0;3;2;1;66;3.9;1420;86
5829;Men with Brooms;263734;5.6;16;10;6;62;0;3;3;0;100;3.1;1241;61
5830;Mysterious Island;55207;6.2;10;8;2;80;0;0;0;0;0;0;0;0
5831;Soul Assassin;271200;0;1;0;1;0;0;0;0;0;0;0;0;0
5832;Left Behind II: Tribulation Force;283644;0;2;0;2;0;0;0;0;0;0;0;0;0
5833;Dog Soldiers;280609;6.8;29;22;7;75;0;2;2;0;100;0;0;0
5834;Goldfinger;58150;8.4;48;46;2;95;7.9;6;5;1;83;3.6;22155;83
5835;God afton, Herr Wallenberg - En Passionshistoria från verkligheten;99673;\N;\N;\N;\N;\N;\N;\N;\N;\N;\N;\N;\N;\N
5836;Houseboat;51745;5.5;11;6;5;54;0;0;0;0;0;0;0;0
5837;Legion of the Dead;441041;0;0;0;0;0;0;0;0;0;0;0;0;0
5838;Madame Bovary;102368;6.4;10;8;2;80;0;1;1;0;100;3.3;531;57
5839;La gloire de mon père;99669;7.5;5;5;0;100;0;2;2;0;100;3.9;1022;84
5840;Le château de ma mère;99266;7.4;7;6;1;85;0;2;1;1;50;4;771;84
5841;Return to the Blue Lagoon;102782;1.9;20;0;20;0;0;4;0;4;0;2.8;2859;48
5842;Trop belle pour toi;98520;0;3;3;0;100;0;1;1;0;100;3.5;391;66
5843;Toy Soldiers;103112;4.4;13;5;8;38;0;2;0;2;0;3;3691;57
5844;The Prowler;82951;0;3;2;1;66;0;0;0;0;0;0;0;0
5845;The Pursuit of D.B. Cooper;82958;0;0;0;0;0;0;0;0;0;0;0;0;0
5846;Raggedy Man;82969;6.5;6;5;1;83;0;1;1;0;100;3.3;201;65
5847;Ragtime;82970;7.3;10;9;1;90;0;1;1;0;100;3.5;672;71
5848;Rich and Famous;82992;4.9;9;5;4;55;0;1;0;1;0;3;151;38
5849;Ricomincio da tre;81427;\N;\N;\N;\N;\N;\N;\N;\N;\N;\N;\N;\N;\N
5851;Rollover;83006;0;3;2;1;66;0;0;0;0;0;0;0;0
5852;Saturday the 14th;83033;3.4;10;1;9;10;0;0;0;0;0;0;0;0
5853;Scanners;81455;6.8;25;19;6;76;0;4;1;3;25;3.2;5721;61
5854;Sharky's Machine;83064;6.2;14;13;1;92;0;1;1;0;100;3;659;45
5855;Shock Treatment;83067;5.3;5;2;3;40;0;0;0;0;0;0;0;0
5856;Sjecas li se Dolly Bell;83089;0;4;4;0;100;0;0;0;0;0;0;0;0
5857;So Fine;83099;0;4;3;1;75;0;1;1;0;100;2.9;107;15
5858;La soupe aux choux;83109;0;0;0;0;0;0;0;0;0;0;0;0;0
5859;Southern Comfort;83111;6.7;14;12;2;85;0;1;1;0;100;3.5;1184;72
5860;Sphinx;83113;0;0;0;0;0;0;0;0;0;0;0;0;0
5861;Storie di ordinaria follia;86410;0;0;0;0;0;0;0;0;0;0;0;0;0
5862;Student Bodies;83133;3.2;6;1;5;16;0;0;0;0;0;0;0;0
5863;Take This Job and Shove It;83163;0;1;0;1;0;0;0;0;0;0;0;0;0
5864;Tarzan the Ape Man;23551;7.8;13;13;0;100;0;0;0;0;0;0;0;0
5865;Tattoo;286204;6.5;25;17;8;68;6.6;9;6;3;66;3.4;520;60
5866;They All Laughed;83189;5.2;6;2;4;33;0;0;0;0;0;0;0;0
5867;The Thief of Bagdad;15400;8.1;13;13;0;100;0;1;1;0;100;3.6;655;75
5868;Elvis;79103;0;2;1;1;50;0;0;0;0;0;0;0;0
5869;True Confessions;83232;7.5;6;6;0;100;0;1;1;0;100;3.3;674;55
5870;Revolution #9;253586;6.5;25;19;6;76;6;5;4;1;80;3.3;37;57
5872;Die Another Day;246460;6.1;190;112;78;58;5.6;36;15;21;41;3.1;29585;53
5873;The Emperor's Club;283530;5.8;125;63;62;50;5.7;30;14;16;46;3.3;5179;66
5874;Friday After Next;293815;4.1;69;17;52;24;4.5;23;7;16;30;3.3;23508;76
5875;Personal Velocity: Three Portraits;295238;6.5;99;68;31;68;7.3;28;22;6;78;3.4;664;61
5876;The Quiet American;258068;7.7;150;131;19;87;8;35;33;2;94;3.5;2910;69
5878;Hable con ella;287467;0;0;0;0;0;0;0;0;0;0;0;0;0
5879;Eight Crazy Nights;271263;3.1;105;13;92;12;3.3;30;4;26;13;3.1;18784;61
5880;Extreme Ops;283160;2.9;65;4;61;6;3.3;18;2;16;11;2.6;1235;33
5881;Solyaris;69293;8.3;39;38;1;97;8.2;8;8;0;100;4.1;7425;89
5882;Treasure Planet;133240;6.5;140;97;43;69;6.5;33;24;9;72;3.1;9742;64
5883;They;283632;4.2;54;20;34;37;3.9;12;4;8;33;2.6;2603;31
5884;Chrome Hearts;103959;0;3;0;3;0;0;0;0;0;0;0;0;0
5885;Was tun, wenn's brennt?;207198;5.6;24;12;12;50;5.5;8;5;3;62;4;589;84
5886;Ik ook van jou;239060;0;0;0;0;0;0;0;0;0;0;0;0;0
5887;Another You;101356;3;8;1;7;12;0;0;0;0;0;0;0;0
5888;Borat: Cultural Learnings of America for Make Benefit Glorious Nation of Kazakhstan;443453;8;209;191;18;91;8.1;41;40;1;97;3.4;141091;76
5889;Zhestokiy romans;90368;\N;\N;\N;\N;\N;\N;\N;\N;\N;\N;\N;\N;\N
5890;Elling;279064;7.1;58;49;9;84;7.3;17;16;1;94;4.1;2002;90
5891;Day of the Woman;77713;4.9;27;15;12;55;0;0;0;0;0;0;0;0
5892;The Island at the Top of the World;71671;0;3;1;2;33;0;0;0;0;0;0;0;0
5893;The Last Seduction;110308;7.8;48;45;3;93;7.9;11;11;0;100;3.6;1444;73
5895;Contact;118884;6.8;55;37;18;67;6.5;13;7;6;53;3.1;19572;74
5896;New Waterford Girl;213121;7.4;12;11;1;91;0;2;2;0;100;3.7;582;80
5897;Das Arche Noah Prinzip;86911;0;0;0;0;0;0;0;0;0;0;0;0;0
5898;The Sword and the Sorcerer;84749;6.8;5;4;1;80;0;0;0;0;0;0;0;0
5899;Zulu;58777;7.2;13;12;1;92;0;2;2;0;100;3.8;4868;89
5900;Analyze That;289848;4.8;145;39;106;26;4.1;32;6;26;18;2.9;11576;45
5901;Empire;262396;4.4;99;21;78;21;4.5;26;5;21;19;3.3;2601;62
5902;Adaptation.;268126;8.2;195;177;18;90;8;35;30;5;85;3.6;39757;82
5903;Equilibrium;238380;4.8;82;30;52;36;4.5;23;7;16;30;3.7;77822;82
5906;Ça commence aujourd'hui;186730;7.2;16;13;3;81;0;4;4;0;100;3.6;210;73
5907;Madea Goes to Jail;1142800;4.9;46;12;34;26;4.5;11;3;8;27;3.8;153294;74
5909;Bijitâ Q;290329;5.6;8;4;4;50;0;1;0;1;0;3.8;3392;77
5910;Les uns et les autres;83260;\N;\N;\N;\N;\N;\N;\N;\N;\N;\N;\N;\N;\N
5911;Urgh! A Music War;138902;0;0;0;0;0;0;0;0;0;0;0;0;0
5912;Vabank;83271;0;0;0;0;0;0;0;0;0;0;0;0;0
5913;Varning för Jönssonligan;83276;0;0;0;0;0;0;0;0;0;0;0;0;0
5914;Vernon, Florida;83281;7.9;7;7;0;100;0;0;0;0;0;0;0;0
5915;Victory;83284;5.7;6;4;2;66;0;2;2;0;100;3.5;2887;69
5916;Whose Life Is It Anyway?;83326;5.9;5;4;1;80;0;0;0;0;0;0;0;0
5917;Zoot Suit;83365;0;3;1;2;33;0;0;0;0;0;0;0;0
5918;Alone in the Dark;369226;1.7;116;1;115;0;1.7;26;0;26;0;2.1;8641;21
5919;Android Apocalypse;470023;0;2;0;2;0;0;0;0;0;0;0;0;0
5921;Attack Force Z;83591;0;0;0;0;0;0;0;0;0;0;0;0;0
5922;Attila;46731;\N;\N;\N;\N;\N;\N;\N;\N;\N;\N;\N;\N;\N
5923;Author! Author!;83598;0;1;1;0;100;0;0;0;0;0;0;0;0
5924;Barbarosa;83619;0;4;4;0;100;0;0;0;0;0;0;0;0
5925;The Beast Within;83629;0;4;0;4;0;0;0;0;0;0;0;0;0
5926;My Best Friend's Wedding;119738;6.5;54;39;15;72;5.9;17;10;7;58;3.3;64013;72
5927;The Best Little Whorehouse in Texas;83642;5.1;9;5;4;55;0;1;0;1;0;3.2;2628;68
5928;The Border;83678;6.7;9;8;1;88;0;0;0;0;0;0;0;0
5929;La boum;82100;\N;\N;\N;\N;\N;\N;\N;\N;\N;\N;\N;\N;\N
5930;Brimstone & Treacle;83693;0;1;1;0;100;0;0;0;0;0;0;0;0
5931;Britannia Hospital;83694;6.8;5;3;2;60;0;0;0;0;0;0;0;0
5932;Burden of Dreams;83702;8.6;14;14;0;100;0;2;2;0;100;4.1;903;89
5933;Cannery Row;83717;6.2;6;4;2;66;0;1;0;1;0;3.5;328;67
5935;Class of 1984;83739;5.9;10;6;4;60;0;1;1;0;100;3.2;1460;61
5936;Come Back to the Five and Dime, Jimmy Dean, Jimmy Dean;83745;0;0;0;0;0;0;0;0;0;0;0;0;0
5937;Danton;83789;7.7;7;6;1;85;0;1;1;0;100;3.8;550;79
5938;Deathtrap;83806;6.1;11;7;4;63;0;1;1;0;100;3.5;1117;69
5939;Dünyayi kurtaran adam;182060;0;2;2;0;100;0;0;0;0;0;0;0;0
5940;Eating Raoul;83869;6.7;17;15;2;88;0;1;0;1;0;3.4;1151;67
5941;Drumline;303933;6.7;81;66;15;81;7;25;23;2;92;3.2;40552;73
5942;The Hot Chick;302640;3.8;80;17;63;21;4.1;24;7;17;29;3.1;39910;67
5943;Maid in Manhattan;252076;5.1;144;56;88;38;5.1;32;10;22;31;2.9;39640;53
5944;Star Trek: Nemesis;253754;5.2;155;57;98;36;5.8;32;14;18;43;3.1;16224;56
5945;About Schmidt;257360;7.7;198;168;30;84;7.9;41;37;4;90;3.1;14978;64
5946;El Bola;243794;7.2;11;10;1;90;0;4;4;0;100;3.9;644;85
5947;Evelyn;298856;6.1;106;69;37;65;6.5;29;23;6;79;3.6;1505;76
5948;Family Guy;182576;\N;\N;\N;\N;\N;\N;\N;\N;\N;\N;\N;\N;\N
5949;Intacto;220580;6.5;72;52;20;72;5.9;21;13;8;61;3.8;2133;82
5950;The Jimmy Show;271020;5;10;4;6;40;0;3;0;3;0;2.8;238;30
5951;Morvern Callar;300214;7;76;64;12;84;7.3;24;21;3;87;3.6;1321;74
5952;The Lord of the Rings: The Two Towers;167261;8.4;218;210;8;96;8;39;39;0;100;4.1;263598;92
5953;Guizi lai le;245929;6.8;10;9;1;90;0;4;3;1;75;4.1;530;89
5954;25th Hour;307901;7.1;162;126;36;77;7;35;26;9;74;3.7;25056;83
5955;Antwone Fisher;168786;6.9;145;114;31;78;7.1;33;28;5;84;3.6;7166;85
5956;Gangs of New York;217505;7.1;200;149;51;74;6.5;42;28;14;66;3.5;35768;76
5957;Two Weeks Notice;313737;5.2;118;49;69;41;5.1;30;10;20;33;3;28494;63
5958;The Wild Thornberrys Movie;282120;6.6;86;68;18;79;6.9;26;22;4;84;2.8;2798;43
5959;Narc;272207;7.1;151;126;25;83;6.7;30;22;8;73;3.4;4235;76
5960;Bad Influence;99091;6.1;14;10;4;71;0;2;2;0;100;3;751;46
5961;Blue Steel;99160;5.9;16;12;4;75;0;2;2;0;100;2.8;1502;32
5962;Body of Evidence;106453;2.7;33;2;31;6;2.6;8;0;8;0;2.4;1797;30
5963;The Children's Hour;54743;7.2;5;5;0;100;0;0;0;0;0;0;0;0
5964;The Business;429715;5.8;6;3;3;50;0;0;0;0;0;0;0;0
5965;The Duellists;75968;7.3;14;14;0;100;0;0;0;0;0;0;0;0
5966;A Kiss Before Dying;49414;0;4;3;1;75;0;0;0;0;0;0;0;0
5968;Miami Blues;100143;6.5;18;15;3;83;0;2;0;2;0;3;889;45
5969;My Girl;102492;5.3;12;6;6;50;0;2;1;1;50;3.5;29984;75
5970;My Girl;102492;5.3;12;6;6;50;0;2;1;1;50;3.5;29984;75
5971;Tonari no Totoro;96283;8.1;28;25;3;89;0;3;1;2;33;4.3;31390;94
5972;The Road to Hong Kong;56417;0;4;3;1;75;0;0;0;0;0;0;0;0
5973;Running Time;120042;0;0;0;0;0;0;0;0;0;0;0;0;0
5974;The Thief of Bagdad;15400;8.1;13;13;0;100;0;1;1;0;100;3.6;655;75
5975;War and Peace;49934;5;6;3;3;50;0;1;0;1;0;3.5;2121;66
5976;Stay;492492;6.1;50;32;18;64;6.1;14;10;4;71;2.8;1534;38
5977;Where's Poppa?;66563;7.4;8;8;0;100;0;1;1;0;100;3.3;354;64
5978;The Whistle Blower;92206;7.6;7;6;1;85;0;1;1;0;100;3.1;379;36
5979;Attack of the Crab Monsters;50147;0;1;0;1;0;0;0;0;0;0;0;0;0
5980;Black Christmas;454082;0;0;0;0;0;0;0;0;0;0;0;0;0
5981;The Day of the Triffids;55894;6.5;15;13;2;86;0;1;1;0;100;3;1136;47
5982;Esther Kahn;183056;5.5;24;12;12;50;4.2;8;2;6;25;3.5;245;57
5983;Invaders from Mars;45917;7;10;8;2;80;0;0;0;0;0;0;0;0
5984;Histoire d'O;73115;0;0;0;0;0;0;0;0;0;0;0;0;0
5985;Asoka;249371;7.6;10;10;0;100;0;0;0;0;0;0;0;0
5986;Fat City;68575;8.6;17;17;0;100;8.1;5;5;0;100;3.9;668;84
5987;Love, Honour and Obey;199727;4.2;15;4;11;26;2.9;5;0;5;0;4.1;2113;87
5988;Quicksilver;91814;3.1;12;1;11;8;0;1;0;1;0;2.8;823;34
5989;Catch Me If You Can;264464;7.9;191;183;8;95;7.3;42;38;4;90;3.6;77695;81
5990;Pinocchio;32910;9;37;37;0;100;8.5;5;5;0;100;3.3;19102;66
5991;Chicago;299658;\N;\N;\N;\N;\N;\N;\N;\N;\N;\N;\N;\N;\N
5992;The Hours;274558;7.4;184;148;36;80;7.1;37;29;8;78;3.7;23176;83
5993;Max;290210;6.4;110;76;34;69;6.3;27;19;8;70;3.3;1412;63
5994;Nicholas Nickleby;309912;6.8;120;92;28;76;6.4;30;22;8;73;3.5;2514;72
5995;The Pianist;253474;8.2;177;169;8;95;8.1;35;33;2;94;4;55875;94
5996;Sonny;305973;4.2;26;6;20;23;4.2;8;2;6;25;3;1479;43
5997;Champagne for Caesar;42325;0;3;3;0;100;0;0;0;0;0;0;0;0
5998;Doppelgänger;64519;0;4;1;3;25;0;0;0;0;0;0;0;0
5999;Heavy Metal 2000;119273;3.7;9;0;9;0;0;1;0;1;0;2.9;2857;44
6000;La casa sperduta nel parco;80503;0;3;1;2;33;0;0;0;0;0;0;0;0
6001;The King of Comedy;85794;8.3;39;36;3;92;7;5;4;1;80;3.8;6225;84
6002;Love Liza;282698;5.9;85;46;39;54;5.6;24;13;11;54;3.7;1656;76
6003;Confessions of a Dangerous Mind;270288;\N;\N;\N;\N;\N;\N;\N;\N;\N;\N;\N;\N;\N
6004;Vale Abraão;108471;7.3;6;5;1;83;0;2;2;0;100;3.7;181;69
6005;Blue Collar Comedy Tour: The Movie;330069;6.8;13;12;1;92;7;8;8;0;100;3.6;6829;82
6006;Just Married;305711;0;0;0;0;0;0;0;0;0;0;0;0;0
6007;P.S. Your Cat Is Dead!;245341;4.2;17;4;13;23;4.1;8;1;7;12;3.1;453;48
6008;Le fils;291172;0;0;0;0;0;0;0;0;0;0;0;0;0
6009;Hyôryû-gai;246498;5.4;12;7;5;58;0;2;1;1;50;3.2;791;48
6010;Double Whammy;250347;4.5;10;3;7;30;0;0;0;0;0;0;0;0
6011;WiseGirls;284655;0;0;0;0;0;0;0;0;0;0;0;0;0
6012;A Guy Thing;295289;4.1;97;24;73;24;3.8;27;5;22;18;2.8;8292;37
6013;Kangaroo Jack;257568;0;0;0;0;0;0;0;0;0;0;0;0;0
6014;National Security;271668;3.3;87;10;77;11;4;26;6;20;23;3;10503;55
6015;Da wan;287934;4.7;15;3;12;20;0;1;0;1;0;3.6;201;72
6016;Cidade de Deus;317248;8.3;149;137;12;91;8.2;34;31;3;91;4.3;66456;97
6017;Yadon ilaheyya;274428;7.2;68;55;13;80;7.6;19;18;1;94;3.7;616;76
6018;En kærlighedshistorie;285280;5.7;18;12;6;66;0;4;1;3;25;3.7;143;64
6019;Indagine su un cittadino al di sopra di ogni sospetto;65889;7.9;5;5;0;100;0;3;3;0;100;4.4;483;97
6020;Alice Adams;26056;7.8;14;13;1;92;0;3;3;0;100;3.6;789;67
6021;Der amerikanische Freund;75675;7.2;16;14;2;87;0;2;2;0;100;3.8;1218;80
6022;American Me;103671;6.8;8;5;3;62;0;2;2;0;100;4.1;2720;91
6023;Bande à part;57869;7.9;39;37;2;94;7.7;12;12;0;100;4.2;4082;91
6024;The Break-Up;452594;5;187;62;125;33;4.5;40;8;32;20;3.1;107481;52
6025;CB4;106500;5.7;20;11;9;55;4.8;7;2;5;28;3.1;2278;60
6026;Der Totmacher;114704;0;0;0;0;0;0;0;0;0;0;0;0;0
6027;Dogfight;101748;6.8;15;12;3;80;0;2;1;1;50;3.8;1613;83
6029;Fun in Acapulco;57083;\N;\N;\N;\N;\N;\N;\N;\N;\N;\N;\N;\N;\N
6030;Girls! Girls! Girls!;56023;4.9;5;2;3;40;0;0;0;0;0;0;0;0
6031;Imitation of Life;52918;7.4;13;11;2;84;0;1;1;0;100;4.2;2834;91
6032;A Little Romance;79477;6.7;14;11;3;78;0;1;0;1;0;3.8;1363;79
6033;Mystery Date;102500;4.7;8;2;6;25;0;1;0;1;0;2.9;538;41
6035;Pépé le Moko;29453;8.6;29;29;0;100;8.8;11;11;0;100;3.8;713;82
6036;Secret Admirer;89981;4.1;8;2;6;25;0;0;0;0;0;0;0;0
6037;Summer Lovers;84737;0;4;0;4;0;0;1;0;1;0;3.1;495;47
6038;Tune in Tomorrow...;100822;6;11;5;6;45;6.2;5;2;3;40;3;665;42
6039;The Woman in Red;88414;4.3;7;2;5;28;0;0;0;0;0;0;0;0
6040;Darkness Falls;282209;3.2;124;10;114;8;3;25;1;24;4;2.8;11135;46
6041;Amen.;280653;6.3;49;33;16;67;6.1;15;9;6;60;3.9;1385;82
6042;Im toten Winkel - Hitlers Sekretärin;311320;7.3;80;68;12;85;7.7;27;26;1;96;3.4;472;66
6043;Im Spiegel der Maya Deren;284203;8;18;17;1;94;7.8;7;7;0;100;3.8;258;79
6044;Blind Date;92666;4.1;22;5;17;22;0;3;1;2;33;2.9;2983;44
6045;Love and a Bullet;235553;0;2;0;2;0;0;0;0;0;0;0;0;0
6047;Dead Reckoning;39305;6.2;6;4;2;66;0;0;0;0;0;0;0;0
6048;The Devil at 4 O'Clock;54805;0;3;2;1;66;0;0;0;0;0;0;0;0
6049;Ethan Frome;106833;5.7;9;5;4;55;0;2;1;1;50;2.9;406;40
6050;Milk;1013753;8;217;203;14;93;8.3;38;36;2;94;3.9;55245;88
6051;The Harder They Come;70155;7.6;13;11;2;84;0;1;0;1;0;3.9;1321;84
6052;The Horse in the Gray Flannel Suit;63091;0;0;0;0;0;0;0;0;0;0;0;0;0
6053;Krush Groove;89444;0;4;3;1;75;0;0;0;0;0;0;0;0
6054;The Moon-Spinners;58371;0;2;1;1;50;0;0;0;0;0;0;0;0
6055;Sugar Hill;107079;5.1;9;2;7;22;0;1;0;1;0;3.4;1056;71
6056;Chaos;402910;0;4;1;3;25;0;0;0;0;0;0;0;0
6057;Biker Boyz;326769;4.2;90;20;70;22;4;28;6;22;21;3;10252;59
6058;Final Destination 2;309593;5;106;50;56;47;4;23;7;16;30;3.2;47391;70
6059;The Recruit;292506;5.5;163;70;93;42;5.6;35;16;19;45;3.2;15473;63
6060;The Guru;280720;5.7;87;50;37;57;5.6;25;15;10;60;2.6;2775;39
6061;Kedma;304267;4.8;13;4;9;30;0;2;0;2;0;3.4;166;53
6062;Lost in La Mancha;308514;7.5;97;91;6;93;7.4;25;22;3;88;3.6;5216;72
6063;May;303361;6.1;63;43;20;68;5.1;16;7;9;43;3.5;5807;75
6064;The Harder They Fall;49291;7.4;9;9;0;100;0;0;0;0;0;0;0;0
6065;I'm All Right Jack;52911;8;5;5;0;100;0;0;0;0;0;0;0;0
6066;Murder by Decree;79592;6.9;7;6;1;85;0;0;0;0;0;0;0;0
6067;Ordinary Decent Criminal;160611;3.7;7;1;6;14;0;0;0;0;0;0;0;0
6068;Pursued;385969;0;0;0;0;0;0;0;0;0;0;0;0;0
6070;Topâzu;105622;6.6;5;3;2;60;0;1;0;1;0;3.4;394;61
6072;La femme infidèle;64323;0;3;3;0;100;0;0;0;0;0;0;0;0
6073;La decima vittima;59095;0;4;4;0;100;0;0;0;0;0;0;0;0
6074;The Freshman;99615;7.3;32;30;2;93;7.2;8;7;1;87;3.1;2525;52
6075;Den enfaldige mördaren;83888;0;0;0;0;0;0;0;0;0;0;0;0;0
6076;Enigma;157583;6.6;104;75;29;72;6.8;29;22;7;75;3.2;2061;52
6077;Evil Under the Sun;83908;6.5;6;5;1;83;0;1;1;0;100;3.4;1485;61
6078;Firefox;83943;5.2;12;5;7;41;0;1;1;0;100;2.9;3121;39
6079;Five Days One Summer;83947;4;5;1;4;20;0;2;0;2;0;3;98;41
6080;Forced Vengeance;83960;0;0;0;0;0;0;0;0;0;0;0;0;0
6081;Le gendarme et les gendarmettes;83996;0;0;0;0;0;0;0;0;0;0;0;0;0
6082;The Grey Fox;85622;7.1;12;12;0;100;0;1;1;0;100;3.5;162;64
6083;Hammett;85640;5.2;8;6;2;75;0;0;0;0;0;0;0;0
6084;Honkytonk Man;84088;7;14;13;1;92;0;4;3;1;75;3.2;1335;52
6086;I, the Jury;84112;0;4;1;3;25;0;0;0;0;0;0;0;0
6087;If You Could See What I Hear;84117;0;0;0;0;0;0;0;0;0;0;0;0;0
6088;Jekyll and Hyde... Together Again;84171;0;0;0;0;0;0;0;0;0;0;0;0;0
6089;Jönssonligan & DynamitHarry;84189;0;0;0;0;0;0;0;0;0;0;0;0;0
6090;Kiss Me Goodbye;84210;0;1;1;0;100;0;0;0;0;0;0;0;0
6091;Laberinto de pasiones;84228;7.8;6;6;0;100;0;4;4;0;100;0;0;0
6092;The Last American Virgin;84234;5.8;9;6;3;66;0;1;0;1;0;3.3;3330;60
6093;The Last Unicorn;84237;5.8;10;5;5;50;0;0;0;0;0;0;0;0
6094;Liquid Sky;85852;6.9;17;16;1;94;0;3;3;0;100;3.5;1091;67
6095;Long xiao ye;84266;0;4;3;1;75;0;0;0;0;0;0;0;0
6096;Making Love;84293;4.6;16;5;11;31;0;3;0;3;0;3.4;534;61
6097;Manhattan Baby;84298;0;2;0;2;0;0;0;0;0;0;0;0;0
6099;Megaforce;84316;1.4;7;0;7;0;0;0;0;0;0;0;0;0
6100;A Midsummer Night's Sex Comedy;84329;6.3;21;15;6;71;0;4;0;4;0;3.3;2757;58
6101;The Missing;338188;6.1;168;98;70;58;6.1;39;21;18;53;3;6895;52
6102;The Mission;91530;6.4;16;11;5;68;0;2;1;1;50;3.8;11307;83
6103;Monsignor;84351;1.9;5;0;5;0;0;3;0;3;0;2.1;20;0
6104;Monty Python Live at the Hollywood Bowl;84352;0;2;2;0;100;0;0;0;0;0;0;0;0
6105;Moonlight;955346;\N;\N;\N;\N;\N;\N;\N;\N;\N;\N;\N;\N;\N
6106;Mother Lode;84359;0;0;0;0;0;0;0;0;0;0;0;0;0
6107;La notte di San Lorenzo;84422;6.8;9;6;3;66;0;1;0;1;0;3.8;345;72
6108;La nuit de Varennes;84423;0;4;3;1;75;0;1;0;1;0;3.9;168;78
6109;One from the Heart;84445;5.8;27;13;14;48;5.9;11;6;5;54;3.4;725;61
6110;Pandemonium;84464;0;0;0;0;0;0;0;0;0;0;0;0;0
6111;Paradise;84469;0;3;0;3;0;0;0;0;0;0;0;0;0
6112;Partner(s);419026;0;0;0;0;0;0;0;0;0;0;0;0;0
6113;Passion;84481;6.2;6;4;2;66;0;1;1;0;100;3.5;398;61
6114;Permanent Vacation;475431;0;0;0;0;0;0;0;0;0;0;0;0;0
6115;Personal Best;84489;6.4;22;16;6;72;5.5;5;2;3;40;3.3;320;58
6116;Pirates of the Caribbean: The Curse of the Black Pearl;325980;7.1;196;153;43;78;6.4;38;25;13;65;3.9;297546;86
6117;Privates on Parade;84538;0;1;0;1;0;0;0;0;0;0;0;0;0
6118;Przypadek;84549;7.6;6;5;1;83;0;0;0;0;0;0;0;0
6119;Le père Noël est une ordure;84555;0;0;0;0;0;0;0;0;0;0;0;0;0
6120;Q;84556;0;0;0;0;0;0;0;0;0;0;0;0;0
6121;Querelle;84565;5.2;9;5;4;55;0;1;0;1;0;3.7;843;71
6122;Richard Pryor Live on the Sunset Strip;84597;8.8;13;13;0;100;0;1;1;0;100;3.7;1438;82
6123;Sans soleil;84628;7.4;10;9;1;90;0;1;1;0;100;4.3;1016;89
6124;Savannah Smiles;84633;0;1;0;1;0;0;0;0;0;0;0;0;0
6125;The Secret Policeman's Other Ball;84648;0;4;4;0;100;0;0;0;0;0;0;0;0
6126;Die Sehnsucht der Veronika Voss;84654;7.4;8;6;2;75;0;3;2;1;66;4.1;643;87
6127;Shoot the Moon;84675;7.8;8;8;0;100;0;1;1;0;100;3.7;260;64
6128;Six-Pack;221554;\N;\N;\N;\N;\N;\N;\N;\N;\N;\N;\N;\N;\N
6129;Six Weeks;84691;0;0;0;0;0;0;0;0;0;0;0;0;0
6130;Soldier;120157;3.5;50;5;45;10;3.6;15;2;13;13;2.8;5503;46
6131;Some Kind of Hero;83107;0;0;0;0;0;0;0;0;0;0;0;0;0
6132;Lo squartatore di New York;84719;0;4;0;4;0;0;0;0;0;0;0;0;0
6133;Der Stand der Dinge;84725;0;4;2;2;50;0;0;0;0;0;0;0;0
6134;Starstruck;84728;0;1;1;0;100;0;0;0;0;0;0;0;0
6135;Still of the Night;84732;5.8;6;4;2;66;0;0;0;0;0;0;0;0
6137;Sword of the Valiant: The Legend of Sir Gawain and the Green Knight;84750;0;1;0;1;0;0;0;0;0;0;0;0;0
6138;Tag: The Assassination Game;84756;0;1;1;0;100;0;0;0;0;0;0;0;0
6139;The Tempest;81613;0;4;3;1;75;0;0;0;0;0;0;0;0
6140;Tenebre;84777;6.7;15;11;4;73;0;0;0;0;0;0;0;0
6141;My Name Is Bruce;489235;4.8;42;17;25;40;4.2;11;3;8;27;3.2;5111;50
6142;Time Walker;84796;0;0;0;0;0;0;0;0;0;0;0;0;0
6143;Trail of the Pink Panther;84814;3.8;11;3;8;27;0;0;0;0;0;0;0;0
6144;La traviata;84821;0;0;0;0;0;0;0;0;0;0;0;0;0
6145;Venom;428251;3.1;62;6;56;9;3.5;19;3;16;15;2.6;2557;30
6146;Finnegan Begin Again;89145;\N;\N;\N;\N;\N;\N;\N;\N;\N;\N;\N;\N;\N
6147;Die weiße Rose;84897;0;0;0;0;0;0;0;0;0;0;0;0;0
6148;White Dog;84899;7.6;10;9;1;90;0;0;0;0;0;0;0;0
6149;Who Dares Wins;83941;0;0;0;0;0;0;0;0;0;0;0;0;0
6150;Wrong Is Right;84920;5.1;8;3;5;37;0;2;0;2;0;3;305;38
6151;Yol;84934;0;1;1;0;100;0;0;0;0;0;0;0;0
6152;Il mondo di Yor;84935;2.8;5;1;4;20;0;0;0;0;0;0;0;0
6153;Zapped!;84945;2;10;0;10;0;0;1;0;1;0;2.8;878;42
6154;Deliver Us from Eva;301181;5.4;81;35;46;43;5.3;28;12;16;42;3.5;3415;78
6155;How to Lose a Guy in 10 Days;251127;5;145;62;83;42;4.9;34;12;22;35;3.4;131729;78
6156;Shanghai Knights;300471;6;145;95;50;65;6.2;32;23;9;71;3.1;25826;63
6157;Daredevil;287978;5.2;210;93;117;44;4.4;35;9;26;25;2.8;46864;46
6158;The Jungle Book 2;283426;4.4;85;16;69;18;4.1;25;4;21;16;2.9;4176;48
6159;All the Real Girls;299458;6.9;110;78;32;70;6.7;29;22;7;75;3.9;2897;80
6160;Amandla! A Revolution in Four Part Harmony;303297;7.1;61;50;11;81;7.6;17;15;2;88;4;313;86
6161;Chihwaseon;317234;0;0;0;0;0;0;0;0;0;0;0;0;0
6162;Jerry Maguire;116695;7.4;57;48;9;84;7.5;19;17;2;89;3.3;32601;72
6163;À la folie... pas du tout;291579;6.8;71;52;19;73;6.9;24;18;6;75;3.8;6623;82
6164;Lockdown;196708;\N;\N;\N;\N;\N;\N;\N;\N;\N;\N;\N;\N;\N
6166;Dennis the Menace;106701;3.9;22;5;17;22;4.9;7;2;5;28;2.7;11273;44
6167;The Stand;108941;\N;\N;\N;\N;\N;\N;\N;\N;\N;\N;\N;\N;\N
6168;10 to Midnight;85121;0;4;1;3;25;0;0;0;0;0;0;0;0
6169;The Black Stallion Returns;85248;0;2;0;2;0;0;1;0;1;0;3.5;1102;77
6170;The Black Stallion;78872;7.7;21;18;3;85;6;5;3;2;60;3.2;3574;76
6172;A Countess from Hong Kong;61523;0;4;2;2;50;0;0;0;0;0;0;0;0
6173;Into the West;104522;6.4;10;7;3;70;0;2;1;1;50;3.6;744;73
6174;Kinjite: Forbidden Subjects;97670;3.6;6;0;6;0;0;1;0;1;0;3;491;40
6175;Messenger of Death;95626;0;0;0;0;0;0;0;0;0;0;0;0;0
6176;Mr. Majestyk;71866;6;8;6;2;75;0;0;0;0;0;0;0;0
6177;Murphy's Law;91575;0;3;1;2;33;0;0;0;0;0;0;0;0
6178;A Patch of Blue;59573;8;5;5;0;100;0;0;0;0;0;0;0;0
6179;A Prayer for the Dying;93771;5.3;8;5;3;62;0;1;0;1;0;3.1;695;51
6180;Q;84556;0;0;0;0;0;0;0;0;0;0;0;0;0
6181;The Red Badge of Courage;43961;7.6;9;8;1;88;0;0;0;0;0;0;0;0
6182;The Thrill of It All;57581;0;2;1;1;50;0;0;0;0;0;0;0;0
6183;Pillow Talk;53172;7.1;23;21;2;91;0;3;2;1;66;3.8;3898;85
6184;The Man Who Fell to Earth;74851;7.8;22;19;3;86;6.8;5;3;2;60;3.6;3805;71
6185;Dark Blue;279331;5.8;127;73;54;57;5.8;32;18;14;56;3.1;2377;50
6186;Gods and Generals;279111;3.5;119;9;110;7;3.5;29;1;28;3;3.5;2681;67
6187;The Life of David Gale;289992;4.2;153;30;123;19;4.1;36;5;31;13;3.6;17064;81
6188;Old School;302886;5.6;165;99;66;60;5.4;31;16;15;51;3.7;85493;84
6190;Lawless Heart;276276;7.1;51;43;8;84;7.2;22;19;3;86;3.6;186;59
6191;The Navigators;279977;7.3;10;10;0;100;0;3;3;0;100;3.6;355;75
6192;Elsker dig for evigt;315543;7.6;55;53;2;96;7.4;16;15;1;93;4.1;1075;88
6193;Poolhall Junkies;273982;4.6;44;15;29;34;4.1;12;2;10;16;3.9;3976;87
6194;Till Human Voices Wake Us;240980;4.9;70;17;53;24;4.8;23;4;19;17;3.6;697;68
6195;Stone Reader;324080;7.2;64;53;11;82;7.3;22;18;4;81;3.5;316;66
6196;Cradle 2 the Grave;306685;4.5;118;31;87;26;4.3;24;8;16;33;3.2;15487;61
6197;Spider;278731;7.5;126;107;19;84;7.6;34;30;4;88;3.3;4398;67
6198;American Heart;103670;6.4;8;6;2;75;0;1;1;0;100;3.4;430;61
6199;Edie & Pen;116169;0;0;0;0;0;0;0;0;0;0;0;0;0
6200;Insignificance;89343;6.6;8;7;1;87;0;1;1;0;100;3.7;200;70
6201;Lady Jane;91374;5.4;7;4;3;57;0;0;0;0;0;0;0;0
6202;Hatuna Meuheret;287471;7.3;64;56;8;87;8;21;21;0;100;3.7;332;74
6203;Life Stinks;102303;3.9;15;3;12;20;0;1;1;0;100;2.9;1450;44
6204;The Meteor Man;107563;4.3;14;4;10;28;0;3;0;3;0;2.4;857;36
6205;Mr. North;95665;5.6;7;3;4;42;0;1;0;1;0;2.8;95;29
6206;Dead Poets Society;97165;7.2;49;42;7;85;6.5;7;5;2;71;3.8;56733;90
6207;The Slaughter Rule;266971;5.9;25;17;8;68;5.6;6;4;2;66;3.1;349;44
6208;Teenagers from Outer Space;53337;0;4;1;3;25;0;0;0;0;0;0;0;0
6209;Trouble Bound;105645;0;4;1;3;25;0;0;0;0;0;0;0;0
6210;WaSanGo;301429;0;0;0;0;0;0;0;0;0;0;0;0;0
6211;Enchanted;461770;7.3;157;145;12;92;7.4;34;31;3;91;3.8;188655;80
6212;Bringing Down the House;305669;4.7;144;49;95;34;4.8;32;12;20;37;3.1;17625;60
6213;Tears of the Sun;314353;5;148;50;98;33;4.8;36;13;23;36;3.4;24615;72
6214;Irréversible;290673;0;0;0;0;0;0;0;0;0;0;0;0;0
6215;Laurel Canyon;298408;6.4;108;73;35;67;6.6;30;20;10;66;3.2;2829;52
6216;Nirgendwo in Afrika;161860;7.5;97;83;14;85;7.6;30;25;5;83;4;1773;88
6217;The Safety of Objects;256359;5.9;72;35;37;48;5.5;27;11;16;40;3.5;1184;68
6218;Bend It Like Beckham;286499;7.2;147;125;22;85;6.9;32;26;6;81;3.2;49098;69
6219;The Hunted;269347;4.7;143;44;99;30;4.5;34;10;24;29;3;5362;51
6220;Willard;310357;6.2;124;80;44;64;5.7;27;15;12;55;2.9;3602;49
6221;Gaudi Afternoon;235412;4.7;17;5;12;29;3.2;6;0;6;0;3.1;152;40
6222;Prozac Nation;236640;4.6;23;6;17;26;4.5;5;2;3;40;3.3;5783;61
6223;Spun;283003;4.7;77;28;49;36;4.1;23;4;19;17;3.5;14251;74
6224;Zir-e poost-e shahr;250125;7;30;26;4;86;7.5;12;11;1;91;3.6;242;72
6225;King of Kings;55047;6.2;14;11;3;78;0;4;2;2;50;3.7;879;75
6226;Die verlorene Ehre der Katharina Blum oder: Wie Gewalt entstehen und wohin sie führen kann;73858;7.2;9;8;1;88;0;1;0;1;0;3.9;286;83
6228;The Talk of the Town;35417;7.4;14;13;1;92;0;2;2;0;100;3.8;815;83
6229;Two-Lane Blacktop;67893;7.5;25;23;2;92;7.6;5;5;0;100;3.9;1567;83
6230;Bang the Drum Slowly;69765;7.4;24;21;3;87;0;3;3;0;100;3.4;1003;62
6231;The Benny Goodman Story;47873;0;2;2;0;100;0;0;0;0;0;0;0;0
6232;Born Free;60182;6.6;10;9;1;90;0;0;0;0;0;0;0;0
6233;Born Yesterday;42276;8.1;20;19;1;95;0;2;1;1;50;3.9;1132;86
6234;Equus;75995;6;14;9;5;64;0;0;0;0;0;0;0;0
6235;Europa Europa;99776;7.5;14;14;0;100;0;1;1;0;100;4.1;1867;90
6236;Fear Strikes Out;50383;6.3;10;7;3;70;0;0;0;0;0;0;0;0
6237;The Glenn Miller Story;47030;7.3;8;7;1;87;0;0;0;0;0;0;0;0
6238;Green Card;99699;5.4;17;9;8;52;0;2;2;0;100;2.8;3609;45
6239;Journey to the Center of the Earth;373051;6;148;91;57;61;6.6;31;24;7;77;3.2;38002;55
6240;One Good Cop;102593;4.4;11;2;9;18;0;2;0;2;0;2.8;845;32
6241;Pauline à la plage;86087;8.8;8;8;0;100;0;2;2;0;100;3.8;644;82
6242;Ringu;178868;0;0;0;0;0;0;0;0;0;0;0;0;0
6243;Ringu 2;218553;3.6;14;0;14;0;4.2;5;0;5;0;3.2;2782;55
6244;Salaam Bombay!;96028;7.9;12;11;1;91;0;3;3;0;100;4.1;1353;91
6245;Sweet Charity;65054;0;3;3;0;100;0;0;0;0;0;0;0;0
6246;Talent for the Game;103036;\N;\N;\N;\N;\N;\N;\N;\N;\N;\N;\N;\N;\N
6247;Women in Love;66579;0;0;0;0;0;0;0;0;0;0;0;0;0
6248;Japón;322824;7.4;25;20;5;80;8.1;8;8;0;100;3.7;545;72
6249;Boat Trip;285462;2.6;87;6;81;6;3;22;2;20;9;2.7;8176;44
6250;The Dream Catcher;128170;\N;\N;\N;\N;\N;\N;\N;\N;\N;\N;\N;\N;\N
6251;Piglet's Big Movie;323642;6.3;74;54;20;72;6;22;14;8;63;3.4;1599;66
6252;View from the Top;264150;3.7;122;17;105;13;3.6;30;3;27;10;2.6;4839;36
6254;The Awful Truth;28597;8;23;21;2;91;0;2;2;0;100;4;2109;88
6255;For the Bible Tells Me So;912583;7.5;47;46;1;97;7.6;16;16;0;100;4.1;1345;89
6256;La casa dalle finestre che ridono;74287;0;2;2;0;100;0;0;0;0;0;0;0;0
6257;Jag är nyfiken - en film i gult;61834;5.2;24;12;12;50;0;4;2;2;50;3.6;513;64
6258;Les dames du Bois de Boulogne;37630;8.3;12;12;0;100;0;2;2;0;100;3.8;470;77
6259;Flicka;434215;5.7;76;41;35;53;5.6;24;12;12;50;3.7;22360;82
6260;Black Robe;101465;7;12;11;1;91;0;1;0;1;0;3.3;1641;60
6261;Wind;105824;5.8;10;5;5;50;0;2;2;0;100;3.5;661;71
6262;Ren xiao yao;318025;6.6;27;17;10;62;6.2;7;5;2;71;3.5;432;67
6263;Basic;264395;4.5;141;30;111;21;4.8;34;8;26;23;3.2;9571;66
6264;The Core;298814;5.3;150;63;87;42;5.3;31;14;17;45;2.7;16895;41
6265;Head of State;325537;4.8;116;35;81;30;4.8;26;7;19;26;2.8;5662;51
6266;What a Girl Wants;286788;4.8;103;35;68;33;4.5;27;6;21;22;3.2;68538;67
6267;Assassination Tango;283897;5.6;87;42;45;48;6;29;14;15;48;2.9;572;37
6268;Raising Victor Vargas;316188;7.9;105;101;4;96;8;31;31;0;100;3.8;1155;81
6269;The Life Aquatic with Steve Zissou;362270;6.3;14;10;4;71;5.9;9;6;3;66;3.8;65;81
6270;Dreams;100998;5.8;17;9;8;52;5.4;5;3;2;60;4.1;4853;87
6271;La nuit américaine;70460;8.6;22;22;0;100;0;2;2;0;100;4.1;2313;90
6272;Eye of God;116261;6.8;12;10;2;83;0;2;2;0;100;3.9;140;82
6273;In a Lonely Place;42593;8.5;28;28;0;100;0;4;4;0;100;4;1654;87
6274;Physical Evidence;98093;3.3;16;2;14;12;0;4;0;4;0;2.6;340;19
6275;Square Dance;94020;0;3;0;3;0;0;1;0;1;0;3.2;289;48
6276;Wake of the Red Witch;40946;0;2;2;0;100;0;0;0;0;0;0;0;0
6277;Winter Kills;80139;7;14;12;2;85;0;3;2;1;66;3.3;254;49
6278;Fellini: Je suis un grand menteur;314062;6.6;40;29;11;72;6.4;12;8;4;66;3.3;437;59
6279;The Good Thief;281820;6.8;138;107;31;77;7;36;29;7;80;3.2;1301;58
6280;A Man Apart;266465;4;129;14;115;10;3.9;31;3;28;9;3.4;15785;68
6281;Phone Booth;183649;6.6;184;131;53;71;6.2;35;22;13;62;3.1;27495;63
6282;Cet amour-là;277622;0;0;0;0;0;0;0;0;0;0;0;0;0
6283;Cowboy Bebop: Tengoku no tobira;275277;6.3;69;45;24;65;6.4;19;11;8;57;3.9;8587;89
6284;DysFunktional Family;337996;5.2;63;27;36;42;5.2;19;9;10;47;3.7;483;73
6285;Levity;304328;5.3;87;31;56;35;4.9;29;7;22;24;3;1220;44
6286;Mies vailla menneisyyttä;311519;8;92;90;2;97;8.2;29;29;0;100;4;2471;90
6287;Anger Management;305224;5.1;188;81;107;43;5.1;39;18;21;46;3.3;70407;66
6288;Better Luck Tomorrow;280477;7;95;76;19;80;6.8;32;24;8;75;3.6;1992;76
6289;Ghosts of the Abyss;297144;7.1;94;76;18;80;7.1;24;21;3;87;3.3;1345;60
6290;House of 1000 Corpses;251736;3.3;77;13;64;16;2.6;13;0;13;0;3.2;25214;68
6291;Lilja 4-ever;300140;7.6;67;58;9;86;7.8;24;23;1;95;4.1;4008;90
6292;Marion Bridge;329355;6.2;16;12;4;75;6.3;8;6;2;75;3.3;388;58
6293;XX/XY;245573;5.3;61;27;34;44;5.3;26;12;14;46;3.1;728;44
6294;Bulletproof Monk;245803;4.3;130;28;102;21;4;31;5;26;16;2.9;13789;50
6295;Chasing Papi;323572;3.7;47;6;41;12;3.9;20;3;17;15;2.8;1064;43
6296;A Mighty Wind;310281;7.4;171;150;21;87;7.4;38;33;5;86;3.6;7120;81
6297;Holes;311289;7;132;102;30;77;6.9;33;24;9;72;3.3;16191;72
6298;Malibu's Most Wanted;328099;4.6;91;27;64;29;4.2;27;4;23;14;2.6;6955;54
6299;Le peuple migrateur;301727;8.2;126;121;5;96;8.4;36;36;0;100;4;1576;85
6300;Blinkende lygter;236027;6.3;10;7;3;70;0;4;2;2;50;4.3;1010;92
6301;Straw Dogs;67800;8.4;30;28;2;93;0;4;2;2;50;3.8;5295;82
6302;Beginning of the End;50177;0;4;2;2;50;0;0;0;0;0;0;0;0
6303;The Andromeda Strain;424600;0;2;1;1;50;0;0;0;0;0;0;0;0
6304;Brainscan;109327;4;10;2;8;20;0;2;0;2;0;3.1;1960;56
6305;Fahrenheit 451;60390;7.5;29;25;4;86;0;3;1;2;33;3.5;5957;70
6306;I Am Trying to Break Your Heart;327920;6.9;59;52;7;88;6.7;20;18;2;90;4;998;88
6307;The Iceman Cometh;70212;6.9;8;7;1;87;6.9;5;4;1;80;3.8;322;67
6308;Legal Eagles;91396;5.2;14;7;7;50;0;1;0;1;0;2.8;875;32
6309;Married to It;107523;4.6;10;3;7;30;0;2;0;2;0;2.9;355;33
6310;Memories of Me;95613;0;2;1;1;50;0;1;1;0;100;2.9;313;40
6311;The Other Side of Heaven;250371;4.6;41;11;30;26;4;12;1;11;8;3.6;2400;74
6312;A Private Function;89838;0;3;3;0;100;0;0;0;0;0;0;0;0
6313;Sibling Rivalry;100611;3.5;8;1;7;12;0;2;0;2;0;2.8;481;33
6314;Undercover Blues;108442;5;17;6;11;35;0;4;1;3;25;3;1603;56
6315;Wildcats;92214;3.9;16;2;14;12;0;3;0;3;0;3.1;1616;51
6316;The Wiz;78504;4.7;19;7;12;36;0;0;0;0;0;0;0;0
6317;Cartouche;55832;0;0;0;0;0;0;0;0;0;0;0;0;0
6318;The Marrying Man;102411;3.2;14;1;13;7;0;2;1;1;50;2.7;603;36
6319;Mon père, ce héros.;102465;0;0;0;0;0;0;0;0;0;0;0;0;0
6320;Scenes from a Mall;102849;4.3;23;7;16;30;3.7;6;2;4;33;2.6;1017;29
6321;How Stella Got Her Groove Back;120703;5.5;47;23;24;48;5.8;12;7;5;58;3.1;4439;72
6322;Confidence;310910;6.3;150;106;44;70;6.1;40;25;15;62;3.4;3860;69
6323;Identity;309698;6.4;166;103;63;62;6.1;35;20;15;57;3.4;21479;76
6324;It Runs in the Family;311110;4.5;95;27;68;28;4.6;29;11;18;37;2.7;901;32
6325;The Real Cancun;360916;4.2;86;30;56;34;4.4;22;8;14;36;2.2;744;28
6326;City of Ghosts;164003;5.5;66;31;35;46;5.8;23;11;12;47;3.1;795;45
6327;A Decade Under the Influence;342275;6.7;30;23;7;76;6.9;12;9;3;75;3.8;1167;80
6328;Dom durakov;332605;5;47;18;29;38;4.9;18;7;11;38;3.8;736;79
6329;Manic;252684;\N;\N;\N;\N;\N;\N;\N;\N;\N;\N;\N;\N;\N
6330;People I Know;274711;5.4;51;22;29;43;5.7;17;7;10;41;2.9;1615;35
6331;Spellbound;38109;7.3;30;26;4;86;0;1;1;0;100;3.8;4332;82
6332;The Lizzie McGuire Movie;306841;5.4;96;38;58;39;5.7;29;16;13;55;2.7;32236;57
6333;X2;290334;7.4;221;194;27;87;6.9;40;33;7;82;3.7;110058;84
6334;Blue Car;290145;6.9;85;69;16;81;7.2;33;30;3;90;3.3;652;62
6335;The Dancer Upstairs;118926;6.4;112;71;41;63;6.6;35;26;9;74;3.6;1196;73
6336;Gomgashtei dar Aragh;317226;7.6;27;25;2;92;8.1;10;10;0;100;3.9;152;81
6337;Owning Mahowny;285861;7;93;73;20;78;6.8;31;24;7;77;3.5;1339;71
6338;Daddy Day Care;317303;4.5;124;35;89;28;4.6;34;9;25;26;3.2;35165;63
6339;L'homme du train;301414;7.5;109;100;9;91;7.6;35;33;2;94;3.7;1127;79
6340;Only the Strong Survive;308672;5.9;44;27;17;61;6.1;22;15;7;68;3.3;234;51
6341;The Shape of Things;308878;6.3;134;86;48;64;5.7;39;20;19;51;3.4;2043;64
6342;Road Trip;215129;5.9;89;52;37;58;5.9;21;14;7;66;3.3;57286;68
6343;Washington Heights;314871;6.1;38;30;8;78;6;15;12;3;80;3.3;157;57
6344;101 Reykjavík;237993;7;46;41;5;89;7.5;11;10;1;90;3.6;2003;71
6345;A Chorus Line;88915;4.8;14;6;8;42;0;1;1;0;100;3.4;2567;64
6346;Absolute Beginners;90585;5.9;7;6;1;85;0;0;0;0;0;0;0;0
6347;Beat Street;86946;0;4;1;3;25;0;0;0;0;0;0;0;0
6348;Breakin' 2: Electric Boogaloo;86999;0;3;1;2;33;0;1;1;0;100;3.4;1507;66
6349;Breakin';86998;4;6;2;4;33;0;0;0;0;0;0;0;0
6350;Tenkû no shiro Rapyuta;92067;7.2;17;16;1;94;0;2;1;1;50;4.1;25837;89
6351;Hysterical Blindness;290664;5.4;10;7;3;70;0;3;2;1;66;0;0;0
6352;Lambada;99969;0;0;0;0;0;0;0;0;0;0;0;0;0
6353;Roadie;81433;0;4;0;4;0;0;1;0;1;0;3.2;251;55
6354;The Carpetbaggers;57917;5.6;6;3;3;50;0;0;0;0;0;0;0;0
6355;Les Girls;50631;0;4;4;0;100;0;0;0;0;0;0;0;0
6356;Gunfight at the O.K. Corral;50468;6.9;11;9;2;81;0;0;0;0;0;0;0;0
6357;High Society;49314;6.7;15;11;4;73;0;2;1;1;50;3.8;2979;82
6358;Kiss Me Kate;45963;7;10;8;2;80;0;2;1;1;50;3.6;1732;73
6365;The Matrix Reloaded;234215;6.8;233;171;62;73;6.5;43;31;12;72;3.4;124014;74
6366;Dracula: Pages from a Virgin's Diary;293113;7.4;59;51;8;86;7.8;21;19;2;90;3.5;898;70
6367;Down with Love;309530;8.3;5;5;0;100;0;1;1;0;100;3.3;44;67
6368;Cinemania;281724;6.8;37;32;5;86;7.3;10;9;1;90;3.3;411;59
6369;Friends and Family;206762;4.4;18;8;10;44;4;6;2;4;33;3.5;319;64
6370;L'auberge espagnole;283900;6.5;89;68;21;76;6.7;32;27;5;84;3.9;9251;85
6371;Pokémon Heroes;347791;3.6;37;6;31;16;3.7;14;4;10;28;3.4;3562;65
6373;Evan Almighty;413099;4.5;190;44;146;23;4;39;3;36;7;3.2;369422;56
6374;The In-Laws;314786;4.9;126;44;82;34;4.9;35;12;23;34;2.9;2546;42
6375;Gigantic (A Tale of Two Johns);304081;7.1;45;37;8;82;7;19;16;3;84;4;397;88
6376;Respiro;286516;6.6;84;64;20;76;6.5;26;19;7;73;3.9;757;82
6377;Finding Nemo;266543;8.5;198;195;3;98;8.5;40;40;0;100;3.8;252174;80
6378;The Italian Job;317740;6.4;178;129;49;72;6.7;40;32;8;80;3.6;103062;79
6379;Wrong Turn;295700;4.3;77;31;46;40;3.7;13;3;10;23;3.1;24686;63
6380;Capturing the Friedmans;342172;8.4;146;142;4;97;8.4;39;38;1;97;3.9;2794;87
6382;He ni zai yi qi;332639;6.7;77;56;21;72;6.7;26;20;6;76;4.1;1005;88
6383;2 Fast 2 Furious;322259;4.8;155;56;99;36;4.8;33;13;20;39;3.1;176485;59
6384;Love the Hard Way;263671;4.8;43;12;31;27;4.8;20;5;15;25;3.6;697;66
6385;Whale Rider;298228;7.7;143;129;14;90;7.5;35;30;5;85;3.8;9564;87
6386;Nevada Smith;60748;6.5;6;4;2;66;0;0;0;0;0;0;0;0
6387;Zong heng si hai;101020;6.5;5;3;2;60;0;0;0;0;0;0;0;0
6388;Regeneration;120001;0;0;0;0;0;0;0;0;0;0;0;0;0
6390;Silk Stockings;50972;0;4;4;0;100;0;0;0;0;0;0;0;0
6391;Snowball Express;69291;0;0;0;0;0;0;0;0;0;0;0;0;0
6392;A Man Called Horse;66049;6.9;14;12;2;85;0;0;0;0;0;0;0;0
6394;Big Jake;66831;0;4;4;0;100;0;0;0;0;0;0;0;0
6395;Movie Crazy;23241;0;1;0;1;0;0;0;0;0;0;0;0;0
6396;Dementia 13;56983;5.7;17;10;7;58;0;1;0;1;0;3;1086;41
6397;Drôle de drame ou L'étrange aventure du Docteur Molyneux;27552;6.6;9;7;2;77;0;2;2;0;100;3.8;73;76
6398;Le Mans;67334;5.8;6;3;3;50;0;0;0;0;0;0;0;0
6400;Un coupable idéal;307197;0;3;2;1;66;0;0;0;0;0;0;0;0
6401;Rio Lobo;66301;6.1;19;14;5;73;0;3;1;2;33;3.7;1553;75
6402;Siam Sunset;178022;6;8;5;3;62;0;2;1;1;50;3.6;119;67
6403;The Swimmer;63663;7.7;18;18;0;100;0;3;3;0;100;3.8;683;79
6404;Lo sceicco bianco;44000;7.8;11;11;0;100;0;1;1;0;100;3.6;726;74
6405;Treasure Island;100813;0;0;0;0;0;0;0;0;0;0;0;0;0
6406;Due occhi diabolici;100827;5.2;9;4;5;44;0;0;0;0;0;0;0;0
6407;Walk Don't Run;61170;6.4;5;4;1;80;0;0;0;0;0;0;0;0
6408;Animals Are Beautiful People;71143;0;2;2;0;100;0;0;0;0;0;0;0;0
6409;Bend of the River;44413;8.4;5;5;0;100;0;0;0;0;0;0;0;0
6410;Car Wash;74281;6.7;21;18;3;85;0;4;4;0;100;3.2;1578;59
6411;Come September;54759;6.1;5;4;1;80;0;0;0;0;0;0;0;0
6412;Destry Rides Again;31225;7.7;16;16;0;100;0;0;0;0;0;0;0;0
6413;The Electric Horseman;79100;5.6;18;11;7;61;0;3;2;1;66;3.1;713;53
6414;Gay Purr-ee;57093;0;4;3;1;75;0;0;0;0;0;0;0;0
6415;Intervista;93267;6.9;11;8;3;72;0;3;2;1;66;3.6;467;68
6416;King Rat;59358;0;3;3;0;100;0;0;0;0;0;0;0;0
6417;Live Wire;104743;2.4;5;0;5;0;0;0;0;0;0;0;0;0
6419;Mr. & Mrs. Bridge;100200;5.8;15;11;4;73;0;1;1;0;100;3.1;465;43
6421;The Rare Breed;60884;5.1;6;2;4;33;0;0;0;0;0;0;0;0
6422;Shenandoah;59711;0;3;3;0;100;0;0;0;0;0;0;0;0
6423;Straight Talk;105481;5.2;9;4;5;44;0;1;0;1;0;2.9;1027;51
6424;Oscar;102603;3.4;15;2;13;13;0;1;0;1;0;2.8;3494;56
6425;The Sixth Man;120142;3.8;13;3;10;23;0;4;0;4;0;3;1793;54
6426;The Far Country;48055;7.8;10;10;0;100;0;0;0;0;0;0;0;0
6427;The Railway Children;215111;0;0;0;0;0;0;0;0;0;0;0;0;0
6428;Two Mules for Sister Sara;65134;6.3;8;6;2;75;0;1;0;1;0;3.5;3250;69
6429;Winchester '73;43137;8.2;16;16;0;100;0;3;3;0;100;3.8;1273;84
6430;Ziggy Stardust and the Spiders from Mars;86643;6.1;28;20;8;71;6.2;8;5;3;62;3.6;27;60
6431;Battle Cry;47860;0;3;3;0;100;0;0;0;0;0;0;0;0
6432;The Courtship of Eddie's Father;56956;0;4;2;2;50;0;0;0;0;0;0;0;0
6433;Chelovek s kino-apparatom;19760;8.9;21;20;1;95;0;2;1;1;50;4.1;2142;88
6434;Objective, Burma!;37954;0;2;1;1;50;0;0;0;0;0;0;0;0
6435;Operation Pacific;43887;0;3;1;2;33;0;0;0;0;0;0;0;0
6436;This Boy's Life;108330;6.3;34;26;8;76;5;10;4;6;40;3.5;5072;76
6437;13 Rue Madeleine;38279;6.2;6;5;1;83;0;0;0;0;0;0;0;0
6438;633 Squadron;57811;0;3;2;1;66;0;0;0;0;0;0;0;0
6439;Star Wars: Episode II - Attack of the Clones;121765;6.5;215;142;73;66;5.5;40;16;24;40;3.3;108730;69
6440;Barton Fink;101410;7.6;50;45;5;90;7.6;10;9;1;90;3.9;12267;88
6441;Battle of Britain;64072;5.5;8;5;3;62;0;1;0;1;0;3.8;2265;79
6442;Belle epoque;103791;7.5;15;14;1;93;0;3;3;0;100;3.6;1565;74
6443;The Big Trail;20691;6.8;7;7;0;100;0;0;0;0;0;0;0;0
6445;Cloak & Dagger;87065;5;5;2;3;40;0;0;0;0;0;0;0;0
6446;The Comancheros;54757;0;4;4;0;100;0;0;0;0;0;0;0;0
6447;Duel at Diablo;60355;0;3;3;0;100;0;0;0;0;0;0;0;0
6448;Flight of the Phoenix;377062;4.8;115;34;81;29;4.4;27;5;22;18;3;7566;48
6449;From the Terrace;53841;4.8;8;3;5;37;0;3;1;2;33;3.6;330;73
6450;Heaven Knows, Mr. Allison;50490;7;7;6;1;85;0;0;0;0;0;0;0;0
6451;The Hot Rock;68718;6;8;5;3;62;0;1;0;1;0;3.4;651;61
6452;The Long, Hot Summer;51878;7.2;15;13;2;86;0;4;2;2;50;3.8;1470;84
6453;Man of Aran;25456;7.6;15;14;1;93;0;3;3;0;100;3.6;320;72
6454;Music Box;100211;6.4;14;9;5;64;0;1;0;1;0;0;0;0
6455;North to Alaska;54127;4.7;6;2;4;33;0;0;0;0;0;0;0;0
6456;Que la bête meure;64861;7.9;6;6;0;100;0;1;1;0;100;3.7;342;78
6457;Sink the Bismarck!;54310;0;4;3;1;75;0;0;0;0;0;0;0;0
6458;The Blue Max;60177;0;4;4;0;100;0;0;0;0;0;0;0;0
6459;The Desert Fox: The Story of Rommel;43461;7;6;5;1;83;0;0;0;0;0;0;0;0
6460;Le procès;57427;7.4;25;22;3;88;7.3;5;4;1;80;4;1771;88
6461;Unforgiven;105695;8.5;56;54;2;96;7.5;11;9;2;81;4;27203;91
6462;The Undefeated;65150;0;4;1;3;25;0;1;0;1;0;3.6;1146;72
6463;Divine Trash;150338;6.9;5;4;1;80;0;1;1;0;100;3.7;350;77
6464;Good Burger;119215;4.3;26;8;18;30;4.7;9;3;6;33;2.7;7419;60
6465;Jubilee;76240;0;3;3;0;100;0;0;0;0;0;0;0;0
6466;Mississippi Masala;102456;6.7;19;15;4;78;0;4;4;0;100;3.4;1551;64
6467;Quai des Orfèvres;39739;8.3;30;30;0;100;8.3;11;11;0;100;3.9;498;87
6468;A Stranger Among Us;105483;4.8;13;4;9;30;0;2;0;2;0;2.7;1243;35
6469;Cahill U.S. Marshal;69834;0;1;0;1;0;0;0;0;0;0;0;0;0
6470;Chisum;65547;5.2;5;3;2;60;0;0;0;0;0;0;0;0
6471;Defence of the Realm;89009;7.1;5;5;0;100;0;1;1;0;100;3.2;256;60
6472;Eat a Bowl of Tea;97261;0;3;3;0;100;0;0;0;0;0;0;0;0
6473;Half Moon Street;91164;5.5;5;3;2;60;0;1;1;0;100;2.8;382;29
6474;La tregua;117959;6.1;15;8;7;53;5.9;6;3;3;50;3.6;202;63
6475;Opportunity Knocks;100301;4.5;8;2;6;25;0;1;0;1;0;2.9;523;45
6476;Shattered Glass;323944;7.7;163;148;15;90;7.5;37;31;6;83;3.5;4409;76
6477;The Song of Bernadette;36377;6.9;9;7;2;77;0;0;0;0;0;0;0;0
6478;The Life and Times of Judge Roy Bean;68853;5.8;7;5;2;71;0;1;0;1;0;3.4;951;66
6479;The Spirit of '76;100670;\N;\N;\N;\N;\N;\N;\N;\N;\N;\N;\N;\N;\N
6480;Thoroughly Modern Millie;62362;7.6;9;9;0;100;0;0;0;0;0;0;0;0
6481;Where the Heart Is;198021;4.6;94;32;62;34;3.9;27;5;22;18;3.5;12595;78
6482;Dumb and Dumberer: When Harry Met Lloyd;329028;2.8;116;12;104;10;2.5;31;1;30;3;2.4;17380;37
6483;From Justin to Kelly;339034;2.8;59;5;54;8;2.7;16;1;15;6;2;6715;39
6484;Hollywood Homicide;329717;4.7;158;47;111;29;4.8;37;10;27;27;2.6;6121;32
6485;Rugrats Go Wild;337711;5;83;33;50;39;4.9;28;12;16;42;2.9;2842;47
6486;The Hard Word;280490;5.5;82;33;49;40;5.5;26;10;16;38;3;615;45
6487;The Heart of Me;301390;5.5;55;27;28;49;5.2;24;10;14;41;3.5;659;62
6488;Décalage horaire;293116;5.8;66;37;29;56;6.1;26;16;10;61;3.1;1234;49
6489;Mi Casa, Su Casa;293452;0;4;1;3;25;0;2;1;1;50;2.7;164;33
6490;Manito;298050;7.3;31;29;2;93;7.8;14;14;0;100;3.5;124;65
6491;Best of the Best 3: No Turning Back;112483;0;0;0;0;0;0;0;0;0;0;0;0;0
6492;Oligarkh;308671;5.5;34;15;19;44;5.9;17;10;7;58;3.8;77;73
6493;Alex & Emma;318283;3.7;131;14;117;10;3.3;36;2;34;5;2.8;7767;42
6494;On_Line;302889;4.6;39;15;24;38;3.7;17;2;15;11;2.3;8;0
6495;Experiment in Terror;55972;0;4;4;0;100;0;0;0;0;0;0;0;0
6496;Éxtasis;118239;0;0;0;0;0;0;0;0;0;0;0;0;0
6497;Paris brûle-t-il?;60814;6.4;5;4;1;80;0;0;0;0;0;0;0;0
6498;Murphy's War;67458;0;2;0;2;0;0;1;0;1;0;3.4;129;58
6499;Orphans of the Storm;12532;0;4;3;1;75;0;0;0;0;0;0;0;0
6500;The Satanic Rites of Dracula;70634;0;0;0;0;0;0;0;0;0;0;0;0;0
6502;28 Days Later...;289043;7.3;200;177;23;88;7.1;39;34;5;87;3.6;107149;82
6503;Charlie's Angels: Full Throttle;305357;5;171;74;97;43;5;37;15;22;40;3;33126;54
6504;Benzina;302309;\N;\N;\N;\N;\N;\N;\N;\N;\N;\N;\N;\N;\N
6505;Ed and His Dead Mother;106792;5.4;6;3;3;50;0;0;0;0;0;0;0;0
6506;Chuen jik sat sau;286635;6.2;32;18;14;56;5.8;10;5;5;50;3.7;2062;74
6507;Just a Little Harmless Sex;175777;4.4;5;1;4;20;0;0;0;0;0;0;0;0
6508;The Bank Job;200465;6.7;137;108;29;78;7.1;31;28;3;90;3.5;60915;74
6509;Angst essen Seele auf;71141;9.2;16;16;0;100;0;2;2;0;100;4.1;1799;89
6510;Bodies, Rest & Motion;106447;5;28;16;12;57;5.2;8;4;4;50;3;516;37
6511;The Blood of Jesus;33406;0;1;1;0;100;0;0;0;0;0;0;0;0
6512;The Long Ships;57259;4.7;6;3;3;50;0;0;0;0;0;0;0;0
6513;Made for Each Other;31602;0;2;2;0;100;0;0;0;0;0;0;0;0
6514;Ring of Terror;56415;\N;\N;\N;\N;\N;\N;\N;\N;\N;\N;\N;\N;\N
6515;You Only Live Once;29808;9;5;5;0;100;0;0;0;0;0;0;0;0
6516;Anastasia;118617;7.1;48;41;7;85;7.1;9;7;2;77;3.2;33076;70
6517;Babe;112431;8.2;54;53;1;98;8.2;11;11;0;100;3;22954;54
6518;Flight of the Intruder;99587;4.3;11;3;8;27;0;2;0;2;0;3;858;50
6519;Fun with Dick and Jane;369441;4.9;131;38;93;29;5.2;30;9;21;30;3.2;80127;58
6520;Arthur! And the Square Knights of the Round Table;220912;\N;\N;\N;\N;\N;\N;\N;\N;\N;\N;\N;\N;\N
6521;The Main Event;79510;4.9;8;3;5;37;0;1;0;1;0;3;481;44
6522;Man's Favorite Sport?;58324;6.2;15;9;6;60;0;3;1;2;33;3.5;622;71
6523;Mr. Baseball;104926;4.2;15;2;13;13;0;1;1;0;100;2.7;1578;36
6524;Pote tin Kyriaki;54198;6.8;7;6;1;85;0;0;0;0;0;0;0;0
6525;Mixed Nuts;110538;2.8;28;2;26;7;2.5;6;0;6;0;2.9;2410;46
6526;Hachi-gatsu no kyôshikyoku;101991;5.8;8;5;3;62;5.6;5;3;2;60;3.6;1375;73
6527;Scaramouche;45125;0;3;1;2;33;0;0;0;0;0;0;0;0
6528;Start the Revolution Without Me;66402;6.6;5;4;1;80;0;0;0;0;0;0;0;0
6529;Strange Bedfellows;360032;6.7;5;4;1;80;0;0;0;0;0;0;0;0
6530;Le locataire;74811;7.8;29;26;3;89;6.6;5;4;1;80;4;3556;87
6531;The Hour of the Pig;107146;5.6;8;6;2;75;0;2;2;0;100;3.3;530;54
6532;Up the Sandbox;69449;0;3;2;1;66;0;1;1;0;100;2.9;358;37
6533;What's Up, Doc?;69495;7.1;33;30;3;90;0;4;3;1;75;3.9;2794;87
6534;The Incredible Hulk;800080;6.1;210;138;72;65;5.7;38;21;17;55;3.6;124298;75
6535;Legally Blonde 2: Red, White & Blonde;333780;4.8;147;55;92;37;5;36;14;22;38;2.9;41399;57
6536;Sinbad: Legend of the Seven Seas;165982;5.6;119;54;65;45;5.7;32;15;17;46;3.1;9338;57
6537;Terminator 3: Rise of the Machines;181852;6.6;195;137;58;70;6;38;22;16;57;3.2;42333;54
6538;Swimming Pool;324133;7.1;148;125;23;84;6.9;37;33;4;89;3.3;5988;65
6539;Pirates of the Caribbean: The Curse of the Black Pearl;325980;7.1;196;153;43;78;6.4;38;25;13;65;3.9;297546;86
6540;Madame Satã;317887;6.2;42;25;17;59;6.7;15;11;4;73;3.7;461;75
6541;The League of Extraordinary Gentlemen;311429;4;174;30;144;17;3.9;37;5;32;13;3;42753;54
6542;Kukushka;308476;7;62;54;8;87;7.2;23;21;2;91;4;791;87
6543;The Holy Land;283387;5.8;54;28;26;51;5.8;19;10;9;52;3.6;173;68
6544;Une femme de ménage;291538;6.5;60;46;14;76;7;22;20;2;90;3;76;35
6545;I Capture the Castle;300015;6.7;81;65;16;80;6.4;27;19;8;70;3.7;1744;76
6546;Km. 0;251777;5.6;44;24;20;54;5.6;16;8;8;50;3.6;424;72
6547;Northfork;322659;5.9;99;56;43;56;5.6;32;16;16;50;3.5;992;68
6548;Bad Boys II;172156;4.1;154;36;118;23;3.8;38;6;32;15;3.6;76903;80
6549;How to Deal;319524;4.5;92;26;66;28;4.7;32;9;23;28;3.1;6783;64
6550;Johnny English;274166;4.8;115;38;77;33;5.2;30;13;17;43;2.9;21762;54
6551;The Anarchist Cookbook;284850;4.2;18;7;11;38;3.7;6;2;4;33;3.3;718;58
6552;Dirty Pretty Things;301199;7.8;138;130;8;94;7.8;38;35;3;92;3.6;6668;79
6553;L'imbalsamatore;322725;6.8;32;26;6;81;6.9;15;14;1;93;3.5;350;67
6554;Garage Days;280696;5.1;52;23;29;44;4.7;17;6;11;35;3.3;1027;62
6555;Cavale;233418;6.8;40;29;11;72;6.9;14;10;4;71;3.1;37;60
6556;Umi wa miteita;316829;6.1;26;15;11;57;5.6;11;5;6;45;3.6;398;72
6557;Wild Hogs;486946;3.8;139;20;119;14;3.4;34;3;31;8;3.4;86633;72
6558;Curly Sue;101635;3.8;11;1;10;9;0;2;1;1;50;2.8;3986;49
6559;Little Giants;110364;3.9;9;3;6;33;0;1;0;1;0;3.1;9092;62
6560;Loose Cannons;100053;3;15;0;15;0;0;4;0;4;0;2.6;545;26
6561;The Mouse That Roared;53084;7.1;18;16;2;88;0;0;0;0;0;0;0;0
6562;Spencer's Mountain;57523;0;3;3;0;100;0;0;0;0;0;0;0;0
6563;Masked and Anonymous;319829;4;77;19;58;24;3.4;28;3;25;10;3;954;46
6564;Lara Croft Tomb Raider: The Cradle of Life;325703;4.5;163;39;124;23;4.5;36;7;29;19;3.1;34884;60
6565;Seabiscuit;329575;0;0;0;0;0;0;0;0;0;0;0;0;0
6566;Spy Kids 3-D: Game Over;338459;0;0;0;0;0;0;0;0;0;0;0;0;0
6567;Buffalo Soldiers;252299;6.6;110;79;31;71;6.3;34;23;11;67;3.4;3099;70
6568;Camp;342167;6;100;62;38;62;6.4;27;19;8;70;3.5;3093;70
6569;Hotel;278487;4.5;25;9;16;36;4.6;11;4;7;36;2.6;446;34
6570;La hija del caníbal;314170;5.4;48;21;27;43;5.6;20;7;13;35;3.4;312;57
6571;Los lunes al sol;319769;7;69;55;14;79;6.5;20;15;5;75;3.9;1360;86
6572;Scorched;286947;4.6;6;1;5;16;0;1;1;0;100;3;906;43
6573;Avanti!;68240;6.9;16;13;3;81;0;3;1;2;33;3.6;906;72
6574;Eve of Destruction;101831;2.8;6;0;6;0;0;0;0;0;0;0;0;0
6575;Stoked: The Rise and Fall of Gator;271211;6.6;47;37;10;78;6.6;19;15;4;78;3.8;199;78
6576;Juggernaut;71706;0;3;2;1;66;0;0;0;0;0;0;0;0
6577;Kickboxer 2: The Road Back;102202;0;1;1;0;100;0;0;0;0;0;0;0;0
6578;Kiss Me, Stupid;58265;6.4;20;15;5;75;6.4;6;5;1;83;3.4;784;66
6579;One, Two, Three;55256;7.7;17;16;1;94;0;4;4;0;100;4;1286;88
6580;Amores Possíveis;275915;0;2;2;0;100;0;0;0;0;0;0;0;0
6581;The Private Life of Sherlock Holmes;66249;7.6;21;20;1;95;7;5;4;1;80;3.5;1066;70
6582;Remo Williams: The Adventure Begins;89901;4.6;12;6;6;50;0;0;0;0;0;0;0;0
6583;The Blood of Heroes;94764;0;1;0;1;0;0;1;0;1;0;3.6;841;72
6584;What's Up, Tiger Lily?;61177;7;18;16;2;88;0;0;0;0;0;0;0;0
6585;White Lightning;70915;6.7;5;4;1;80;0;0;0;0;0;0;0;0
6586;American Wedding;328828;5.8;149;83;66;55;5.2;33;14;19;42;3.4;73646;72
6587;Gigli;299930;0;0;0;0;0;0;0;0;0;0;0;0;0
6588;And Now... Ladies and Gentlemen...;283883;5.4;72;34;38;47;5.5;26;12;14;46;3.3;642;51
6589;Boys Life 4: Four Play;369295;0;0;0;0;0;0;0;0;0;0;0;0;0
6590;I'll Be There;325352;5.2;6;3;3;50;0;1;1;0;100;3.3;685;59
6591;The Magdalene Sisters;318411;7.6;143;129;14;90;8.1;38;38;0;100;3.9;3422;87
6592;The Secret Lives of Dentists;314630;7.2;93;79;14;84;7.3;33;29;4;87;3.2;653;54
6593;Freaky Friday;322330;7;140;123;17;87;7;34;29;5;85;2.9;73112;60
6595;S.W.A.T.;257076;5.4;162;77;85;47;5.3;39;15;24;38;3.1;23455;63
6596;Le divorce;306734;5.2;133;49;84;36;5.7;37;16;21;43;2.5;3545;25
6597;Shura Yukihime;310149;5.9;28;16;12;57;5.8;10;6;4;60;3.3;1979;55
6598;Step Into Liquid;308508;6.9;77;63;14;81;7.1;28;26;2;92;4.1;1308;91
6599;Accattone;54599;7.6;13;13;0;100;0;3;3;0;100;4.1;471;88
6600;The Making of '...And God Spoke';107492;7;8;8;0;100;0;0;0;0;0;0;0;0
6601;Big Trouble;246464;5.4;110;53;57;48;4.8;31;9;22;29;2.9;3337;52
6602;Brain Damage;94793;\N;\N;\N;\N;\N;\N;\N;\N;\N;\N;\N;\N;\N
6603;La double vie de Véronique;101765;7.6;25;21;4;84;7.6;5;5;0;100;4.3;5676;92
6604;Uccellacci e uccellini;61132;6.5;10;8;2;80;0;3;3;0;100;4.1;399;84
6605;The Man in the Glass Booth;73345;0;3;3;0;100;0;1;1;0;100;4;91;88
6607;The Red Pony;41792;0;2;2;0;100;0;0;0;0;0;0;0;0
6608;Sex & the Other Man;112628;0;0;0;0;0;0;0;0;0;0;0;0;0
6609;Il vangelo secondo Matteo;58715;8.4;27;25;2;92;0;4;4;0;100;4.1;1125;86
6610;The Honeymoon Killers;64437;8;18;17;1;94;0;3;3;0;100;3.5;670;67
6611;Umberto D.;45274;8.9;25;24;1;96;8.9;7;7;0;100;4.3;1981;93
6612;My Brother's Keeper;287944;6;5;2;3;40;0;0;0;0;0;0;0;0
6613;The Day of the Dolphin;69946;5.4;17;9;8;52;0;3;0;3;0;3.1;307;43
6614;I Love You to Death;99819;5.6;17;10;7;58;0;2;1;1;50;3.3;2330;60
6615;Freddy vs. Jason;329101;4.9;152;62;90;40;4.2;32;8;24;25;2.9;31156;60
6616;Grind;338077;3.1;71;6;65;8;3;23;2;21;8;3.5;8588;79
6617;Open Range;316356;6.8;170;134;36;78;6.7;33;23;10;69;3.5;8881;80
6618;Siu lam juk kau;286112;7.1;87;79;8;90;7.4;28;28;0;100;3.7;17693;82
6619;Uptown Girls;263757;3.8;108;14;94;12;3.9;30;5;25;16;3.1;32370;64
6620;American Splendor;305206;8.3;178;167;11;93;8.6;42;42;0;100;3.7;9157;85
6622;Carnages;280523;6.9;36;28;8;77;7.1;11;9;2;81;3.7;239;71
6623;Passionada;285879;5.6;45;26;19;57;5.8;16;9;7;56;3.2;457;55
6624;Agent Cody Banks;313911;5.1;99;38;61;38;4.8;24;8;16;33;2.6;21724;41
6625;Camp Nowhere;109369;3.6;10;1;9;10;0;2;1;1;50;2.8;2929;53
6626;The Cemetery Club;106536;5.8;7;4;3;57;0;3;2;1;66;2.9;263;36
6627;Changing Habits;115865;0;2;0;2;0;0;0;0;0;0;0;0;0
6628;Hot Dog... The Movie;87425;0;0;0;0;0;0;0;0;0;0;0;0;0
6629;House of Wax;397065;4.3;148;37;111;25;4.5;30;6;24;20;2.8;39495;54
6630;The Inn of the Sixth Happiness;51776;0;2;2;0;100;0;0;0;0;0;0;0;0
6631;Man's Best Friend;107504;\N;\N;\N;\N;\N;\N;\N;\N;\N;\N;\N;\N;\N
6633;Prince of Jutland;110891;0;0;0;0;0;0;0;0;0;0;0;0;0
6634;Remando al viento;93840;0;1;0;1;0;0;0;0;0;0;0;0;0
6635;The Rachel Papers;98160;0;2;1;1;50;0;0;0;0;0;0;0;0
6636;The Sure Thing;90103;6.8;26;23;3;88;6.8;5;4;1;80;3.5;2781;75
6637;Thrashin';92085;0;0;0;0;0;0;0;0;0;0;0;0;0
6638;Valley Girl;86525;0;2;1;1;50;0;2;1;1;50;3.7;550;73
6639;Wait Until Dark;62467;7.8;17;16;1;94;0;0;0;0;0;0;0;0
6641;Code inconnu: Récit incomplet de divers voyages;216625;6.9;37;26;11;70;7.2;9;7;2;77;3.8;1347;78
6642;Showdown in Little Tokyo;102915;4.3;6;2;4;33;0;0;0;0;0;0;0;0
6643;Tôkyô monogatari;46438;9.6;34;34;0;100;0;3;3;0;100;4.4;3458;94
6644;Le rayon vert;91830;7.7;12;11;1;91;0;3;3;0;100;4.1;525;84
6645;THX 1138;66434;7;56;50;6;89;6.9;10;9;1;90;3.6;7990;73
6646;Beyond the Valley of the Dolls;65466;6.1;22;15;7;68;0;3;1;2;33;0;0;0
6647;The Business of Fancydancing;303313;5.7;30;17;13;56;5.2;8;4;4;50;3.6;262;70
6648;Chunhyangdyun;245837;7;40;34;6;85;7.5;11;11;0;100;3.6;318;71
6649;Tunes of Glory;54412;5.7;6;4;2;66;0;0;0;0;0;0;0;0
6650;Kind Hearts and Coronets;41546;8.8;26;26;0;100;0;4;4;0;100;4.3;2828;93
6651;Ash Wednesday;280438;4;14;4;10;28;0;4;1;3;25;3.1;670;46
6652;Joe Kidd;68768;6.8;6;5;1;83;0;1;0;1;0;3.2;1890;50
6653;The Keep;85780;4.1;9;1;8;11;0;0;0;0;0;0;0;0
6654;Kaitei gunkan;57215;0;0;0;0;0;0;0;0;0;0;0;0;0
6655;Chikyû Bôeigun;50251;0;4;3;1;75;0;0;0;0;0;0;0;0
6656;Attack of the Puppet People;51381;0;1;0;1;0;0;0;0;0;0;0;0;0
6657;The Beast from 20,000 Fathoms;45546;6.8;10;9;1;90;0;0;0;0;0;0;0;0
6658;Enchanted;461770;7.3;157;145;12;92;7.4;34;31;3;91;3.8;188655;80
6659;Tremors;100814;7;24;21;3;87;0;1;1;0;100;3;16973;63
6660;The Red Shoes;40725;9.1;41;40;1;97;8.2;6;6;0;100;4.2;2989;89
6661;Me & Isaac Newton;218433;7;9;8;1;88;0;2;2;0;100;3.2;135;40
6662;The Pink Panther;383216;4.1;139;31;108;22;4.1;32;6;26;18;3;52976;59
6663;The Pink Panther Strikes Again;75066;7.1;17;14;3;82;0;1;0;1;0;3.4;5835;80
6664;Commando;88944;6;31;22;9;70;0;3;2;1;66;3.1;18349;65
6665;Dracula;21814;7.7;42;39;3;92;7.7;6;6;0;100;3.6;8598;76
6666;Le charme discret de la bourgeoisie;68361;8.4;38;37;1;97;7.6;10;10;0;100;4.2;3780;90
6667;Waco: The Rules of Engagement;120472;7.8;16;14;2;87;0;3;2;1;66;3.8;380;82
6668;Wo de fu qin mu qin;235060;7.4;79;70;9;88;7.6;23;21;2;91;4.1;2770;88
6669;Ikiru;44741;8.6;30;30;0;100;8.3;9;9;0;100;4.5;5818;96
6670;Comic Book Villains;287969;0;4;3;1;75;0;0;0;0;0;0;0;0
6671;An Angel at My Table;99040;7.6;13;12;1;92;0;2;2;0;100;4;986;87
6672;War Photographer;309061;6.9;25;20;5;80;7;9;7;2;77;4.3;673;91
6673;¡Ay, Carmela!;101025;0;2;1;1;50;0;0;0;0;0;0;0;0
6674;Jang Aur Aman;311356;0;0;0;0;0;0;0;0;0;0;0;0;0
6675;Loin;258242;0;1;1;0;100;0;0;0;0;0;0;0;0
6676;Incident at Oglala;104504;7.7;12;12;0;100;0;1;1;0;100;4.1;260;85
6678;The Handmaid's Tale;99731;4.6;12;3;9;25;0;2;0;2;0;3;1026;44
6679;Revolution OS;308808;5.8;14;6;8;42;0;3;0;3;0;3.7;350;74
6680;Live Nude Girls Unite!;264802;7.1;17;14;3;82;0;4;4;0;100;3.8;355;63
6681;All the Little Animals;120584;5.4;21;13;8;61;5.3;6;4;2;66;3.8;1085;76
6682;Earth;393597;7.2;88;76;12;86;7.1;23;20;3;86;3.8;80150;74
6683;Man on Fire;328107;5.2;157;61;96;38;5.1;38;14;24;36;3.9;67139;89
6684;Morte a Venezia;67445;7.1;15;11;4;73;0;2;0;2;0;4;1986;83
6685;Marci X;266747;2.9;52;5;47;9;3.3;14;2;12;14;2.3;826;28
6686;The Medallion;288045;3.9;122;22;100;18;4.3;32;9;23;28;2.7;7847;42
6687;My Boss's Daughter;270980;2.4;66;6;60;9;2.6;15;2;13;13;2.5;6043;32
6688;Babí léto;286476;7.3;37;36;1;97;7;13;12;1;92;3.7;349;81
6689;The Battle of Shaker Heights;357470;5.1;57;24;33;42;4.4;23;5;18;21;3.2;1504;52
6690;Sin noticias de Dios;284491;5.1;29;11;18;37;5.2;9;4;5;44;3.5;1529;66
6691;Ask the Dust;384814;5.1;103;37;66;35;5.5;32;16;16;50;2.8;14077;37
6692;Stoked: The Rise and Fall of Gator;271211;6.6;47;37;10;78;6.6;19;15;4;78;3.8;199;78
6693;Venus Boyz;293685;6.1;16;13;3;81;5.9;6;5;1;83;3.4;203;70
6694;Tan de repente;324158;6.6;21;20;1;95;6.9;8;8;0;100;3.1;56;22
6695;Jeepers Creepers II;301470;4.2;119;26;93;21;3.9;26;4;22;15;2.8;17496;53
6696;Bollywood/Hollywood;303785;5;45;18;27;40;4.6;15;4;11;26;3.2;1101;57
6697;Civil Brand;326806;3.8;19;3;16;15;3.9;9;2;7;22;3.8;954;73
6698;Nola;317950;3.1;13;0;13;0;2.9;8;0;8;0;3.1;258;38
6699;Once Upon a Time in the Midlands;301684;5.7;74;38;36;51;5.9;25;16;9;64;3.1;886;45
6700;El otro lado de la cama;301524;5;41;19;22;46;5;16;8;8;50;3.5;1042;66
6701;Day Zero;768183;4.1;19;4;15;21;4;7;0;7;0;3.1;1008;45
6702;Dickie Roberts: Former Child Star;325258;4.5;114;26;88;22;4.5;32;7;25;21;2.8;8342;52
6703;Law & Order: Special Victims Unit;203259;\N;\N;\N;\N;\N;\N;\N;\N;\N;\N;\N;\N;\N
6704;Home Room;264689;5.5;21;11;10;52;4.6;9;2;7;22;3.7;861;79
6705;Party Monster;320244;4.4;75;20;55;26;4;28;5;23;17;3.5;6775;77
6706;Taking Sides;260414;0;0;0;0;0;0;0;0;0;0;0;0;0
6707;Cabin Fever;303816;5.9;134;84;50;62;5.2;31;15;16;48;2.6;15690;45
6708;Matchstick Men;325805;7.1;180;148;32;82;6.6;38;29;9;76;3.3;14261;76
6709;Once Upon a Time in Mexico;285823;6.3;159;108;51;67;6.3;33;22;11;66;3.2;31247;66
6710;Dummy;246592;6.2;32;23;9;71;5.8;10;7;3;70;3.6;2069;74
6711;Lost in Translation;335266;8.4;215;203;12;94;8.5;41;40;1;97;3.6;84187;84
6712;Luster;325761;4.6;10;5;5;50;0;3;1;2;33;2.9;329;40
6713;Sennen joyû;291350;7.6;49;45;4;91;7.7;13;12;1;92;4.1;4498;87
6714;Chik yeung tin si;300620;6.7;37;30;7;81;6;9;5;4;55;3.9;2855;80
6715;Children of the Night;103957;0;1;0;1;0;0;0;0;0;0;0;0;0
6716;Daisy Miller;71385;6;5;4;1;80;0;0;0;0;0;0;0;0
6717;Erleuchtung garantiert;177749;6.6;13;8;5;61;0;3;2;1;66;3.9;316;88
6718;Gotcha!;89222;4.8;9;4;5;44;0;1;0;1;0;3;845;47
6719;Hard to Hold;87384;0;1;0;1;0;0;0;0;0;0;0;0;0
6720;Kuffs;104647;4.5;15;4;11;26;0;1;0;1;0;2.9;2235;46
6721;Wong Fei Hung;103285;7.3;25;22;3;88;0;2;2;0;100;3.8;4888;85
6722;Wong Fei Hung II: Nam yi dong ji keung;105839;6.9;14;13;1;92;0;3;2;1;66;3.8;3504;82
6723;Wong Fei Hung ji saam: Si wong jaang ba;108592;6;8;5;3;62;0;0;0;0;0;0;0;0
6724;Paper Moon;70510;8.4;29;26;3;89;8;6;4;2;66;4;3053;91
6725;Sgt. Pepper's Lonely Hearts Club Band;78239;2.9;20;3;17;15;0;3;0;3;0;2.9;1491;52
6726;En sång för Martin;257215;7.3;27;23;4;85;7;12;9;3;75;3.5;333;70
6727;Targets;63671;7.5;24;21;3;87;6.4;5;3;2;60;3.7;829;78
6728;The Ugly American;56632;6.1;5;4;1;80;0;0;0;0;0;0;0;0
6729;The Bostonians;86992;6.2;5;3;2;60;0;1;1;0;100;2.9;265;32
6730;Convoy;77369;4.1;8;4;4;50;0;1;0;1;0;3.6;2494;73
6731;Day of the Dead;88993;6.5;27;21;6;77;0;2;1;1;50;3.5;16164;72
6732;Hello, Dolly!;64418;5.9;16;8;8;50;0;0;0;0;0;0;0;0
6733;Je rentre à la maison;283422;7.7;52;50;2;96;8.2;19;19;0;100;3.4;322;63
6734;Memoirs of an Invisible Man;104850;4.6;25;6;19;24;0;2;0;2;0;2.6;2632;30
6735;La môme;450188;5.8;12;6;6;50;0;4;1;3;25;3.8;33;80
6736;See No Evil;437179;2.6;57;5;52;8;2.5;14;1;13;7;3.3;46137;61
6737;Super Sucker;293624;4.1;14;4;10;28;0;4;1;3;25;2.9;303;42
6738;Stazione Termini;46366;6.2;6;4;2;66;0;0;0;0;0;0;0;0
6739;At War with the Army;42209;0;2;0;2;0;0;0;0;0;0;0;0;0
6740;Bingo;101455;0;1;0;1;0;0;1;0;1;0;2.7;1322;36
6741;God Told Me To;75930;6.1;7;5;2;71;0;1;0;1;0;3.3;590;57
6742;I, Madman;97557;0;4;3;1;75;0;1;1;0;100;3;387;44
6743;The Jungle Book;61852;7.3;27;24;3;88;0;2;1;1;50;3.5;35715;70
6744;Once Bitten;89730;3.4;10;1;9;10;0;0;0;0;0;0;0;0
6745;The Shrimp on the Barbie;100608;0;0;0;0;0;0;0;0;0;0;0;0;0
6746;Squirm;75261;4.3;10;3;7;30;0;0;0;0;0;0;0;0
6747;The Adventures of Huck Finn;106223;5.9;13;8;5;61;0;4;3;1;75;2.9;2408;47
6748;The Brood;78908;7;14;11;3;78;0;1;0;1;0;3.5;2752;65
6749;The Prince and the Pauper;100409;0;0;0;0;0;0;0;0;0;0;0;0;0
6750;Anything Else;313792;5.2;130;53;77;40;5;35;12;23;34;2.9;4837;45
6751;Cold Creek Manor;331468;3.8;108;13;95;12;4.5;27;6;21;22;2.6;4032;31
6752;The Fighting Temptations;191133;5.4;105;44;61;41;5.8;30;17;13;56;3.2;5134;69
6753;Secondhand Lions;327137;6.1;132;78;54;59;5.2;31;11;20;35;3.7;13936;83
6754;Underworld;320691;4.7;155;47;108;30;4.4;32;5;27;15;3.6;101467;82
6755;BubbaHo-Tep;281686;6.8;102;80;22;78;6;27;19;8;70;3.6;14170;78
6756;Casa de los babys;303830;6;105;61;44;58;5.8;29;16;13;55;3.2;515;50
6757;Demonlover;284034;5.5;75;36;39;48;6;21;14;7;66;2.9;692;43
6759;Doctor Sleep;286594;5.7;36;17;19;47;5.2;13;7;6;53;3;925;39
6760;Where in the World Is Osama Bin Laden?;963208;4.9;102;38;64;37;4.6;29;9;20;31;3.3;2558;55
6761;Tibet: Cry of the Snow Lion;373389;7.4;49;42;7;85;7.6;20;18;2;90;4;721;82
6762;Yossi & Jagger;334754;6.8;41;36;5;87;7.2;15;14;1;93;3.7;822;74
6763;Duplex;266489;5;104;38;66;36;4.8;28;9;19;32;2.9;11260;46
6764;The Rundown;327850;6.4;143;102;41;71;6.1;31;20;11;64;3.3;18070;72
6765;Under the Tuscan Sun;328589;6.2;143;87;56;60;6.3;35;21;14;60;3.4;14219;77
6766;Camera Obscura;204933;5;7;3;4;42;0;1;0;1;0;3;37;50
6768;Luther;309820;5.2;61;27;34;44;5;21;9;12;42;3.7;2529;76
6769;Mambo italiano;330602;4.7;72;23;49;31;5;23;8;15;34;3.3;1531;64
6770;My Life Without Me;314412;0;0;0;0;0;0;0;0;0;0;0;0;0
6771;Dorm Daze 2;458438;0;0;0;0;0;0;0;0;0;0;0;0;0
6772;Être et avoir;318202;8.1;58;56;2;96;8.1;21;20;1;95;4.1;1542;89
6773;Les triplettes de Belleville;286244;0;0;0;0;0;0;0;0;0;0;0;0;0
6774;Videodrome;86541;7.1;44;35;9;79;0;3;3;0;100;3.6;9415;79
6775;Life and Debt;284262;7.3;42;38;4;90;7.6;12;12;0;100;4.1;552;90
6776;Lagaan: Once Upon a Time in India;169102;7.9;59;56;3;94;7.9;19;19;0;100;4.2;4800;90
6777;Judgment at Nuremberg;55031;7.7;19;17;2;89;0;2;1;1;50;4;2099;90
6778;Reise der Hoffnung;100470;6.4;5;4;1;80;0;2;1;1;50;4.2;163;87
6779;Same Time, Next Year;78199;4.5;5;2;3;40;0;0;0;0;0;0;0;0
6780;A Brief History of Time;103882;7.3;12;11;1;91;0;2;1;1;50;3.9;305;86
6781;Jakob, der Lügner;71688;6.3;5;5;0;100;0;0;0;0;0;0;0;0
6782;Leningrad Cowboys Go America;97728;7.5;5;5;0;100;0;0;0;0;0;0;0;0
6783;La règle du jeu;31885;9.1;37;36;1;97;9;10;10;0;100;4.3;2952;91
6784;The Song Remains the Same;75244;6.6;11;8;3;72;0;0;0;0;0;0;0;0
6785;Seven Brides for Seven Brothers;47472;7.5;18;15;3;83;0;0;0;0;0;0;0;0
6786;Kiss of the Spider Woman;89424;7.5;24;21;3;87;0;3;3;0;100;3.6;2040;78
6787;All the President's Men;74119;9;40;40;0;100;0;3;3;0;100;3.9;11562;89
6788;Angie;109129;5.2;15;6;9;40;0;3;1;2;33;2.7;642;31
6789;L'appartement;115561;0;2;2;0;100;0;0;0;0;0;0;0;0
6790;The Mists of Avalon;244353;5.6;7;3;4;42;0;1;1;0;100;3.7;4639;74
6791;Babettes gæstebud;92603;8.6;14;13;1;92;0;1;0;1;0;4.2;3211;90
6792;Sibirskiy tsiryulnik;120125;0;3;0;3;0;0;0;0;0;0;0;0;0
6793;Beethoven;103786;4.8;23;7;16;30;6.1;5;4;1;80;2.8;16534;41
6794;Beethoven's 2nd;106375;4.4;10;2;8;20;0;2;0;2;0;2.6;7881;35
6795;Black Moon Rising;90735;3.9;9;3;6;33;0;2;1;1;50;2.8;1020;32
6796;Boyz n the Hood;101507;8.3;45;44;1;97;7.7;9;9;0;100;3.7;22104;88
6797;Bugsy;101516;7;32;29;3;90;0;2;2;0;100;3.2;1987;62
6798;Bugsy Malone;74256;6.4;16;12;4;75;0;1;1;0;100;3.5;3796;76
6799;By the Sword;101524;0;2;0;2;0;0;1;0;1;0;3.6;301;69
6800;Cobra;90859;2.5;14;1;13;7;0;3;1;2;33;2.7;5821;43
6801;La comunidad;255067;0;3;3;0;100;0;0;0;0;0;0;0;0
6802;Consenting Adults;104006;4.2;10;3;7;30;0;1;0;1;0;2.8;822;29
6803;Phenomenon;117333;5.9;32;16;16;50;5.5;6;1;5;16;3;9166;62
6804;Crimewave;88967;\N;\N;\N;\N;\N;\N;\N;\N;\N;\N;\N;\N;\N
6805;Crying Freeman;112750;0;1;1;0;100;0;0;0;0;0;0;0;0
6806;Shun liu Ni liu;251433;6.1;43;27;16;62;6.4;15;10;5;66;3.6;915;71
6807;The Meaning of Life;85959;7.5;26;23;3;88;0;0;0;0;0;0;0;0
6808;Where Eagles Dare;65207;6.5;17;15;2;88;0;3;2;1;66;3.8;5588;85
6809;Tightrope;88272;6.8;11;9;2;81;0;1;1;0;100;3.1;1687;46
6810;Sleeping with the Enemy;102945;4.4;31;7;24;22;3.8;7;1;6;14;3.2;11187;67
6811;PCU;110759;5.2;15;7;8;46;0;2;0;2;0;3.5;3192;73
6812;The Rookie;265662;7.2;140;115;25;82;7.4;32;29;3;90;3.3;10597;68
6813;The Ghost and Mr. Chicken;59221;6.2;6;4;2;66;0;0;0;0;0;0;0;0
6814;City Heat;87062;3.8;13;3;10;23;0;4;1;3;25;2.8;1089;30
6815;30 Days of Night;389722;5.5;150;73;77;48;5.1;28;13;15;46;3.3;146766;57
6816;Three O'Clock High;94138;5.6;8;5;3;62;0;1;0;1;0;3.4;1098;70
6817;White Hunter Black Heart;100928;7;32;28;4;87;6.6;8;6;2;75;3.2;1489;54
6818;Idi i smotri;91251;8;20;19;1;95;0;4;3;1;75;4.5;2288;96
6819;A Rage in Harlem;102749;6.7;11;9;2;81;0;2;1;1;50;3.2;878;54
6820;Ginger Snaps;210070;7.4;46;41;5;89;7.1;8;7;1;87;3.4;8664;76
6821;More American Graffiti;79576;4.2;9;2;7;22;0;0;0;0;0;0;0;0
6822;The Ballad of Little Jo;106350;5.8;8;6;2;75;0;2;2;0;100;3.1;555;50
6823;Under Suspicion;164212;5.3;44;22;22;50;5.2;12;6;6;50;3.2;1858;49
6824;Tais-toi!;310203;0;1;1;0;100;0;0;0;0;0;0;0;0
6825;The Reluctant Astronaut;62190;0;0;0;0;0;0;0;0;0;0;0;0;0
6826;The Shakiest Gun in the West;63591;0;0;0;0;0;0;0;0;0;0;0;0;0
6827;It's Pat;110169;2.3;11;0;11;0;0;2;0;2;0;2;1188;24
6828;Un dimanche à la campagne;88318;8.4;6;6;0;100;0;1;1;0;100;3.5;302;71
6829;The Gun in Betty Lou's Handbag;104376;3.6;11;1;10;9;0;0;0;0;0;0;0;0
6830;Sudden Fear;45205;6.8;5;5;0;100;0;0;0;0;0;0;0;0
6831;Nobody's Baby;215516;4;5;0;5;0;0;0;0;0;0;0;0;0
6832;Regarding Henry;102768;5.1;25;12;13;48;0;2;0;2;0;3.3;3801;64
6833;The Debut;163745;0;0;0;0;0;0;0;0;0;0;0;0;0
6834;Wilder Napalm;108569;3.6;7;2;5;28;0;1;0;1;0;3;367;42
6835;Contamination;82000;0;2;0;2;0;0;0;0;0;0;0;0;0
6836;The Amazing Transparent Man;53593;5;5;2;3;40;0;0;0;0;0;0;0;0
6837;Love Affair;110391;4.8;26;8;18;30;0;3;1;2;33;3.5;1260;71
6839;Try Seventeen;311941;3.5;7;0;7;0;0;0;0;0;0;0;0;0
6840;Kingdom Hospital;324864;\N;\N;\N;\N;\N;\N;\N;\N;\N;\N;\N;\N;\N
6841;Article 99;101371;5.4;12;6;6;50;0;2;0;2;0;3.2;709;53
6842;Picture This;1076252;0;0;0;0;0;0;0;0;0;0;0;0;0
6843;Eureka;796264;\N;\N;\N;\N;\N;\N;\N;\N;\N;\N;\N;\N;\N
6844;Oleanna;110722;5.8;16;9;7;56;0;2;1;1;50;3.3;398;59
6845;Chattahoochee;99242;4.9;5;1;4;20;0;2;0;2;0;3.3;468;54
6846;Tough Guys Don't Dance;94169;4.9;18;7;11;38;0;4;2;2;50;3.3;251;49
6847;There Goes My Baby;108320;0;1;0;1;0;0;0;0;0;0;0;0;0
6848;Kingdom of the Spiders;76271;5.5;9;4;5;44;0;0;0;0;0;0;0;0
6849;Scrooge;66344;6.8;16;11;5;68;0;3;2;1;66;3.4;1834;72
6850;Leap of Faith;104695;5.8;18;12;6;66;0;1;1;0;100;2.7;1901;38
6851;Gas, Food Lodging;104321;6.5;13;10;3;76;0;2;2;0;100;3.5;533;73
6852;In Cold Blood;61809;8.3;25;22;3;88;7.8;5;4;1;80;3.8;2614;83
6853;Campus Man;92717;0;0;0;0;0;0;0;0;0;0;0;0;0
6854;The Bedford Incident;58962;6.9;7;7;0;100;0;0;0;0;0;0;0;0
6855;Les blessures assassines;216578;7.3;47;43;4;91;7.8;13;13;0;100;3.7;64;74
6856;Yankee Doodle Dandy;35575;7.9;23;21;2;91;0;3;3;0;100;3.8;1924;83
6857;Jûbê ninpûchô;107692;8.3;5;5;0;100;0;0;0;0;0;0;0;0
6858;Nóz w wodzie;56291;8.2;30;30;0;100;0;4;4;0;100;3.9;2383;85
6859;All That Money Can Buy;33532;7.9;16;16;0;100;0;0;0;0;0;0;0;0
6860;Mobsters;102460;3.8;11;1;10;9;0;2;0;2;0;3.1;2921;54
6861;Charlotte Sometimes;284478;6.8;44;36;8;81;7.6;11;11;0;100;3.5;200;66
6862;Out of Time;313443;0;0;0;0;0;0;0;0;0;0;0;0;0
6863;The School of Rock;332379;7.8;188;172;16;91;8.2;39;38;1;97;3.2;183700;63
6864;Concert for George;380275;7.6;18;17;1;94;7.3;9;8;1;88;4.3;31;90
6865;Lemony Snicket's A Series of Unfortunate Events;339291;6.6;154;109;45;70;6.6;32;19;13;59;3.2;60437;61
6866;9 Dead Gay Guys;336910;4;23;5;18;21;2.6;9;1;8;11;3.4;768;61
6867;The Station Agent;340377;8;149;142;7;95;8;33;33;0;100;3.9;7193;90
6868;Wonderland;335563;5;98;34;64;34;4.5;32;7;25;21;3.3;3666;67
6869;Ônibus 174;340468;8.3;73;73;0;100;8.1;22;22;0;100;3.9;1380;87
6870;Mystic River;327056;7.8;193;168;25;87;8;40;38;2;95;3.7;30024;86
6871;Good Boy!;326900;5.3;84;37;47;44;5.6;26;15;11;57;3;2701;49
6872;House of the Dead;317676;1.9;53;2;51;3;2;12;1;11;8;1.9;6777;20
6873;Intolerable Cruelty;138524;6.7;178;133;45;74;6.8;41;31;10;75;2.9;12106;43
6874;Kill Bill: Vol. 2;378194;7.7;226;193;33;85;7.7;43;35;8;81;3.8;162324;87
6875;Dopamine;342300;5.5;51;26;25;50;5.4;20;8;12;40;3.1;357;51
6876;La fleur du mal;322289;6.2;60;39;21;65;6.8;20;15;5;75;3.1;468;43
6877;Girls Will Be Girls;339071;5.6;31;18;13;58;5;13;6;7;46;3.6;1305;71
6879;Runaway Jury;313542;6.6;152;111;41;73;6.6;38;28;10;73;3.4;11578;73
6880;The Texas Chainsaw Massacre;324216;4.8;152;55;97;36;4.2;33;6;27;18;3.2;36030;67
6881;Pieces of April;311648;7.1;145;122;23;84;7.2;36;31;5;86;3.3;5487;68
6882;The Return;433442;3.9;55;8;47;14;3.9;15;2;13;13;2.9;26258;38
6883;Sylvia;325055;5.3;126;46;80;36;5.2;34;9;25;26;3.3;2530;58
6884;Veronica Guerin;312549;6;135;73;62;54;5.5;35;15;20;42;3.6;2866;72
6885;In the Cut;199626;4.8;144;48;96;33;5;37;11;26;29;2.7;3073;36
6886;Beyond Borders;294357;4.3;101;14;87;13;4.2;34;4;30;11;3.5;6426;75
6887;Radio;316465;5;115;41;74;35;4.9;32;8;24;25;3.6;23763;83
6888;Scary Movie 3;306047;4.8;124;45;79;36;4.8;30;11;19;36;3;92592;68
6889;Brother Bear;328880;5.5;122;46;76;37;5.3;30;10;20;33;3.3;23328;68
6890;Elephant;363589;7;142;100;42;70;7.1;35;27;8;77;3.6;15005;79
6891;Gypsy 83;251110;5.5;26;14;12;53;5.2;12;6;6;50;3.9;728;77
6892;The Singing Detective;314676;5.1;106;41;65;38;5;28;9;19;32;3;2164;42
6893;The Italian Job;317740;6.4;178;129;49;72;6.7;40;32;8;80;3.6;103062;79
6894;Impulse;1078899;0;2;0;2;0;0;0;0;0;0;0;0;0
6895;Normal;338290;7.2;6;6;0;100;0;2;2;0;100;3.6;624;71
6896;Shoah;90015;8.8;12;12;0;100;0;1;1;0;100;4.6;400;96
6897;Unconditional Love;219374;3.7;6;1;5;16;0;1;0;1;0;3.5;739;65
6898;Super Sweet 16: The Movie;1018829;0;1;0;1;0;0;0;0;0;0;0;0;0
6899;Alien from L.A.;92532;1.3;6;0;6;0;0;0;0;0;0;0;0;0
6900;Black Sunday;75765;7.4;11;11;0;100;0;0;0;0;0;0;0;0
6901;Men of Respect;102432;0;3;0;3;0;0;1;0;1;0;3.1;107;47
6902;Interstate 60: Episodes of the Road;165832;6.4;5;4;1;80;0;0;0;0;0;0;0;0
6903;Lipstick;74802;4.4;5;1;4;20;0;1;0;1;0;3;279;43
6905;Storyville;105480;6;5;3;2;60;0;1;1;0;100;2.7;221;23
6906;That Was Then... This Is Now;90151;3.2;5;0;5;0;0;0;0;0;0;0;0;0
6907;Holy Matrimony;36009;0;0;0;0;0;0;0;0;0;0;0;0;0
6908;Ye yan;465676;4.4;8;3;5;37;0;2;0;2;0;3.5;2288;62
6909;Gin gwai;325655;6.1;102;65;37;63;6.3;30;21;9;70;3.5;8843;71
6910;Kronos;50610;5;6;4;2;66;0;0;0;0;0;0;0;0
6911;The Jolson Story;38661;0;4;4;0;100;0;0;0;0;0;0;0;0
6912;You'll Never Get Rich;34409;0;2;1;1;50;0;0;0;0;0;0;0;0
6913;Frankenstein and the Monster from Hell;71519;0;0;0;0;0;0;0;0;0;0;0;0;0
6914;Preaching to the Perverted;119935;0;4;2;2;50;0;0;0;0;0;0;0;0
6915;Chicago Joe and the Showgirl;99250;0;4;1;3;25;0;1;0;1;0;2.9;170;31
6916;Quest for Camelot;120800;5.3;21;7;14;33;5.9;6;2;4;33;3.1;4042;62
6917;Promised Land;115325;\N;\N;\N;\N;\N;\N;\N;\N;\N;\N;\N;\N;\N
6918;Aparajito;48956;8.4;14;13;1;92;8.2;7;6;1;85;4.3;811;92
6919;The Hired Hand;67204;7.4;11;10;1;90;0;3;2;1;66;3.4;491;67
6920;Le cercle rouge;65531;8.3;57;54;3;94;8.5;19;19;0;100;4.2;1875;92
6921;Czlowiek z marmuru;75902;0;2;2;0;100;0;0;0;0;0;0;0;0
6923;Sherlock Holmes and the Voice of Terror;35318;0;3;2;1;66;0;0;0;0;0;0;0;0
6924;Sherlock Holmes Faces Death;36348;0;2;2;0;100;0;0;0;0;0;0;0;0
6925;Sherlock Holmes in Washington;36349;0;2;2;0;100;0;0;0;0;0;0;0;0
6926;The Solid Gold Cadillac;49777;7.5;5;5;0;100;0;0;0;0;0;0;0;0
6927;The Human Stain;308383;5.5;147;62;85;42;5.6;38;15;23;39;3.1;3875;50
6928;Die, Mommie, Die!;322023;6;59;38;21;64;6.5;21;16;5;76;3.5;839;67
6929;Joe Dirt;245686;3;74;8;66;10;2.7;24;1;23;4;2.8;16165;63
6930;Girlhood;368745;7.7;33;31;2;93;7.5;11;10;1;90;3.5;176;65
6931;Mail Order Wife;377088;6;32;20;12;62;6.2;9;6;3;66;3.5;426;68
6932;Shattered Glass;323944;7.7;163;148;15;90;7.5;37;31;6;83;3.5;4409;76
6934;The Matrix Revolutions;242653;5.3;203;74;129;36;5;37;10;27;27;3.4;111917;70
6935;Chavez: Inside the Coup;363510;7.9;48;47;1;97;7.9;20;20;0;100;4.2;655;90
6936;Elf;319343;6.9;166;139;27;83;6.5;38;29;9;76;3.2;66072;73
6937;Anything But Love;96534;0;0;0;0;0;0;0;0;0;0;0;0;0
6938;Billabong Odyssey;379713;4.9;11;4;7;36;4;5;1;4;20;4.1;417;88
6939;Gloomy Sunday - Ein Lied von Liebe und Tod;155722;7;64;54;10;84;6.8;16;13;3;81;4.1;1350;91
6940;Dans ma peau;337961;6;41;26;15;63;5.5;12;7;5;58;3.6;899;68
6942;Love Actually;314331;6.4;187;118;69;63;6.3;42;25;17;59;3.1;191514;71
6944;Father of the Bride;101862;5.8;29;21;8;72;0;2;2;0;100;3.2;22336;67
6945;My Architect;373175;7.5;90;84;6;93;7.7;26;26;0;100;3.8;825;81
6946;Looney Tunes: Back in Action;318155;6;130;73;57;56;5.9;32;20;12;62;2.7;8974;43
6947;Master and Commander: The Far Side of the World;311113;7.6;205;174;31;84;7.8;41;38;3;92;3.3;17643;75
6948;Tupac: Resurrection;343121;6.7;85;66;19;77;6.6;32;26;6;81;4;2964;87
6949;The Big Empty;321442;5.3;7;5;2;71;0;1;1;0;100;3.1;888;48
6950;The Missing;338188;6.1;168;98;70;58;6.1;39;21;18;53;3;6895;52
6951;The Cat in the Hat;312528;3.2;148;16;132;10;3.4;37;5;32;13;2.5;15383;41
6952;Gothika;348836;4.1;161;24;137;14;3.9;34;2;32;5;3;23666;56
6953;21 Grams;315733;7.5;175;142;33;81;8.1;36;32;4;88;3.6;38037;83
6954;Les invasions barbares;338135;7.2;125;103;22;82;7.3;35;29;6;82;3.9;4434;88
6955;Blindness;861689;5.2;150;63;87;42;5;30;8;22;26;3.1;17761;49
6956;Lan se da men;333764;7.1;12;10;2;83;6.8;6;5;1;83;3.9;931;86
6957;Bad Santa;307987;6.7;187;144;43;77;6.9;40;32;8;80;3.2;17921;73
6958;The Haunted Mansion;338094;4.2;134;18;116;13;4.4;31;6;25;19;2.6;14063;41
6959;Timeline;300556;3.7;135;15;120;11;3.8;33;5;28;15;2.9;8959;52
6960;Marquis de Sade: Justine;62870;0;1;0;1;0;0;0;0;0;0;0;0;0
6961;Damage;104237;6.7;19;14;5;73;0;3;2;1;66;0;0;0
6962;OT: Our Town;334029;7;24;21;3;87;6.9;6;5;1;83;3.6;67;82
6963;The Devil's Playground;74404;0;0;0;0;0;0;0;0;0;0;0;0;0
6964;Dance with a Stranger;88987;7.4;10;9;1;90;0;1;1;0;100;3.4;510;64
6965;Journeys with George;312848;6.6;10;8;2;80;0;3;2;1;66;3.4;435;71
6966;Darkman;99365;6.6;46;36;10;78;7.1;8;7;1;87;2.9;9871;50
6967;Dead of Night;37635;0;0;0;0;0;0;0;0;0;0;0;0;0
6968;Death Machine;109575;0;1;1;0;100;0;0;0;0;0;0;0;0
6969;Le dernier combat;85426;0;3;2;1;66;0;0;0;0;0;0;0;0
6970;Desk Set;50307;6.8;16;16;0;100;0;2;2;0;100;3.9;1337;81
6971;Europa;101829;7.2;12;10;2;83;0;1;1;0;100;4;2055;88
6972;The Watermelon Woman;118125;7.3;5;5;0;100;0;1;1;0;100;3.2;237;54
6973;Final Analysis;104265;5.3;22;11;11;50;5.8;6;3;3;50;2.8;1422;37
6974;The Freshman;99615;7.3;32;30;2;93;7.2;8;7;1;87;3.1;2525;52
6975;Funny Games U.S.;808279;5.6;138;71;67;51;4.7;34;13;21;38;3.2;16153;54
6976;Tales from the Crypt;96708;0;1;1;0;100;0;0;0;0;0;0;0;0
6977;New Jack City;102526;6.4;28;22;6;78;7.2;7;6;1;85;0;0;0
6978;Slackers;240900;3.1;104;11;93;10;2.4;30;1;29;3;2.8;4294;52
6979;WarGames;86567;7.4;27;26;1;96;0;4;3;1;75;3.3;7636;68
6980;Mr. Hobbs Takes a Vacation;56255;5.8;9;8;1;88;0;0;0;0;0;0;0;0
6981;Ordet;48452;9.4;11;11;0;100;0;1;1;0;100;4.4;1138;91
6982;Jeux interdits;43686;8.8;9;9;0;100;0;0;0;0;0;0;0;0
6983;Jane Eyre;780362;\N;\N;\N;\N;\N;\N;\N;\N;\N;\N;\N;\N;\N
6984;A Tale of Two Cities;52270;0;0;0;0;0;0;0;0;0;0;0;0;0
6985;La passion de Jeanne d'Arc;19254;8.9;31;30;1;96;8.1;6;5;1;83;4.4;3362;94
6986;Ben-Hur;52618;7.8;33;30;3;90;0;4;3;1;75;3.7;25817;80
6987;Das Cabinet des Dr. Caligari.;10323;8.9;34;34;0;100;0;1;1;0;100;4.1;6812;88
6988;Broken Blossoms or The Yellow Man and the Girl;9968;8.1;13;13;0;100;0;1;1;0;100;3.7;970;73
6989;Gorky Park;85615;6.6;22;17;5;77;0;4;3;1;75;3.3;824;57
6990;The Great Train Robbery;439;7.6;6;6;0;100;0;0;0;0;0;0;0;0
6991;Greystoke: The Legend of Tarzan, Lord of the Apes;87365;5.8;10;6;4;60;0;0;0;0;0;0;0;0
6992;Guarding Tess;109951;5.6;31;18;13;58;6.7;7;5;2;71;3;2875;51
6993;Hannah and Her Sisters;91167;8.4;40;37;3;92;8.5;5;5;0;100;3.9;7548;88
6994;The Hard Way;102004;5.8;18;14;4;77;0;2;1;1;50;3;2056;46
6995;Hercules in New York;65832;2.8;5;1;4;20;0;0;0;0;0;0;0;0
6996;Highlander II: The Quickening;102034;2.6;21;0;21;0;0;3;0;3;0;2.6;7551;37
6997;Hoffa;104427;5.6;20;11;9;55;0;2;1;1;50;3.3;2678;58
6998;House of Cards;107148;\N;\N;\N;\N;\N;\N;\N;\N;\N;\N;\N;\N;\N
6999;HouseSitter;104452;5.1;17;7;10;41;0;2;1;1;50;2.7;3753;46
7000;Hudson Hawk;102070;3.6;30;6;24;20;0;4;1;3;25;2.9;6827;54
7001;Invasion of the Body Snatchers;49366;8.9;36;36;0;100;0;2;2;0;100;3.6;3820;81
7002;Mindwalk;100151;6.6;8;7;1;87;0;0;0;0;0;0;0;0
7003;Kafka;102181;0;0;0;0;0;0;0;0;0;0;0;0;0
7004;Kindergarten Cop;99938;5.1;32;16;16;50;5.7;6;3;3;50;3;22205;53
7005;King Ralph;102216;4.7;9;2;7;22;0;1;0;1;0;2.4;1885;26
7006;Knight Moves;104627;3.7;5;1;4;20;0;1;0;1;0;2.9;884;37
7007;The Last Boy Scout;102266;5.1;30;13;17;43;0;4;2;2;50;3.3;11177;66
7008;Ultimo tango a Parigi;70849;7.8;26;21;5;80;0;4;3;1;75;3.6;6478;76
7009;Lorenzo's Oil;104756;6.8;23;22;1;95;0;3;3;0;100;3.5;2829;76
7010;L'amant;101316;4.8;15;4;11;26;0;4;0;4;0;3.8;2726;80
7011;The Matador;1186238;6.7;14;11;3;78;6.7;5;4;1;80;3.4;113;56
7012;Mr. Destiny;100201;4.7;15;6;9;40;0;2;0;2;0;3;1673;47
7013;The Night of the Hunter;48424;8.7;41;40;1;97;8;8;7;1;87;4.2;5852;91
7014;Nowhere to Run;107711;3.9;19;5;14;26;3;6;0;6;0;2.7;2820;39
7015;Only the Lonely;102598;5.9;18;11;7;61;0;1;0;1;0;2.9;1292;45
7016;Over the Top;93692;\N;\N;\N;\N;\N;\N;\N;\N;\N;\N;\N;\N;\N
7017;Passenger 57;105104;3.9;21;5;16;23;0;1;0;1;0;2.9;8383;48
7018;Presumed Innocent;100404;7.2;31;29;2;93;7.5;8;8;0;100;3.2;3836;60
7019;Project X;93793;6.2;9;7;2;77;0;1;1;0;100;3.1;1570;53
7020;Proof;377107;6.4;138;87;51;63;6.4;34;20;14;58;3.2;15629;57
7021;Pure Luck;102729;4;9;1;8;11;0;2;0;2;0;0;0;0
7022;Batoru rowaiaru;266308;7.2;22;18;4;81;0;0;0;0;0;0;0;0
7023;Xi yan;107156;7.5;16;15;1;93;0;2;2;0;100;3.9;2178;86
7024;Salò o le 120 giornate di Sodoma;73650;6.1;21;15;6;71;0;2;1;1;50;3.6;4630;68
7025;A Midnight Clear;102443;7.5;25;21;4;84;0;4;3;1;75;3.7;801;79
7026;Summer School;94072;5.5;28;17;11;60;0;4;1;3;25;2.9;3011;55
7027;Silverado;90022;6.8;29;22;7;75;5.8;5;3;2;60;3.5;5005;75
7028;Quick Change;100449;6.5;27;22;5;81;5.3;8;4;4;50;3.3;2142;63
7029;Rabid;76590;5.8;18;11;7;61;0;1;0;1;0;3.1;1745;48
7030;Radio Flyer;105211;4.7;28;12;16;42;4.4;7;2;5;28;3.4;2859;73
7031;The Real McCoys;50053;\N;\N;\N;\N;\N;\N;\N;\N;\N;\N;\N;\N;\N
7032;Star Wars: Episode III - Revenge of the Sith;121766;7.2;253;202;51;79;6.6;43;29;14;67;3.1;198824;64
7033;The Secret of My Succe$s;93936;5.4;19;11;8;57;0;4;2;2;50;3;3534;57
7034;Fucking Åmål;150662;7.6;39;35;4;89;7.8;10;9;1;90;3.9;4417;84
7035;Streets of Fire;88194;5.9;20;12;8;60;0;1;1;0;100;3.5;2031;70
7036;Teen Wolf;90142;4.6;17;8;9;47;0;0;0;0;0;0;0;0
7037;Tacones lejanos;103030;5.9;12;7;5;58;0;4;1;3;25;3.9;2771;85
7038;Things You Can Tell Just by Looking at Her;210358;6.5;19;14;5;73;0;4;4;0;100;3.3;1417;61
7039;Thunderheart;105585;6.4;15;13;2;86;0;2;1;1;50;3.4;2637;70
7040;To Live and Die in L.A.;90180;7.1;23;20;3;86;0;1;1;0;100;3.6;2714;74
7041;Trapped in Paradise;111477;3.1;20;2;18;10;2.8;7;1;6;14;2.9;2272;42
7042;37°2 le matin;90563;6.4;25;19;6;76;5.6;9;5;4;55;4.1;3961;90
7043;Vivre sa vie: Film en douze tableaux;56663;7.9;26;24;2;92;7.5;6;5;1;83;4.3;2190;92
7044;Wild at Heart;100935;5.8;42;27;15;64;5;8;3;5;37;3.7;11690;81
7045;The Witches;100944;7.5;13;13;0;100;0;2;2;0;100;3.2;8849;61
7046;The Witches of Eastwick;94332;6.2;26;19;7;73;0;1;1;0;100;3.2;12158;60
7047;Year of the Dragon;90350;6.1;15;9;6;60;0;0;0;0;0;0;0;0
7048;Nothing to Lose;119807;5.1;23;6;17;26;5.7;5;1;4;20;3.1;5245;67
7049;Flying Down to Rio;24025;7.5;5;5;0;100;0;0;0;0;0;0;0;0
7050;Follow the Fleet;27630;7.1;8;6;2;75;0;0;0;0;0;0;0;0
7051;What's New Pussycat;59903;5.5;10;4;6;40;0;3;1;2;33;3.3;1538;57
7052;Mary of Scotland;27948;0;0;0;0;0;0;0;0;0;0;0;0;0
7053;Roberta;26942;6.6;5;4;1;80;0;0;0;0;0;0;0;0
7054;Little Women;110367;0;0;0;0;0;0;0;0;0;0;0;0;0
7055;Swing Time;28333;8.6;19;19;0;100;0;4;4;0;100;0;0;0
7056;The Public Enemy;22286;8.4;26;26;0;100;0;2;2;0;100;3.9;1936;84
7057;A Midsummer Night's Dream;140379;0;0;0;0;0;0;0;0;0;0;0;0;0
7058;Life with Father;39566;7.1;7;7;0;100;0;0;0;0;0;0;0;0
7059;National Velvet;37120;7.8;11;11;0;100;0;0;0;0;0;0;0;0
7060;Jesus Christ Superstar;70239;5.9;21;12;9;57;0;2;1;1;50;3.4;5991;75
7061;Dark Victory;31210;7.2;19;16;3;84;0;1;1;0;100;3.9;1297;83
7062;Birdman of Alcatraz;55798;6.9;15;12;3;80;0;0;0;0;0;0;0;0
7063;Aguirre, der Zorn Gottes;68182;8.9;32;31;1;96;0;3;3;0;100;4.2;6781;91
7064;La belle et la bête;38348;0;0;0;0;0;0;0;0;0;0;0;0;0
7065;The Birth of a Nation;4972;8;31;31;0;100;0;4;4;0;100;3.3;1249;58
7066;Lan feng zheng;107358;8;8;8;0;100;0;2;2;0;100;3.9;476;85
7067;Giulietta degli spiriti;59229;7.2;21;18;3;85;7.1;7;6;1;85;4;1862;85
7068;L'année dernière à Marienbad;54632;8.1;34;32;2;94;8.8;7;7;0;100;4.2;2222;86
7069;The Tragedy of Macbeth;67372;7.7;24;20;4;83;0;4;2;2;50;3.3;1824;65
7070;Red River;40724;8.6;18;18;0;100;0;3;3;0;100;0;0;0
7071;A Woman Under the Influence;72417;8;19;17;2;89;0;3;3;0;100;4.3;2367;93
7072;Stagecoach;31971;8.9;26;26;0;100;0;0;0;0;0;0;0;0
7073;A Shot in the Dark;58586;7.9;20;20;0;100;0;0;0;0;0;0;0;0
7074;Flight of the Navigator;91059;5.7;7;5;2;71;0;0;0;0;0;0;0;0
7075;The Court Jester;49096;7.6;13;13;0;100;0;0;0;0;0;0;0;0
7076;Bullitt;62765;7.7;33;32;1;96;7.1;5;4;1;80;3.8;8312;84
7077;Way Down East;11841;8.3;8;7;1;87;0;0;0;0;0;0;0;0
7078;Jezebel;30287;7.5;13;13;0;100;0;0;0;0;0;0;0;0
7079;The Hunchback of Notre Dame;31455;8.3;9;9;0;100;0;0;0;0;0;0;0;0
7080;42nd Street;24034;7.8;20;19;1;95;0;2;1;1;50;3.5;1572;71
7081;I'm No Angel;24166;7.7;8;8;0;100;0;0;0;0;0;0;0;0
7082;That Touch of Mink;56575;5.4;9;6;3;66;0;0;0;0;0;0;0;0
7083;Sweet Dreams;90110;6.4;12;11;1;91;0;1;0;1;0;3.7;1151;77
7084;Play It Again, Sam;69097;7.4;32;31;1;96;0;1;1;0;100;3.9;3355;86
7085;Send Me No Flowers;58571;6.4;7;5;2;71;0;0;0;0;0;0;0;0
7086;Pygmalion;30637;8.2;16;15;1;93;0;3;3;0;100;3.7;900;82
7087;A Passage to India;87892;7.3;20;17;3;85;0;4;3;1;75;3.6;1652;74
7088;Orfeu Negro;53146;7.8;21;19;2;90;0;4;4;0;100;4;1619;86
7089;Amarcord;71129;8.2;39;36;3;92;8.4;10;9;1;90;4.2;5273;90
7090;Ying xiong;299977;0;0;0;0;0;0;0;0;0;0;0;0;0
7091;Horse Feathers;23027;8.2;24;23;1;95;0;3;3;0;100;3.9;2168;86
7092;Anna Karenina;26071;7.4;7;7;0;100;0;0;0;0;0;0;0;0
7093;The Front Page;71524;5.8;24;16;8;66;0;1;1;0;100;3.6;905;73
7094;The Rules of Attraction;292644;5.3;134;59;75;44;4.9;27;9;18;33;3.2;10253;71
7095;Looking for Mr. Goodbar;76327;6.4;19;15;4;78;0;2;2;0;100;0;0;0
7096;Rivers and Tides;307385;8.1;70;69;1;98;7.8;21;20;1;95;4.2;236;86
7097;Une hirondelle a fait le printemps;240149;6.9;41;37;4;90;7.2;15;13;2;86;3.5;505;64
7099;Kaze no tani no Naushika;87544;8.2;8;8;0;100;0;0;0;0;0;0;0;0
7100;CrissCross;104027;0;0;0;0;0;0;0;0;0;0;0;0;0
7101;Doc Hollywood;101745;5.9;24;18;6;75;0;1;1;0;100;2.7;3776;43
7102;Dragnet;92925;4.9;28;13;15;46;6.4;6;5;1;83;0;0;0
7103;Madhouse;363276;0;1;0;1;0;0;0;0;0;0;0;0;0
7104;1941;78723;5.2;21;7;14;33;0;1;0;1;0;3;5333;48
7105;A Shot at Glory;193854;6;21;14;7;66;0;4;4;0;100;3.3;476;61
7106;Noirs et blancs en couleur;74972;0;4;4;0;100;0;0;0;0;0;0;0;0
7107;Foul Play;77578;6.2;20;14;6;70;0;3;1;2;33;3.4;1837;67
7108;Zhong an zu;108656;6.6;15;14;1;93;0;1;1;0;100;3.3;1708;60
7109;Al di là delle nuvole;114086;6.4;20;13;7;65;0;4;3;1;75;3.6;976;68
7110;Môjû tai Issunbôshi;374076;\N;\N;\N;\N;\N;\N;\N;\N;\N;\N;\N;\N;\N
7111;Ryan's Daughter;66319;5.5;16;8;8;50;5.5;5;2;3;40;3.9;717;79
7112;Crash;375679;7.1;197;148;49;75;7.1;39;30;9;76;4;98746;89
7113;Cabeza de Vaca;101529;0;0;0;0;0;0;0;0;0;0;0;0;0
7114;The Bone Collector;145681;4.7;84;23;61;27;4.7;23;7;16;30;3.3;26317;68
7115;Profondo rosso;73582;8;18;18;0;100;0;0;0;0;0;0;0;0
7116;Les diaboliques;46911;8.2;23;22;1;95;7.8;5;4;1;80;4.1;3066;91
7117;Leprechaun;107387;4;10;3;7;30;0;1;0;1;0;2.5;4764;38
7118;Ôritsu uchûgun Oneamisu no tsubasa;93207;6.9;9;9;0;100;0;3;3;0;100;3.7;1212;75
7119;Movie Crazy;23241;0;1;0;1;0;0;0;0;0;0;0;0;0
7120;Dark Wolf;326820;0;0;0;0;0;0;0;0;0;0;0;0;0
7121;Adam's Rib;41090;8.2;23;23;0;100;0;3;3;0;100;3.9;3056;85
7122;Le roi de coeur;60908;7.4;10;9;1;90;0;2;1;1;50;4;779;86
7123;Naked Lunch;102511;6.8;31;21;10;67;0;2;1;1;50;3.6;7592;78
7124;The Grass Is Greener;53877;6.6;7;7;0;100;0;0;0;0;0;0;0;0
7125;Spring Forward;156096;7.5;22;19;3;86;0;2;2;0;100;3.8;237;78
7126;The Killing of a Chinese Bookie;74749;6.2;15;12;3;80;0;2;1;1;50;3.9;1173;83
7127;Run Fatboy Run;425413;5.5;143;69;74;48;5.5;31;17;14;54;3.5;43462;66
7128;Things to Come;28358;7.5;20;19;1;95;0;3;2;1;66;3.3;608;54
7129;Queen of Hearts;98153;0;3;2;1;66;0;1;1;0;100;0;0;0
7130;My Darling Clementine;38762;8.7;22;22;0;100;0;1;1;0;100;3.8;1741;83
7131;A Summer Place;53320;6;6;5;1;83;0;0;0;0;0;0;0;0
7132;A Night at the Opera;26778;8.5;33;32;1;96;0;3;2;1;66;4.1;4515;90
7133;Metalstorm: The Destruction of Jared-Syn;85935;0;0;0;0;0;0;0;0;0;0;0;0;0
7134;Forbrydelsens element;87280;6.3;13;10;3;76;0;0;0;0;0;0;0;0
7135;Tirez sur le pianiste;54389;8.6;18;17;1;94;0;3;2;1;66;0;0;0
7136;Baisers volés;62695;7.7;16;15;1;93;0;1;1;0;100;4;1610;88
7137;The Cooler;318374;6.7;168;129;39;76;7.2;36;32;4;88;3.3;3858;68
7138;El bonaerense;315850;6.7;11;10;1;90;6.6;5;4;1;80;3.1;27;53
7139;In America;298845;7.7;170;151;19;88;7.8;40;37;3;92;3.8;6695;89
7141;My Flesh and Blood;342804;7.6;30;27;3;90;7.8;11;10;1;90;4;459;89
7142;Honey;322589;4.1;111;22;89;19;4.1;30;5;25;16;3.4;89773;76
7143;The Last Samurai;325710;6.4;213;138;75;64;5.9;41;23;18;56;3.7;87574;82
7144;Forget Baghdad: Jews and Arabs - The Iraqi Connection;329094;6.9;12;9;3;75;0;4;3;1;75;3.5;42;56
7146;What Alice Found;343172;6.3;38;26;12;68;6.8;11;9;2;81;3.1;213;46
7147;Big Fish;319061;7.2;211;161;50;76;6.4;41;25;16;60;3.7;112139;86
7148;Love Don't Cost a Thing;337592;3.7;71;9;62;12;4.1;24;4;20;16;3.1;6106;70
7149;Something's Gotta Give;337741;6.5;163;115;48;70;6.8;39;29;10;74;3.2;24174;68
7150;Stuck on You;338466;0;0;0;0;0;0;0;0;0;0;0;0;0
7151;Girl with a Pearl Earring;335119;6.8;172;123;49;71;6.7;39;30;9;76;3.4;16783;67
7152;The Statement;340376;4.7;106;25;81;23;4.5;32;6;26;18;3;654;38
7153;The Lord of the Rings: The Return of the King;167260;8.6;239;225;14;94;8.6;43;42;1;97;3.7;288649;83
7154;Mona Lisa Smile;304415;4.9;147;51;96;34;5.2;41;18;23;43;3.1;23577;61
7155;Calendar Girls;337909;6.5;118;87;31;73;6.5;33;23;10;69;3.1;8453;59
7156;The Fog of War: Eleven Lessons from the Life of Robert S. McNamara;317910;8.4;135;132;3;97;8.4;35;34;1;97;4.1;4231;92
7157;The Hebrew Hammer;317640;5.1;23;12;11;52;4.8;12;6;6;50;3.2;1577;61
7158;House of Sand and Fog;315983;7.1;168;126;42;75;7.9;33;29;4;87;3.6;8761;81
7159;Two Men Went to War;304857;5.6;27;17;10;62;5.1;8;4;4;50;3.3;218;63
7160;Monster;340855;7.2;182;149;33;81;7.4;37;33;4;89;3.5;17719;78
7161;Cheaper by the Dozen;349205;4.6;111;26;85;23;4.9;31;10;21;32;3.1;62198;65
7162;Cold Mountain;159365;6.7;221;156;65;70;7.5;42;38;4;90;3.3;26002;74
7163;Paycheck;338337;4.7;151;42;109;27;4.5;31;4;27;12;2.9;19654;52
7164;Peter Pan;316396;6.8;132;100;32;75;6.3;33;23;10;69;3.3;47413;68
7165;The Company;335013;6.6;124;86;38;69;6.6;31;20;11;64;3;1840;43
7166;The Young Black Stallion;318850;5.4;39;17;22;43;5.7;14;7;7;50;3.6;930;72
7167;Japanese Story;304229;6.4;89;60;29;67;6.5;30;21;9;70;3.5;1232;70
7168;Choses secrètes;287963;5.6;49;24;25;48;5.3;19;8;11;42;3;168;40
7169;Chasing Liberty;360139;0;0;0;0;0;0;0;0;0;0;0;0;0
7170;My Baby's Daddy;332712;2.8;51;2;49;3;3.1;17;1;16;5;3.1;1999;57
7171;Aileen: Life and Death of a Serial Killer;364930;7.1;57;49;8;85;7.3;20;18;2;90;3.5;1623;72
7172;Uzak;346094;7.8;43;38;5;88;7.9;16;15;1;93;3.9;1453;82
7173;Along Came Polly;343135;4.8;152;39;113;25;4.7;36;8;28;22;3.1;42224;54
7174;Teacher's Pet;350194;6.5;72;54;18;75;6.7;25;19;6;76;2.8;370;38
7175;Torque;329691;4.2;111;25;86;22;4.3;30;6;24;20;2.9;17598;55
7176;Talaye sorkh;371280;7.5;73;63;10;86;8;25;24;1;96;3.7;506;77
7177;Osama;368913;7.8;101;97;4;96;8;35;34;1;97;3.9;1868;86
7178;The Great Gatsby;71577;4.8;26;10;16;38;0;4;0;4;0;3.2;3750;56
7179;Wuthering Heights;32145;7.9;16;16;0;100;0;1;1;0;100;3.9;2525;84
7180;Odds Against Tomorrow;53133;0;2;2;0;100;0;0;0;0;0;0;0;0
7181;Ship of Fools;59712;6.8;16;13;3;81;0;3;2;1;66;3.6;400;74
7182;Lord Love a Duck;60636;6.9;7;5;2;71;0;0;0;0;0;0;0;0
7183;There's a Girl in My Soup;66449;0;2;1;1;50;0;0;0;0;0;0;0;0
7184;This Property Is Condemned;61089;5.5;14;9;5;64;0;3;2;1;66;3.8;780;75
7185;What Doesn't Kill You;1133991;6;32;21;11;65;6.3;10;8;2;80;3.1;2596;45
7186;Once Upon a Crime...;101625;3.7;6;0;6;0;0;0;0;0;0;0;0;0
7187;Beyond Therapy;92646;4.2;8;2;6;25;0;3;0;3;0;2.7;388;34
7188;The General;17925;8.9;38;35;3;92;0;4;2;2;50;4.4;3785;93
7189;Car 54, Where Are You?;109376;1.9;13;0;13;0;0;3;0;3;0;2.2;859;22
7190;Jane Eyre;780362;\N;\N;\N;\N;\N;\N;\N;\N;\N;\N;\N;\N;\N
7191;Blame It on the Bellboy;103827;2.4;9;1;8;11;0;0;0;0;0;0;0;0
7192;Only the Strong;107750;2.8;7;0;7;0;2.5;5;0;5;0;3.7;1259;79
7193;The Adventures of Ford Fairlane;98987;3.5;22;6;16;27;0;2;0;2;0;3.2;2144;66
7194;Bonjour tristesse;51429;6.7;13;11;2;84;0;3;1;2;33;3.6;458;67
7195;The Enforcer;74483;6.3;26;20;6;76;0;1;1;0;100;3.4;3350;61
7196;X-Men;120903;7;152;124;28;81;5.8;32;19;13;59;3.7;133573;83
7197;Ransom;117438;6.4;30;21;9;70;5.7;7;4;3;57;3.1;10364;61
7198;The Pick-up Artist;93737;5;20;11;9;55;5.2;6;3;3;50;2.8;1355;34
7199;Melvin Goes to Dinner;323633;7.3;11;11;0;100;0;3;3;0;100;3.6;651;77
7200;The Court-Martial of Billy Mitchell;47956;7.4;5;5;0;100;0;1;1;0;100;3.5;225;60
7201;Crime Spree;310924;5.8;6;3;3;50;0;4;2;2;50;3.3;616;57
7202;Beyond Re-Animator;222812;5.2;11;5;6;45;0;1;0;1;0;3;2279;42
7203;The Final Cut;364343;5.4;75;29;46;38;4.9;26;8;18;30;3;4745;48
7204;Hells Angels on Wheels;61758;4.4;7;2;5;28;0;1;0;1;0;3;814;39
7205;The Wind and the Lion;73906;6;10;6;4;60;0;0;0;0;0;0;0;0
7206;Mon oncle;50706;8.5;17;16;1;94;0;2;1;1;50;4.2;2439;89
7207;Where the Boys Are;54469;0;4;3;1;75;0;0;0;0;0;0;0;0
7208;Dr. Jekyll and Mr. Hyde;1159984;0;1;0;1;0;0;0;0;0;0;0;0;0
7209;Les vacances de Monsieur Hulot;46487;8.8;24;24;0;100;0;3;3;0;100;4;2052;86
7210;My Darling Clementine;38762;8.7;22;22;0;100;0;1;1;0;100;3.8;1741;83
7211;People Will Talk;43915;0;4;4;0;100;0;0;0;0;0;0;0;0
7212;I Was a Male War Bride;41498;6.7;14;11;3;78;0;2;1;1;50;3.6;1412;71
7213;Divorce American Style;61581;6.6;5;4;1;80;0;1;1;0;100;3.2;434;44
7214;Kiss Them for Me;50599;0;1;0;1;0;0;0;0;0;0;0;0;0
7215;To Have and Have Not;37382;8.1;21;21;0;100;0;3;3;0;100;4.1;3565;90
7216;High Sierra;33717;7.8;16;15;1;93;0;0;0;0;0;0;0;0
7217;Dark Passage;39302;7.6;14;13;1;92;0;0;0;0;0;0;0;0
7218;The Ox-Bow Incident;36244;8.1;17;16;1;94;0;0;0;0;0;0;0;0
7219;They Drive by Night;33149;6.8;17;16;1;94;0;0;0;0;0;0;0;0
7220;Micki + Maude;87718;5.3;6;4;2;66;0;1;1;0;100;2.9;446;41
7221;Platinum Blonde;22268;7.2;6;6;0;100;0;0;0;0;0;0;0;0
7222;Tell Your Children;28346;4.8;24;11;13;45;0;1;1;0;100;3;2726;45
7223;DOA: Dead or Alive;398913;4.5;44;15;29;34;4.2;10;2;8;20;2.7;71044;43
7224;The Boy with Green Hair;40185;7.1;8;6;2;75;0;0;0;0;0;0;0;0
7225;Pumping Iron;76578;7.3;23;22;1;95;0;4;4;0;100;0;0;0
7226;No Good Deed;292610;4;10;2;8;20;4.3;5;1;4;20;2.9;933;34
7227;The Trouble with Angels;61122;0;4;4;0;100;0;0;0;0;0;0;0;0
7228;Cool World;104009;3.2;31;2;29;6;0;4;0;4;0;2.6;8556;35
7229;Money for Nothing;107594;0;4;1;3;25;0;1;0;1;0;2.8;839;31
7230;The Silencers;60980;0;1;0;1;0;0;0;0;0;0;0;0;0
7231;Where Angels Go Trouble Follows!;63800;0;1;0;1;0;0;0;0;0;0;0;0;0
7232;Heat and Dust;84058;0;4;4;0;100;0;1;1;0;100;3.5;237;54
7234;La strada;47528;8.7;31;30;1;96;0;4;3;1;75;4.3;5992;94
7235;Koroshiya 1;296042;6.1;35;22;13;62;4.2;8;2;6;25;3.9;12533;83
7236;A Boy and His Dog;72730;6.6;30;23;7;76;0;3;0;3;0;3.4;2758;62
7237;The Last Tycoon;74777;5.4;18;8;10;44;0;3;1;2;33;3.2;859;49
7238;Popiól i diament;52080;8.4;8;7;1;87;0;0;0;0;0;0;0;0
7239;Marooned;64639;6.7;5;5;0;100;0;1;1;0;100;3;377;40
7240;King David;89420;3;8;1;7;12;0;0;0;0;0;0;0;0
7241;Kanal;50585;0;0;0;0;0;0;0;0;0;0;0;0;0
7242;Cat Chaser;97028;4.8;5;2;3;40;0;0;0;0;0;0;0;0
7243;Intolerance: Love's Struggle Throughout the Ages;6864;7.8;23;22;1;95;0;3;3;0;100;3.8;1397;77
7244;The Beast of Yucca Flats;54673;0;3;0;3;0;0;0;0;0;0;0;0;0
7245;Hets;36914;7;6;5;1;83;0;2;1;1;50;3.8;348;76
7247;Chitty Chitty Bang Bang;62803;5.4;22;13;9;59;0;2;2;0;100;3.2;18830;65
7248;Suriyothai;290879;5.6;58;31;27;53;5.3;19;8;11;42;3.4;414;60
7249;Plaza Suite;67589;5.5;6;3;3;50;0;0;0;0;0;0;0;0
7250;The Out-of-Towners;129280;5;34;8;26;23;4.9;5;1;4;20;2.6;2186;33
7251;Where the Day Takes You;105810;5.6;5;3;2;60;0;1;1;0;100;3.6;904;72
7252;The Three Stooges in Orbit;56580;0;0;0;0;0;0;0;0;0;0;0;0;0
7253;It;18033;6.6;8;8;0;100;0;1;1;0;100;3.7;773;78
7254;The Butterfly Effect;289879;4.8;166;55;111;33;3.8;34;6;28;17;3.6;109956;81
7255;Win a Date with Tad Hamilton!;335559;5.6;142;74;68;52;5.2;35;14;21;40;2.9;10675;48
7256;Touching the Void;379557;8;136;127;9;93;7.6;37;34;3;91;4.1;3095;91
7257;The Big Bounce;315824;4;132;21;111;15;3.8;35;4;31;11;2.5;3228;26
7258;The Perfect Score;314498;3.7;107;18;89;16;3.7;30;6;24;20;2.9;7659;50
7259;You Got Served;365957;0;0;0;0;0;0;0;0;0;0;0;0;0
7260;Latter Days;345551;5.4;46;20;26;43;5.4;16;7;9;43;4;3579;82
7261;Barbershop 2: Back in Business;337579;6.3;123;84;39;68;6.4;34;23;11;67;3.1;7601;58
7262;Catch That Kid;337917;3.8;84;9;75;10;3.7;27;2;25;7;3.1;5038;56
7263;Miracle;349825;7;156;124;32;79;6.8;37;29;8;78;3.7;11958;88
7264;Un couple épatant;234940;0;0;0;0;0;0;0;0;0;0;0;0;0
7265;The Dreamers;309987;6.2;154;93;61;60;6;39;20;19;51;3.7;12547;78
7266;The Lost Skeleton of Cadavra;307109;5.9;68;36;32;52;6.1;19;11;8;57;3.9;1458;84
7267;Who's the Man?;108560;5.3;7;3;4;42;0;2;1;1;50;2.9;682;50
7269;Hangin' with the Homeboys;101998;7.1;5;4;1;80;0;2;2;0;100;3.3;433;57
7270;Sleep with Me;111218;4.6;12;2;10;16;0;3;0;3;0;3.2;521;48
7271;Just Between Friends;91310;4.6;6;2;4;33;0;1;0;1;0;3;662;39
7272;Super Fly;69332;7.1;21;19;2;90;0;3;3;0;100;3.5;1082;70
7273;A Piece of the Action;76543;0;1;1;0;100;0;0;0;0;0;0;0;0
7274;Let's Do It Again;45995;0;0;0;0;0;0;0;0;0;0;0;0;0
7275;Uptown Saturday Night;72351;6.4;7;5;2;71;0;0;0;0;0;0;0;0
7276;Hell's Kitchen;129136;4.6;5;2;3;40;0;0;0;0;0;0;0;0
7277;Presumed Innocent;100404;7.2;31;29;2;93;7.5;8;8;0;100;3.2;3836;60
7278;Daddy and Them;166158;6.3;6;5;1;83;0;0;0;0;0;0;0;0
7279;The Wilby Conspiracy;73901;0;3;2;1;66;0;0;0;0;0;0;0;0
7280;Blacula;68284;5.1;19;8;11;42;0;2;1;1;50;2.8;1108;42
7281;Scream Blacula Scream;70656;0;3;1;2;33;0;0;0;0;0;0;0;0
7282;Da Hip Hop Witch;245943;\N;\N;\N;\N;\N;\N;\N;\N;\N;\N;\N;\N;\N
7283;Swing Shift;88213;7.2;6;6;0;100;0;1;1;0;100;2.9;671;31
7284;Trespass;105636;6.1;22;15;7;68;5.5;6;3;3;50;3;1402;48
7285;Ocean's Thirteen;496806;6.4;195;136;59;69;6;43;25;18;58;3.6;846364;74
7286;Simple Men;105411;7.1;10;9;1;90;0;2;1;1;50;3.9;685;88
7288;Foolish Wives;13140;9;7;7;0;100;0;0;0;0;0;0;0;0
7289;Silent Night, Bloody Night;70694;0;2;0;2;0;0;0;0;0;0;0;0;0
7290;The Sin of Harold Diddlebock;39825;6.7;9;8;1;88;0;2;2;0;100;3.3;264;54
7291;Pontiac Moon;110867;0;0;0;0;0;0;0;0;0;0;0;0;0
7292;Best Defense;86955;0;4;0;4;0;0;1;0;1;0;2.4;1191;19
7293;50 First Dates;343660;5.4;172;76;96;44;5.3;38;18;20;47;3.4;217959;68
7294;Welcome to Mooseport;361925;4.2;144;19;125;13;4.3;38;6;32;15;2.5;2414;24
7295;Après la vie;233230;7.2;33;31;2;93;7.7;12;12;0;100;3.8;54;75
7297;Salmer fra kjøkkenet;323872;7.3;75;67;8;89;7.1;25;24;1;96;4;1308;86
7298;La mentale;304391;0;0;0;0;0;0;0;0;0;0;0;0;0
7299;Monsieur Ibrahim et les fleurs du Coran;329388;7;80;68;12;85;7.4;25;24;1;96;3.9;1791;85
7300;Vanishing Point;67927;6.3;16;12;4;75;0;4;2;2;50;3.9;4207;81
7301;Journal d'un curé de campagne;42619;8.3;17;15;2;88;0;2;1;1;50;4.1;1108;88
7302;The Thief of Bagdad;15400;8.1;13;13;0;100;0;1;1;0;100;3.6;655;75
7303;The Diary of Anne Frank;52738;6.8;15;11;4;73;0;2;1;1;50;3.5;6344;74
7304;Allegro non troppo;74121;7.3;17;15;2;88;0;1;1;0;100;3.8;1302;81
7305;Black Widow;1046894;0;1;0;1;0;0;0;0;0;0;0;0;0
7306;La ley de Herodes;221344;6.4;25;17;8;68;6.3;10;7;3;70;4;575;88
7307;Flesh+Blood;89153;6;8;6;2;75;0;0;0;0;0;0;0;0
7308;King Solomon's Mines;42646;7.4;11;10;1;90;0;0;0;0;0;0;0;0
7309;The Black Pirate;16654;8.1;7;7;0;100;0;0;0;0;0;0;0;0
7310;Raw Deal;91828;3.8;12;3;9;25;0;1;0;1;0;2.7;3041;32
7311;Goodbye, Mr. Chips;31385;7.8;16;13;3;81;0;0;0;0;0;0;0;0
7312;Follow Me, Boys!;60420;0;0;0;0;0;0;0;0;0;0;0;0;0
7313;Fire Birds;99575;3.1;15;1;14;6;0;4;0;4;0;2.9;1449;41
7314;Robot Stories;301777;6.6;42;30;12;71;6.6;15;11;4;73;3.1;471;51
7315;Against the Ropes;312329;4.2;131;16;115;12;4.3;34;6;28;17;2.8;1809;35
7316;Confessions of a Teenage Drama Queen;361467;3.8;88;11;77;12;3.8;25;3;22;12;2.7;33054;48
7317;EuroTrip;356150;0;0;0;0;0;0;0;0;0;0;0;0;0
7318;The Passion of the Christ;335345;5.8;262;130;132;49;4.9;47;17;30;36;3.7;51559;84
7319;Club Dread;331953;4.4;98;29;69;29;4.3;26;7;19;26;2.7;7120;45
7320;Dirty Dancing: Havana Nights;338096;4.3;105;24;81;22;3.7;34;4;30;11;3.2;46963;71
7321;Twisted;315297;2.9;132;2;130;1;3.2;36;0;36;0;2.8;2961;40
7322;Alila;349079;5.3;17;7;10;41;5.2;6;2;4;33;3;221;40
7323;Good Bye Lenin!;301357;7.4;105;94;11;89;6.6;28;23;5;82;4;16904;91
7324;Hidalgo;317648;5.6;157;73;84;46;5.5;36;16;20;44;3.2;13730;70
7325;Starsky & Hutch;335438;6;188;120;68;63;6;41;28;13;68;3;28412;54
7326;The Reckoning;258816;5.6;85;34;51;40;5.5;28;12;16;42;3.3;1019;60
7327;Persona;60827;8.6;29;27;2;93;0;4;3;1;75;4.4;7552;94
7328;En passion;64793;8.2;11;11;0;100;0;2;2;0;100;4;746;85
7329;Walk on the Wild Side;56671;0;4;2;2;50;0;0;0;0;0;0;0;0
7330;Tokyo Joe;41967;0;3;2;1;66;0;0;0;0;0;0;0;0
7331;The Serpent's Egg;76686;4.5;12;3;9;25;0;4;0;4;0;3.3;729;58
7332;Fire Down Below;119123;3.3;26;3;23;11;3.3;7;1;6;14;2.6;3327;48
7333;Le corbeau;35753;7.7;23;20;3;86;0;3;1;2;33;4;807;90
7334;All Quiet on the Western Front;20629;8.6;32;31;1;96;7.8;5;5;0;100;3.8;3797;85
7335;Pickup on South Street;46187;7.6;25;22;3;88;0;3;1;2;33;4;1058;89
7336;La caduta degli dei;64118;8.1;10;9;1;90;0;1;1;0;100;4;255;82
7337;American Gun;416471;5.3;30;11;19;36;5;12;4;8;33;3.2;1027;49
7338;Richard III;114279;8.1;43;41;2;95;7.6;11;10;1;90;3.7;1552;82
7339;Quartet;82964;0;2;0;2;0;0;0;0;0;0;0;0;0
7340;Just One of the Guys;89393;4.6;10;4;6;40;0;2;0;2;0;3.3;2022;66
7341;The Chase;60232;6.5;5;4;1;80;0;0;0;0;0;0;0;0
7342;The Last Kiss;434139;5.7;124;57;67;45;6;31;15;16;48;3.2;37077;59
7343;Wisconsin Death Trip;210389;6.4;11;9;2;81;0;3;2;1;66;3.5;346;66
7344;The Wrong Arm of the Law;56704;0;0;0;0;0;0;0;0;0;0;0;0;0
7345;Agent Cody Banks 2: Destination London;358349;3.4;91;11;80;12;3.9;24;4;20;16;2.5;13037;41
7346;The Girl Next Door;265208;5.6;156;87;69;55;5;32;17;15;53;3.3;39311;71
7347;Secret Window;363988;5.5;158;73;85;46;5.5;37;18;19;48;3.3;56932;69
7348;Spartan;360009;6.5;131;84;47;64;6.3;41;22;19;53;3.3;3343;61
7349;Knafayim Shvurot;317842;7.3;67;62;5;92;7.4;22;21;1;95;4;613;87
7351;How to Draw a Bunny;303348;7;27;22;5;81;6.6;8;6;2;75;3.9;404;81
7352;Wilbur Wants to Kill Himself;329767;7.1;78;67;11;85;6.8;26;20;6;76;3.5;1296;69
7353;Clifford's Really Big Movie;398872;5.6;31;16;15;51;5.6;12;6;6;50;3;524;41
7354;Mad Dog and Glory;107473;6.2;26;20;6;76;6.2;6;4;2;66;3;2359;41
7355;The Wind in the Willows;118172;6.9;8;6;2;75;0;0;0;0;0;0;0;0
7356;Night Crossing;82810;0;3;3;0;100;0;0;0;0;0;0;0;0
7357;Peyton Place;50839;6.1;9;5;4;55;0;0;0;0;0;0;0;0
7358;Searching for Debra Winger;318049;0;4;3;1;75;0;1;1;0;100;3.2;487;50
7359;Walk Like a Man;94288;0;1;0;1;0;0;0;0;0;0;0;0;0
7360;Dawn of the Dead;363547;6.7;171;130;41;76;6.1;32;20;12;62;3.4;49706;75
7361;Eternal Sunshine of the Spotless Mind;338013;8.3;216;200;16;92;7.9;42;38;4;90;4;177263;93
7362;Taking Lives;364045;4.6;155;35;120;22;4.7;37;10;27;27;3.2;13988;63
7364;Intermission;332658;6.6;96;70;26;72;6.8;28;21;7;75;3.6;2948;76
7365;Nói albínói;351461;7;53;46;7;86;6.4;15;12;3;80;3.9;1758;85
7366;Jersey Girl;300051;5.3;169;69;100;40;4.7;38;12;26;31;2.9;16772;52
7367;The Ladykillers;335245;6.1;185;101;84;54;5.8;39;18;21;46;2.8;12107;40
7368;Never Die Alone;354766;4.1;89;23;66;25;4.3;28;8;20;28;3.3;2511;65
7369;Scooby Doo 2: Monsters Unleashed;331632;4.2;111;24;87;21;3.6;25;3;22;12;2.7;15310;57
7370;A Foreign Affair;40367;7.6;9;9;0;100;0;2;2;0;100;3.7;504;75
7371;Dogville;276919;6.9;152;106;46;69;6.8;40;28;12;70;4;17210;88
7372;Ned Kelly;277941;5.7;54;30;24;55;5.2;15;4;11;26;3.2;7741;60
7373;Hellboy;167190;6.8;195;157;38;80;6.8;38;33;5;86;3.2;65444;63
7374;Home on the Range;299172;5.7;120;65;55;54;5.3;30;11;19;36;2.8;4447;44
7375;The Prince & Me;337697;4.8;118;33;85;27;4.5;32;7;25;21;3.1;29626;67
7376;Walking Tall;351977;4.4;130;32;98;24;4.6;34;7;27;20;3.2;20192;71
7377;The United States of Leland;301976;4.9;87;29;58;33;4.5;27;7;20;25;3.8;6163;83
7379;The Alamo;318974;0;0;0;0;0;0;0;0;0;0;0;0;0
7380;Ella Enchanted;327679;5.6;113;56;57;49;5.7;30;14;16;46;3.1;50156;62
7381;The Whole Ten Yards;327247;2.8;116;5;111;4;3.3;31;2;29;6;3;11437;51
7382;Io non ho paura;326977;7.5;98;88;10;89;7.3;32;28;4;87;3.9;1989;87
7383;Shade;323939;5.8;15;10;5;66;0;3;2;1;66;3.3;1382;60
7384;Depuis qu'Otar est parti...;336264;7.9;55;54;1;98;8.1;20;20;0;100;4;492;84
7385;Twentynine Palms;315110;4.9;36;16;20;44;4.6;13;4;9;30;2.8;474;44
7386;The Ten Commandments;49833;7.3;29;26;3;89;0;4;2;2;50;3.6;11440;83
7387;Dawn of the Dead;363547;6.7;171;130;41;76;6.1;32;20;12;62;3.4;49706;75
7388;Fratello sole, sorella luna;69824;5.6;8;5;3;62;0;1;0;1;0;3.8;742;77
7389;One Million Years B.C.;60782;5.5;6;3;3;50;0;0;0;0;0;0;0;0
7390;Prey for Rock & Roll;307351;5.8;46;26;20;56;6.3;14;10;4;71;3.4;876;66
7391;Mother, Jugs & Speed;74923;5.4;13;7;6;53;0;2;1;1;50;0;0;0
7392;Bandolero!;62708;0;0;0;0;0;0;0;0;0;0;0;0;0
7393;The Slugger's Wife;90036;3.3;8;0;8;0;0;2;0;2;0;2.8;189;24
7394;Those Magnificent Men in Their Flying Machines or How I Flew from London to Paris in 25 hours 11 minutes;59797;5.8;6;4;2;66;0;0;0;0;0;0;0;0
7395;Cheaper by the Dozen;349205;4.6;111;26;85;23;4.9;31;10;21;32;3.1;62198;65
7396;Scener ur ett äktenskap;70644;8.5;16;15;1;93;0;3;2;1;66;4.4;2761;93
7397;Baby the Rain Must Fall;58930;0;3;3;0;100;0;0;0;0;0;0;0;0
7398;Belles on Their Toes;44410;0;1;1;0;100;0;0;0;0;0;0;0;0
7399;Ned Kelly;277941;5.7;54;30;24;55;5.2;15;4;11;26;3.2;7741;60
7401;Mac and Me;95560;2.4;14;0;14;0;0;2;0;2;0;2.7;2264;43
7402;The Food of the Gods;74540;3.6;14;3;11;21;0;1;0;1;0;2.8;401;31
7403;Food of the Gods II;97371;\N;\N;\N;\N;\N;\N;\N;\N;\N;\N;\N;\N;\N
7404;Miracle at St. Anna;1046997;5.2;113;38;75;33;4.8;32;8;24;25;3.3;8435;56
7405;Road to Bali;45094;0;4;2;2;50;0;0;0;0;0;0;0;0
7406;The Flying Deuces;31322;6;6;5;1;83;0;0;0;0;0;0;0;0
7407;Africa Screams;41098;0;4;2;2;50;0;0;0;0;0;0;0;0
7408;Jack and the Beanstalk: The Real Story;264262;0;3;1;2;33;0;0;0;0;0;0;0;0
7409;Shu dan long wei;114437;0;3;2;1;66;0;1;1;0;100;0;0;0
7410;The Osterman Weekend;86058;5.5;14;6;8;42;0;3;0;3;0;3;724;40
7411;Harold & Kumar Go to White Castle;366551;6.5;144;106;38;73;6.7;30;22;8;73;3.5;61100;79
7413;Hangman's Curse;342508;2.9;6;0;6;0;0;2;0;2;0;3.7;1853;77
7414;Going in Style;79219;0;4;4;0;100;0;0;0;0;0;0;0;0
7415;Late Show with David Letterman;106053;\N;\N;\N;\N;\N;\N;\N;\N;\N;\N;\N;\N;\N
7416;The Sunshine Boys;73766;7.1;15;14;1;93;0;0;0;0;0;0;0;0
7417;Jersey Girl;300051;5.3;169;69;100;40;4.7;38;12;26;31;2.9;16772;52
7418;American Nightmare;247164;0;0;0;0;0;0;0;0;0;0;0;0;0
7419;After Hours;88680;7.8;37;34;3;91;6.7;5;4;1;80;3.8;5298;85
7420;Viva Las Vegas;58725;6.6;22;18;4;81;0;3;3;0;100;3.4;1800;71
7437;Connie and Carla;345074;5.1;119;52;67;43;5.3;32;17;15;53;3.4;3049;66
7438;Kill Bill: Vol. 2;378194;7.7;226;193;33;85;7.7;43;35;8;81;3.8;162324;87
7439;Punisher: War Zone;450314;4.2;96;25;71;26;3.7;21;1;20;4;3;29393;47
7440;Paper Clips;380615;6.3;52;37;15;71;6.8;16;13;3;81;3.8;723;75
7441;Mil nubes de paz cercan el cielo, amor, jamás acabarás de ser amor;358590;4.6;26;8;18;30;3.7;10;2;8;20;3.2;105;48
7442;Young Adam;289635;6.3;116;72;44;62;6.4;32;20;12;62;3.1;2330;48
7444;13 Going on 30;337563;6.2;161;104;57;64;6.6;35;26;9;74;3.3;96034;70
7445;Man on Fire;328107;5.2;157;61;96;38;5.1;38;14;24;36;3.9;67139;89
7446;Clifford's Really Big Movie;398872;5.6;31;16;15;51;5.6;12;6;6;50;3;524;41
7447;MC5*: A True Testimonial;333847;7.2;15;14;1;93;7;7;6;1;85;4.5;88;96
7448;Envy;326856;3.1;114;8;106;7;2.9;33;0;33;0;2.5;7245;33
7449;Godsend;335121;3.4;135;6;129;4;3.3;35;1;34;2;2.5;5199;29
7450;Laws of Attraction;323033;4.5;143;26;117;18;4.4;39;7;32;17;2.9;5210;49
7451;Mean Girls;377092;6.9;170;141;29;82;6.6;40;31;9;77;3;245101;66
7452;The Wrestler;1125849;8.3;207;202;5;97;8.2;37;36;1;97;3.9;57550;86
7453;New York Minute;363282;3.5;115;13;102;11;3.7;31;4;27;12;3;18023;57
7454;Van Helsing;338526;0;0;0;0;0;0;0;0;0;0;0;0;0
7455;The Mudge Boy;339419;6.4;26;20;6;76;6.4;13;10;3;76;3.7;728;73
7456;My Bloody Valentine;1179891;5.7;85;48;37;56;5.2;8;3;5;37;3.1;111307;49
7457;Breakin' All the Rules;349169;4.8;86;28;58;32;5;28;11;17;39;3.3;2699;64
7458;Troy;332452;6;216;118;98;54;6.2;43;28;15;65;3.5;148904;74
7459;Carandiru;293007;6.6;77;53;24;68;7.4;29;25;4;86;3.9;2413;83
7460;Coffee and Cigarettes;379217;6.2;118;75;43;63;6.2;36;25;11;69;3.5;10991;75
7461;Les égarés;329111;6.6;58;43;15;74;6.8;21;16;5;76;3.5;542;61
7474;The Boys in the Band;65488;7.1;15;15;0;100;0;0;0;0;0;0;0;0
7478;Swimming to Cambodia;94089;7.8;8;8;0;100;0;1;1;0;100;4.1;390;92
7479;Watch on the Rhine;36515;0;2;1;1;50;0;0;0;0;0;0;0;0
7480;Courage Under Fire;115956;7.3;52;44;8;84;7.8;15;14;1;93;3.2;6918;61
7481;Enemy Mine;89092;5.7;22;13;9;59;0;1;0;1;0;3.3;3733;69
7482;Enter the Dragon;70034;0;0;0;0;0;0;0;0;0;0;0;0;0
7483;Terra Estrangeira;114651;0;2;1;1;50;0;0;0;0;0;0;0;0
7484;Gimme Shelter;65780;9.1;20;20;0;100;0;2;2;0;100;4;1625;90
7485;Ohayô;53134;8.1;11;9;2;81;0;1;0;1;0;4;948;87
7486;Chun gwong cha sit;118845;7.1;31;24;7;77;7.1;9;7;2;77;4.1;4907;90
7487;Henry & June;99762;6;14;9;5;64;0;1;1;0;100;3.5;2170;67
7488;Berkeley in the Sixties;99121;8.1;5;5;0;100;0;1;1;0;100;3.8;195;74
7489;Das schreckliche Mädchen;100557;7.6;5;3;2;60;0;1;0;1;0;3.6;464;71
7490;At First Sight;132512;5.2;36;12;24;33;5.4;6;1;5;16;2.9;2600;48
7491;The Naked Prey;60736;6.8;11;9;2;81;0;1;0;1;0;3.8;541;80
7492;A Personal Journey with Martin Scorsese Through American Movies;112120;8.5;10;10;0;100;0;0;0;0;0;0;0;0
7493;The Three Faces of Eve;51077;7.7;12;12;0;100;0;1;1;0;100;3.7;997;77
7521;No Mercy;91637;3.4;13;2;11;15;4.4;5;2;3;40;2.8;740;32
7523;The Desperate Hours;47985;7;5;4;1;80;0;0;0;0;0;0;0;0
7541;100 Girls;214388;5.9;5;3;2;60;0;0;0;0;0;0;0;0
7560;Fail-Safe;58083;7.6;13;12;1;92;0;0;0;0;0;0;0;0
7561;Paperhouse;98061;8.3;5;5;0;100;0;1;1;0;100;0;0;0
7562;Dobermann;118996;0;1;0;1;0;0;0;0;0;0;0;0;0
7563;The Discovery of Heaven;251052;0;0;0;0;0;0;0;0;0;0;0;0;0
7564;Kaidan;58279;7.5;16;13;3;81;0;2;1;1;50;4.1;1525;89
7565;Cat-Women of the Moon;45609;0;0;0;0;0;0;0;0;0;0;0;0;0
7566;28 Up;88650;8.8;12;12;0;100;0;3;3;0;100;4.2;565;93
7567;Last Chance Harvey;1046947;6.2;146;102;44;69;6.1;27;19;8;70;3.2;14302;52
7569;You Only Live Twice;62512;6.1;33;23;10;69;4.8;6;1;5;16;3.4;11073;70
7570;Octopussy;86034;5.3;32;15;17;46;4.7;5;2;3;40;3.1;10228;55
7571;The Blue Gardenia;45564;6.6;5;5;0;100;0;0;0;0;0;0;0;0
7572;Wit;243664;6.5;10;8;2;80;0;0;0;0;0;0;0;0
7573;Never Say Never Again;86006;5.9;34;22;12;64;6.2;5;3;2;60;3.1;7414;48
7574;Maboroshi no hikari;113725;8.1;16;16;0;100;0;4;4;0;100;4;530;83
7577;Trollflöjten;73822;7.8;14;13;1;92;0;3;3;0;100;3.8;1181;77
7578;Midnight Movie;981224;0;1;1;0;100;0;0;0;0;0;0;0;0
7579;Pride & Prejudice;414387;7.7;164;140;24;85;7.6;37;32;5;86;3.8;101164;88
7580;The Man in the Gray Flannel Suit;49474;5.9;6;5;1;83;0;0;0;0;0;0;0;0
7581;The Fountainhead;41386;6.4;11;9;2;81;0;0;0;0;0;0;0;0
7582;Old Acquaintance;36230;0;1;0;1;0;0;0;0;0;0;0;0;0
7583;In This Our Life;34890;0;3;2;1;66;0;0;0;0;0;0;0;0
7584;The Women;430770;3.9;142;18;124;12;3.8;34;4;30;11;3;20081;41
7585;Summertime;48673;7.4;14;13;1;92;0;3;3;0;100;3.7;859;78
7586;Soldaat van Oranje;76734;7.9;8;8;0;100;0;0;0;0;0;0;0;0
7587;Le samouraï;62229;8.3;25;25;0;100;8.4;7;7;0;100;0;0;0
7613;White Palace;103251;5.6;14;8;6;57;0;2;2;0;100;3.2;887;63
7614;Oklahoma!;48445;7.2;22;20;2;90;0;4;3;1;75;3.4;4365;72
7615;Desert Hearts;89015;6.8;5;4;1;80;0;1;0;1;0;3.7;699;72
7616;Body Double;86984;6.6;25;21;4;84;0;1;1;0;100;3.2;1914;61
7617;Rooster Cogburn;73636;4.7;7;3;4;42;0;1;0;1;0;0;0;0
7618;Chaplin;103939;5.8;44;27;17;61;3.3;9;0;9;0;3.6;6022;81
7619;The Miracle Worker;56241;7.8;17;17;0;100;0;3;3;0;100;3.7;1889;83
7620;Monster in a Box;102467;6.6;14;13;1;92;0;2;2;0;100;4.2;127;98
7621;Vengo;211718;5.7;37;23;14;62;5.2;13;6;7;46;4;644;84
7622;O Primeiro Dia;166707;0;1;1;0;100;0;0;0;0;0;0;0;0
7623;If You Only Knew;180303;0;1;1;0;100;0;0;0;0;0;0;0;0
7624;School Ties;105327;5.8;35;23;12;65;4.9;7;3;4;42;3.3;5052;69
7625;Calendar Girls;337909;6.5;118;87;31;73;6.5;33;23;10;69;3.1;8453;59
7626;Switch;103016;4.7;16;5;11;31;0;2;0;2;0;2.8;1035;47
7627;Just Write;119434;5;6;3;3;50;0;0;0;0;0;0;0;0
7636;Raising Cain;105217;4.4;19;10;9;52;0;1;1;0;100;2.9;1825;40
7637;Irma Vep;116650;7.4;35;32;3;91;7.5;11;10;1;90;3.5;738;67
7638;Buck Privates;33436;0;0;0;0;0;0;0;0;0;0;0;0;0
7639;Nice Guys Sleep Alone;160574;0;2;2;0;100;0;0;0;0;0;0;0;0
7644;Divorce Iranian Style;166169;0;0;0;0;0;0;0;0;0;0;0;0;0
7645;Iron & Silk;99857;6.3;5;4;1;80;0;0;0;0;0;0;0;0
7646;Rose Red;259153;0;0;0;0;0;0;0;0;0;0;0;0;0
7647;Noises Off...;105017;5.7;21;12;9;57;0;0;0;0;0;0;0;0
7648;Wildflower;103266;0;1;0;1;0;0;0;0;0;0;0;0;0
7649;Babylon 5: In the Beginning;120711;\N;\N;\N;\N;\N;\N;\N;\N;\N;\N;\N;\N;\N
7650;Witchfinder General;63285;6.9;12;10;2;83;0;1;1;0;100;3.5;1271;68
7675;The Canterville Ghost;115820;0;0;0;0;0;0;0;0;0;0;0;0;0
7697;The Prince and the Showgirl;50861;6;5;4;1;80;0;0;0;0;0;0;0;0
7698;The China Syndrome;78966;7.4;27;23;4;85;0;4;3;1;75;3.6;2169;76
7699;¿Quién diablos es Juliette?;126627;6.4;6;4;2;66;0;1;1;0;100;3.4;65;58
7700;Le salaire de la peur;46268;8.8;36;36;0;100;8.8;6;6;0;100;4.4;2478;94
7701;Look Who's Talking Too;100050;2.8;12;2;10;16;0;1;1;0;100;2.6;9775;43
7702;The Bells of St. Mary's;37536;7.2;15;14;1;93;0;3;3;0;100;3.7;1566;76
7703;You Light Up My Life;76941;3.2;5;1;4;20;0;0;0;0;0;0;0;0
7704;Delta Force 2: The Colombian Connection;99399;2.2;7;0;7;0;0;1;0;1;0;2.9;1781;45
7705;Pat and Mike;45012;7.4;20;18;2;90;7.2;6;6;0;100;3.5;815;67
7706;Animal Crackers;20640;8;20;19;1;95;0;0;0;0;0;0;0;0
7707;He Said, She Said;102011;4.9;14;5;9;35;0;2;0;2;0;2.7;1214;33
7708;Bedazzled;230030;5.4;109;53;56;48;5.2;32;14;18;43;2.7;15017;45
7713;Cat People;83722;6.1;36;23;13;63;0;3;2;1;66;3;2400;46
7714;Quest for Camelot;120800;5.3;21;7;14;33;5.9;6;2;4;33;3.1;4042;62
7716;The Lonely Guy;87635;5.2;21;10;11;47;0;4;0;4;0;3.1;985;48
7720;The Four Musketeers;73012;6.9;18;14;4;77;0;1;0;1;0;3.4;1319;68
7723;Good Guys Wear Black;79227;0;4;1;3;25;0;0;0;0;0;0;0;0
7724;Steel Dawn;94033;0;2;1;1;50;0;0;0;0;0;0;0;0
7725;On Deadly Ground;110725;2.3;23;0;23;0;2.4;5;0;5;0;2.5;3925;45
7726;Boy Meets Girl;86994;0;1;1;0;100;0;0;0;0;0;0;0;0
7727;The Fourth Protocol;93044;5.7;14;9;5;64;0;2;2;0;100;3.4;544;58
7728;The Postman Always Rings Twice;82934;6.3;10;7;3;70;0;1;0;1;0;3.3;2610;61
7730;Matinee;107529;7.5;25;23;2;92;0;3;3;0;100;2.9;970;53
7738;Forever Fever;155713;5.7;15;7;8;46;0;4;2;2;50;3.5;291;72
7739;Virtual Sexuality;164221;0;4;1;3;25;0;0;0;0;0;0;0;0
7742;The Baxter;401244;5.1;73;24;49;32;4.8;24;6;18;25;3.7;1793;76
7743;Explorers;89114;0;0;0;0;0;0;0;0;0;0;0;0;0
7745;Mùi du du xanh - L'odeur de la papaye verte;107617;8.1;14;14;0;100;0;2;2;0;100;4;1483;82
7748;Pierrot le fou;59592;7.8;34;28;6;82;0;4;2;2;50;4.2;3601;88
7749;Weekend at Bernie's;98627;4.9;21;10;11;47;0;1;0;1;0;3;6596;57
7751;Strange Cargo;33105;7;8;5;3;62;0;0;0;0;0;0;0;0
7752;Seven Girlfriends;177215;5.7;6;3;3;50;0;0;0;0;0;0;0;0
7753;Tuesdays with Morrie;207805;5.3;6;4;2;66;0;0;0;0;0;0;0;0
7756;Aleksandr Nevskiy;29850;8.7;16;15;1;93;0;3;2;1;66;4;1217;82
7757;Jason and the Argonauts;57197;7.7;23;22;1;95;0;0;0;0;0;0;0;0
7758;On connaît la chanson;119828;6.4;14;9;5;64;0;2;1;1;50;3.8;499;77
7759;Nostalgia Boy;823687;\N;\N;\N;\N;\N;\N;\N;\N;\N;\N;\N;\N;\N
7761;La peau douce;58458;7.4;11;10;1;90;0;2;1;1;50;3.9;573;85
7762;Tinker, Tailor, Soldier, Spy;80297;\N;\N;\N;\N;\N;\N;\N;\N;\N;\N;\N;\N;\N
7763;Winterschläfer;120522;0;0;0;0;0;0;0;0;0;0;0;0;0
7764;The Driller Killer;79082;6;10;7;3;70;0;0;0;0;0;0;0;0
7766;Kumonosu-jô;50613;8.7;33;32;1;96;0;3;3;0;100;4.3;5573;93
7767;La meglio gioventù;346336;8.4;62;59;3;95;8.1;26;24;2;92;4.6;2911;97
7768;Guncrazy;104377;5.8;8;5;3;62;0;1;0;1;0;2.9;869;38
7769;Bangrajan;284880;6.2;31;22;9;70;5.8;13;8;5;61;3.4;846;66
7770;Treasure Island;100813;0;0;0;0;0;0;0;0;0;0;0;0;0
7771;Alexis Zorbas;57831;7.2;5;4;1;80;0;0;0;0;0;0;0;0
7772;Undercurrent;39066;0;3;2;1;66;0;0;0;0;0;0;0;0
7773;Bang Bang You're Dead;288439;0;2;1;1;50;0;0;0;0;0;0;0;0
7774;My Side of the Mountain;64708;0;3;2;1;66;0;1;1;0;100;3.2;556;47
7775;The Thin Blue Line;96257;8.7;11;11;0;100;0;1;1;0;100;4;1805;89
7781;Twister;117998;6;49;28;21;57;6.7;10;7;3;70;3.2;45771;62
7782;Sniper;108171;4.7;12;5;7;41;0;2;1;1;50;3;3468;58
7783;No se lo digas a nadie;166287;0;1;1;0;100;0;0;0;0;0;0;0;0
7784;Ghost in the Machine;107009;3;8;1;7;12;0;1;0;1;0;2.6;1353;32
7785;Zamani barayé masti asbha;259072;7.3;30;25;5;83;8.1;7;7;0;100;4.3;467;91
7786;Genghis Blues;187859;7.1;11;8;3;72;0;3;3;0;100;4;354;88
7787;Rambo;462499;4.8;138;50;88;36;4;26;6;20;23;3.4;107524;70
7789;11'09''01 - September 11;328802;6.6;58;45;13;77;6.6;21;16;5;76;3.5;303;62
7790;Bon Voyage, Charlie Brown (and Don't Come Back!!);80461;0;0;0;0;0;0;0;0;0;0;0;0;0
7791;Internal Affairs;99850;6.7;25;22;3;88;6.9;7;6;1;85;3.2;1646;56
7792;The Parallax View;71970;7.7;26;24;2;92;0;4;2;2;50;3.7;1119;77
7802;The Warriors;80120;7.4;30;28;2;93;0;0;0;0;0;0;0;0
7808;Mayerling;64645;0;3;1;2;33;0;1;0;1;0;3;76;38
7809;Rukajärven tie;162625;\N;\N;\N;\N;\N;\N;\N;\N;\N;\N;\N;\N;\N
7810;Babylon 5: A Call to Arms;146455;0;0;0;0;0;0;0;0;0;0;0;0;0
7811;Babylon 5: The River of Souls;146247;0;0;0;0;0;0;0;0;0;0;0;0;0
7812;Babylon 5: Thirdspace;121804;0;0;0;0;0;0;0;0;0;0;0;0;0
7813;FM;77532;0;4;2;2;50;0;0;0;0;0;0;0;0
7814;Waterloo;66549;0;2;2;0;100;0;0;0;0;0;0;0;0
7815;Dreamer: Inspired by a True Story;418647;6.3;115;73;42;63;6.1;29;17;12;58;3.6;21404;74
7816;North Beach;226225;0;2;1;1;50;0;0;0;0;0;0;0;0
7817;Zardoz;70948;5.2;18;8;10;44;0;1;0;1;0;3.1;2696;51
7818;School for Scoundrels;462519;4.6;137;35;102;25;4.5;32;8;24;25;3.2;39981;57
7820;Jungfrukällan;53976;8.1;16;15;1;93;0;2;1;1;50;4.2;2857;92
7821;Ice-Cold in Alex;53935;0;0;0;0;0;0;0;0;0;0;0;0;0
7822;Mogambo;46085;6.2;9;7;2;77;0;0;0;0;0;0;0;0
7824;Segunda piel;232611;0;0;0;0;0;0;0;0;0;0;0;0;0
7826;The Secret Life of Walter Mitty;39808;7;5;4;1;80;0;0;0;0;0;0;0;0
7827;Cypher;284978;6.3;17;10;7;58;0;0;0;0;0;0;0;0
7828;The Rack;49652;0;0;0;0;0;0;0;0;0;0;0;0;0
7831;Another Thin Man;31047;7.1;12;12;0;100;0;0;0;0;0;0;0;0
7832;The Thin Man Goes Home;37365;6.4;5;3;2;60;0;0;0;0;0;0;0;0
7833;Shadow of the Thin Man;34172;6.8;6;5;1;83;0;0;0;0;0;0;0;0
7834;After the Thin Man;27260;7.5;12;12;0;100;0;0;0;0;0;0;0;0
7835;Song of the Thin Man;39853;6;10;8;2;80;0;0;0;0;0;0;0;0
7836;Woodstock;66580;8.6;19;19;0;100;0;2;2;0;100;4.1;2814;90
7837;36 fillette;94596;7.1;7;6;1;85;0;1;1;0;100;3;414;48
7838;The Internecine Project;71663;0;0;0;0;0;0;0;0;0;0;0;0;0
7839;Crazy Love;790706;7;84;65;19;77;7;32;26;6;81;3.6;2624;70
7840;Gunga Din;31398;8;24;22;2;91;0;1;1;0;100;3.7;1406;74
7841;Children of Dune;287839;\N;\N;\N;\N;\N;\N;\N;\N;\N;\N;\N;\N;\N
7842;Dune;87182;6.1;26;16;10;61;0;2;0;2;0;3.4;17715;67
7843;Lammbock;258760;0;0;0;0;0;0;0;0;0;0;0;0;0
7844;Fong Sai Yuk;106936;7.2;9;8;1;88;0;0;0;0;0;0;0;0
7845;Tremors II: Aftershocks;114720;5.3;8;5;3;62;0;0;0;0;0;0;0;0
7846;Tremors 3: Back to Perfection;259685;5.5;6;4;2;66;0;0;0;0;0;0;0;0
7847;The Peanut Butter Solution;89789;0;0;0;0;0;0;0;0;0;0;0;0;0
7872;Getting It Right;97424;6;6;4;2;66;0;1;1;0;100;3.9;146;73
7878;Straight to Hell;94048;4.2;7;2;5;28;0;1;0;1;0;3.3;813;54
7879;Notorious C.H.O.;300274;\N;\N;\N;\N;\N;\N;\N;\N;\N;\N;\N;\N;\N
7880;Vendredi soir;295743;6.9;53;42;11;79;6.2;16;12;4;75;3.4;267;55
7881;White Zombie;23694;6.9;13;10;3;76;0;0;0;0;0;0;0;0
7882;The Plague of the Zombies;60841;5.2;6;4;2;66;0;0;0;0;0;0;0;0
7883;I Walked with a Zombie;36027;7.7;22;20;2;90;0;3;1;2;33;3.7;1271;73
7884;Highway 61;102035;6.8;5;5;0;100;0;1;1;0;100;0;0;0
7885;The Vampire Lovers;66518;4.9;7;3;4;42;0;2;1;1;50;3.4;584;62
7886;Countess Dracula;65580;0;2;0;2;0;0;0;0;0;0;0;0;0
7887;But I'm a Cheerleader;179116;4.7;46;15;31;32;4.1;12;3;9;25;3.4;7081;74
7888;How to Succeed in Business Without Really Trying;61791;7;9;8;1;88;0;0;0;0;0;0;0;0
7889;Pat Garrett & Billy the Kid;70518;7.2;17;14;3;82;0;3;1;2;33;3.8;2126;82
7890;The Left Handed Gun;51849;7.8;7;7;0;100;0;2;2;0;100;3.4;241;52
7891;The Last Man on Earth;58700;6.3;15;11;4;73;0;1;0;1;0;3.6;4886;69
7892;Gekitotsu! Satsujin ken;73756;0;4;3;1;75;0;0;0;0;0;0;0;0
7893;Satsujin ken 2;73623;0;3;0;3;0;0;0;0;0;0;0;0;0
7894;Giù la testa;67140;7.5;19;17;2;89;7.5;5;4;1;80;3.8;4524;77
7895;Bring Me the Head of Alfredo Garcia;71249;7.3;18;15;3;83;0;2;1;1;50;3.9;2407;84
7896;Ride the High Country;56412;8.2;14;13;1;92;0;1;1;0;100;0;0;0
7897;The Ballad of Cable Hogue;65446;7;13;12;1;92;0;3;3;0;100;3.6;929;75
7898;Junior Bonner;68786;7.4;17;15;2;88;0;3;2;1;66;3.4;748;60
7899;Du bi quan wang da po xue di zi;72913;6.9;20;18;2;90;0;4;4;0;100;3.9;1371;83
7900;Frankenstein Must Be Destroyed;65738;0;2;0;2;0;0;0;0;0;0;0;0;0
7901;The Haunted Palace;57128;0;4;3;1;75;0;0;0;0;0;0;0;0
7912;Finder's Fee;192023;6.8;5;3;2;60;0;0;0;0;0;0;0;0
7913;La frusta e il corpo;57078;6.8;7;5;2;71;0;0;0;0;0;0;0;0
7914;Berlin: Die Sinfonie der Grosstadt;17668;6.4;6;5;1;83;0;1;1;0;100;3.9;403;81
7915;SF: Episode One;170544;0;1;1;0;100;0;0;0;0;0;0;0;0
7916;Gidget;52847;5.6;8;4;4;50;0;0;0;0;0;0;0;0
7917;Wild in the Streets;63808;6;8;5;3;62;0;1;0;1;0;3.6;252;69
7918;The Indian Runner;102116;5.9;13;9;4;69;0;2;2;0;100;3.7;1580;78
7919;Yoidore tenshi;40979;7.5;13;13;0;100;0;3;3;0;100;4;1199;87
7920;Desperate Living;75936;6;10;7;3;70;0;0;0;0;0;0;0;0
7921;The Devil's Rain;72869;3.9;10;2;8;20;0;1;0;1;0;0;0;0
7922;The Valachi Papers;68341;0;0;0;0;0;0;0;0;0;0;0;0;0
7923;Rolling Thunder;76637;6.9;5;5;0;100;0;0;0;0;0;0;0;0
7924;Nora inu;41699;7.4;15;14;1;93;0;0;0;0;0;0;0;0
7925;Kakushi-toride no san-akunin;51808;8.6;22;22;0;100;0;2;2;0;100;4.1;6021;90
7926;Tengoku to jigoku;57565;7.8;14;13;1;92;0;2;2;0;100;4.3;2474;94
7928;Efter repetitionen;87193;7.7;10;9;1;90;0;3;3;0;100;3.7;244;69
7930;The People Under the Stairs;105121;5.5;13;8;5;61;0;1;0;1;0;3.1;6410;60
7931;My New Gun;104954;5.7;6;3;3;50;0;1;0;1;0;3.4;190;40
7932;Dark Days;235327;7.8;29;27;2;93;7.4;5;4;1;80;4;1419;89
7933;A Night in Casablanca;38777;5;7;4;3;57;0;0;0;0;0;0;0;0
7934;Zelig;86637;7.7;17;17;0;100;0;0;0;0;0;0;0;0
7935;Ansikte mot ansikte;74147;6.8;7;5;2;71;0;4;2;2;50;4;333;86
7936;Skammen;63611;6.8;14;10;4;71;0;3;2;1;66;4;1110;88
7937;Tystnaden;57611;8;12;11;1;91;0;3;2;1;66;4.1;1976;89
7938;Nattvardsgästerna;57358;7.7;15;12;3;80;0;3;2;1;66;4.3;1967;92
7939;Såsom i en spegel;55499;8.6;14;14;0;100;0;2;2;0;100;4.2;2486;91
7940;Ansiktet;51365;8.2;6;6;0;100;0;2;2;0;100;3.9;677;84
7941;Sommarnattens leende;48641;8.5;10;10;0;100;0;1;1;0;100;4;1688;88
7942;Sommaren med Monika;46345;\N;\N;\N;\N;\N;\N;\N;\N;\N;\N;\N;\N;\N
7943;Natural Born Killers;110632;6;29;15;14;51;5.9;7;3;4;42;3.5;39062;80
7944;The Night of the Iguana;58404;7.2;14;10;4;71;0;3;1;2;33;3.9;1177;84
7945;Freud;55998;0;1;1;0;100;0;0;0;0;0;0;0;0
7946;Reflections in a Golden Eye;62185;6.6;6;5;1;83;0;0;0;0;0;0;0;0
7947;Under the Volcano;88322;6.5;16;12;4;75;0;4;3;1;75;3.6;510;71
7948;Wise Blood;80140;7.4;9;8;1;88;0;0;0;0;0;0;0;0
7949;The Yakuza;73918;5.8;10;5;5;50;0;3;0;3;0;3.8;480;79
7951;Nightbreed;100260;4.9;11;4;7;36;0;1;0;1;0;3.3;3698;62
7952;Bottle Shock;914797;5.6;116;56;60;48;6.1;29;16;13;55;3.3;4827;60
7953;Cani arrabbiati;71275;6;7;5;2;71;0;0;0;0;0;0;0;0
7954;Gli orrori del castello di Norimberga;69048;4.1;6;0;6;0;0;2;0;2;0;3.1;382;42
7958;Bloody Mama;65481;4.5;6;2;4;33;0;0;0;0;0;0;0;0
7959;Road Trip;215129;5.9;89;52;37;58;5.9;21;14;7;66;3.3;57286;68
7976;Ken Park;209077;4.9;14;6;8;42;0;1;0;1;0;3.3;3212;58
7979;Monterey Pop;64689;7.9;16;16;0;100;0;2;2;0;100;4.1;573;88
7980;A Bridge Too Far;75784;6.6;12;8;4;66;0;0;0;0;0;0;0;0
7981;Mou gaan dou;338564;7.6;60;57;3;95;8;22;22;0;100;4.2;19748;94
7982;Janghwa, Hongryeon;365376;7.1;53;46;7;86;6.7;16;13;3;81;3.9;7458;83
7983;Broadway Danny Rose;87003;8.1;25;25;0;100;0;4;4;0;100;3.7;2721;78
7984;They Came from Beyond Space;62360;0;1;0;1;0;0;0;0;0;0;0;0;0
7985;The Wonderful Ice Cream Suit;129634;0;4;3;1;75;0;0;0;0;0;0;0;0
7986;Robot Jox;102800;0;1;0;1;0;0;0;0;0;0;0;0;0
7987;Dolls;330229;6.7;36;27;9;75;6.9;13;12;1;92;4.2;3709;87
7988;Space Truckers;120199;3.4;11;1;10;9;0;0;0;0;0;0;0;0
7989;Not of This Earth;50778;0;0;0;0;0;0;0;0;0;0;0;0;0
7990;Rock 'n' Roll High School;79813;6.7;23;18;5;78;0;2;1;1;50;3.5;3278;71
7991;Death Race;452608;4.8;145;60;85;41;5.2;23;10;13;43;3.5;50505;69
7992;Cockfighter;71338;0;0;0;0;0;0;0;0;0;0;0;0;0
7993;A Bucket of Blood;52655;6.6;10;7;3;70;0;0;0;0;0;0;0;0
7994;Premature Burial;56368;4.6;5;2;3;40;0;0;0;0;0;0;0;0
7995;The Wild Angels;61189;5.5;9;5;4;55;0;0;0;0;0;0;0;0
8003;Bedlam;38343;6.5;15;13;2;86;0;2;2;0;100;3.3;649;56
8004;Terrore nello spazio;59792;5.9;7;4;3;57;0;0;0;0;0;0;0;0
8007;Pure Country;105191;0;4;0;4;0;0;1;0;1;0;3.9;3532;89
8008;Brigadoon;46807;6;10;8;2;80;0;0;0;0;0;0;0;0
8009;Marjorie Morningstar;51911;0;0;0;0;0;0;0;0;0;0;0;0;0
8010;The Power of One;105159;5.6;11;6;5;54;0;2;0;2;0;4;2912;88
8011;The Weather Underground;343168;7.8;57;52;5;91;7.5;19;16;3;84;3.9;920;85
8012;Kikujirô no natsu;199683;0;0;0;0;0;0;0;0;0;0;0;0;0
8013;I'm with Lucy;282593;0;2;0;2;0;0;0;0;0;0;0;0;0
8014;Bom yeoreum gaeul gyeoul geurigo bom;374546;8.1;94;89;5;94;8.1;26;24;2;92;4.2;7663;92
8015;The Phantom Tollbooth;64806;0;3;3;0;100;0;0;0;0;0;0;0;0
8016;A Perfect Getaway;971209;5.8;124;76;48;61;5.9;29;18;11;62;3.2;102622;50
8017;10 Rillington Place;66730;6.5;8;5;3;62;0;1;1;0;100;3.9;564;87
8019;Honogurai mizu no soko kara;308379;6.8;13;10;3;76;0;0;0;0;0;0;0;0
8024;The Thing Called Love;108327;5.3;20;11;9;55;0;4;2;2;50;3.5;2915;71
8025;Vor;124207;7;24;21;3;87;7.6;9;9;0;100;4;254;89
8033;How to Steal a Million;60522;7;6;6;0;100;0;0;0;0;0;0;0;0
8035;La sindrome di Stendhal;117658;6.2;11;8;3;72;0;0;0;0;0;0;0;0
8037;Dangan ranna;116015;0;0;0;0;0;0;0;0;0;0;0;0;0
8039;Support Your Local Sheriff!;65051;6;11;7;4;63;0;1;0;1;0;3.6;1267;77
8040;Brain Donors;103872;4.8;9;4;5;44;0;0;0;0;0;0;0;0
8041;Passed Away;105103;4.5;8;1;7;12;0;2;0;2;0;0;0;0
8042;Mean Streets;70379;8.9;46;45;1;97;9.2;6;6;0;100;3.8;15074;83
8043;Jack the Bear;107247;4.9;17;5;12;29;0;2;1;1;50;3.2;989;56
8044;I Am a Fugitive from a Chain Gang;23042;8.4;16;16;0;100;0;0;0;0;0;0;0;0
8045;Hamburger Hill;93137;7.3;11;11;0;100;0;3;3;0;100;3.4;6794;68
8056;Harper;60490;7.1;16;16;0;100;0;3;3;0;100;3.6;474;69
8057;Sweet Bird of Youth;56541;6.7;16;12;4;75;0;3;1;2;33;3.7;457;71
8062;Dahmer;285728;6.4;38;26;12;68;5.9;9;5;4;55;2.8;1473;41
8063;Paradise;84469;0;3;0;3;0;0;0;0;0;0;0;0;0
8069;Comes a Horseman;77360;6.7;7;6;1;85;0;0;0;0;0;0;0;0
8070;Halbe Treppe;304126;0;0;0;0;0;0;0;0;0;0;0;0;0
8092;Frankenstein Unbound;99612;5;15;6;9;40;0;1;1;0;100;2.9;443;37
8093;Swiri;192657;5.5;36;21;15;58;6.1;12;8;4;66;3.6;1502;70
8094;Bad Day at Black Rock;47849;8.2;25;24;1;96;0;3;2;1;66;3.9;1420;86
8117;I Kina spiser de hunde;180748;0;0;0;0;0;0;0;0;0;0;0;0;0
8118;Delta Force 2: The Colombian Connection;99399;2.2;7;0;7;0;0;1;0;1;0;2.9;1781;45
8119;Crossroads;275022;3.9;101;14;87;13;3.9;24;3;21;12;2.2;15071;41
8120;29th Street;101252;6.4;9;7;2;77;0;2;2;0;100;3.3;877;67
8121;La grande séduction;366532;6.3;65;44;21;67;5.9;19;12;7;63;3.9;1308;87
8122;Beyond the City Limits;201479;0;0;0;0;0;0;0;0;0;0;0;0;0
8123;Sammy and Rosie Get Laid;93913;6.9;8;7;1;87;0;1;1;0;100;3.8;157;74
8124;Leaving Normal;104697;4.6;7;2;5;28;0;2;0;2;0;0;0;0
8125;Sunrise: A Song of Two Humans;18455;8.8;38;37;1;97;7.7;8;7;1;87;4.4;2918;93
8126;Shock Corridor;57495;7.6;11;10;1;90;0;0;0;0;0;0;0;0
8127;The First $20 Million Is Always the Hardest;280674;2.4;9;1;8;11;0;2;0;2;0;3.2;483;50
8128;Au revoir les enfants;92593;9.2;23;22;1;95;10;5;4;1;80;4.2;3681;92
8129;Sex: The Annabel Chong Story;181810;5.1;17;7;10;41;0;4;2;2;50;3.1;1360;51
8130;The Girl Next Door;265208;5.6;156;87;69;55;5;32;17;15;53;3.3;39311;71
8131;The Pursuit of Happyness;454921;6.4;166;110;56;66;6.1;38;25;13;65;4.1;211913;88
8132;Gladiator;172495;7;159;123;36;77;6.4;36;26;10;72;3.8;248672;85
8133;Arven;328844;6.7;36;27;9;75;6.1;15;9;6;60;3.8;493;79
8134;Wonderful Days;353014;5.6;42;23;19;54;5.4;16;8;8;50;3.6;1432;73
8136;Indestructible Man;49363;0;0;0;0;0;0;0;0;0;0;0;0;0
8137;The Wasp Woman;54462;4.3;10;4;6;40;0;0;0;0;0;0;0;0
8138;Attack of the Giant Leeches;53611;0;0;0;0;0;0;0;0;0;0;0;0;0
8139;Deranged;71408;0;4;1;3;25;0;0;0;0;0;0;0;0
8140;The Cruel Sea;45659;0;2;2;0;100;0;0;0;0;0;0;0;0
8142;Dead or Alive: Hanzaisha;221111;0;0;0;0;0;0;0;0;0;0;0;0;0
8143;Lola Montès;48308;7.8;27;23;4;85;7.3;10;8;2;80;3.8;488;78
8147;Charlie and the Chocolate Factory;367594;0;0;0;0;0;0;0;0;0;0;0;0;0
8148;Twice Upon a Time;86489;0;1;1;0;100;0;0;0;0;0;0;0;0
8149;Atlantis, the Lost Continent;54642;0;4;0;4;0;0;0;0;0;0;0;0;0
8153;Lust for Life;49456;7.8;9;9;0;100;0;0;0;0;0;0;0;0
8154;La dolce vita;53779;9.1;53;52;1;98;8.5;15;14;1;93;0;0;0
8157;Jin-Rô;193253;5.8;22;12;10;54;5.4;7;4;3;57;3.7;3049;77
8158;August Rush;426931;4.8;120;44;76;36;4.4;27;7;20;25;4;105941;84
8167;Captain Blood;26174;\N;\N;\N;\N;\N;\N;\N;\N;\N;\N;\N;\N;\N
8168;De lift;87622;0;0;0;0;0;0;0;0;0;0;0;0;0
8169;*batteries not included;92494;5.6;13;8;5;61;0;2;2;0;100;3.2;9550;61
8183;Educating Rita;85478;7.2;13;11;2;84;0;1;0;1;0;3.6;1843;77
8187;On Moonlight Bay;43880;6.2;5;5;0;100;0;0;0;0;0;0;0;0
8188;Sanshô dayû;47445;9.1;10;10;0;100;0;0;0;0;0;0;0;0
8189;Zazie dans le métro;54494;0;0;0;0;0;0;0;0;0;0;0;0;0
8190;The Americanization of Emily;57840;7.4;11;11;0;100;0;0;0;0;0;0;0;0
8191;Anne of the Thousand Days;64030;0;4;3;1;75;0;0;0;0;0;0;0;0
8194;Baby Doll;48973;8;14;14;0;100;0;3;3;0;100;3.9;746;81
8195;L'avventura;53619;8.6;26;25;1;96;0;3;3;0;100;4.2;3223;90
8196;Beyond the Valley of the Dolls;65466;6.1;22;15;7;68;0;3;1;2;33;0;0;0
8197;Hiroshima mon amour;52893;8.4;18;17;1;94;0;2;2;0;100;4.2;3402;89
8198;Die 1000 Augen des Dr. Mabuse;54371;6.8;7;6;1;85;0;0;0;0;0;0;0;0
8199;Ugetsu monogatari;46478;8.9;19;19;0;100;8.4;5;5;0;100;4.3;1896;93
8201;At Play in the Fields of the Lord;101373;5.7;6;3;3;50;0;1;1;0;100;0;0;0
8202;Le carrosse d'or;44487;8.3;11;11;0;100;0;2;2;0;100;3.9;335;83
8203;La guerre est finie;60481;8.2;7;7;0;100;0;3;3;0;100;3.8;194;72
8206;Mystery of the Wax Museum;24368;7.4;8;8;0;100;0;0;0;0;0;0;0;0
8207;The Day of the Jackal;69947;7.6;20;18;2;90;0;4;3;1;75;3.9;2316;86
8208;The Razor's Edge;87980;5.4;15;8;7;53;0;1;0;1;0;3.7;879;77
8220;Incubo sulla città contaminata;80931;0;4;2;2;50;0;0;0;0;0;0;0;0
8221;War of the Buttons;111666;0;2;2;0;100;0;0;0;0;0;0;0;0
8222;The Other;69050;6.8;7;6;1;85;0;1;1;0;100;3.7;411;72
8225;Night of the Living Dead;63350;8.5;45;43;2;95;7;5;4;1;80;3.7;26113;85
8227;Drums Along the Mohawk;31252;6.7;9;7;2;77;0;0;0;0;0;0;0;0
8228;The Maltese Falcon;33870;9;40;40;0;100;8.2;6;6;0;100;4;14452;90
8232;I Love You Again;32617;0;4;4;0;100;0;0;0;0;0;0;0;0
8235;Safety Last!;14429;8.5;12;11;1;91;0;0;0;0;0;0;0;0
8236;While the City Sleeps;49949;8.9;7;7;0;100;0;0;0;0;0;0;0;0
8238;Little Murders;67350;6.4;7;4;3;57;0;1;1;0;100;3.7;356;77
8239;Viridiana;55601;8.9;19;19;0;100;0;2;2;0;100;4.2;2048;90
8240;Totally F***ed Up;108366;7.6;6;6;0;100;0;0;0;0;0;0;0;0
8241;Megamind;1001526;0;0;0;0;0;0;0;0;0;0;0;0;0
8252;You're a Big Boy Now;61209;6.4;9;7;2;77;0;3;3;0;100;3.3;183;46
8253;Rupan sansei: Kariosutoro no shiro;79833;7;10;9;1;90;0;1;1;0;100;4;4187;86
8254;Arizona Dream;106307;6.9;14;12;2;85;6.5;5;4;1;80;4;9613;83
8255;Kaosu;295362;6.5;16;11;5;68;5.8;5;3;2;60;3.3;372;56
8256;Queen Christina;24481;8.3;12;12;0;100;0;0;0;0;0;0;0;0
8257;Battleground;41163;8.4;5;5;0;100;0;0;0;0;0;0;0;0
8258;Citizen Toxie: The Toxic Avenger IV;212879;5.9;9;6;3;66;0;2;1;1;50;3.3;1527;63
8259;The Texas Chain Saw Massacre;72271;7.7;40;36;4;90;0;3;2;1;66;3.4;22149;78
8260;Gadjo dilo;122082;7;21;17;4;80;7.5;6;6;0;100;4.1;1215;88
8261;3 Women;75612;7.9;20;19;1;95;7.1;5;4;1;80;3.9;1570;85
8262;The Green Pastures;27700;6.6;7;6;1;85;0;0;0;0;0;0;0;0
8263;Take Me Out to the Ball Game;41944;7.5;6;6;0;100;0;0;0;0;0;0;0;0
8264;Grey Gardens;73076;8.4;16;16;0;100;0;4;4;0;100;4.1;2464;87
8265;The Frog Prince;95182;0;0;0;0;0;0;0;0;0;0;0;0;0
8266;Purple Rain;87957;6.3;29;22;7;75;0;2;1;1;50;3.3;7627;78
8267;Lebenszeichen;63218;7.1;8;7;1;87;0;1;0;1;0;3.6;399;67
8268;Point of No Return;107843;5.4;21;10;11;47;0;3;2;1;66;2.9;3771;51
8269;Short Time;100604;4.6;5;1;4;20;0;1;0;1;0;3.6;119;65
8270;Le mari de la coiffeuse;100112;8.1;10;10;0;100;0;0;0;0;0;0;0;0
8272;Cromwell;65593;0;4;1;3;25;0;1;0;1;0;3.4;463;60
8273;Jamón, jamón;104545;7;10;8;2;80;0;2;1;1;50;3.5;1911;65
8275;College;844671;2.5;40;2;38;5;2.8;12;1;11;8;2.8;10667;35
8290;Mitchell;73396;0;0;0;0;0;0;0;0;0;0;0;0;0
8291;Ten Little Indians;61075;0;1;0;1;0;0;0;0;0;0;0;0;0
8292;Hakuchi;43614;7;7;6;1;85;0;0;0;0;0;0;0;0
8293;Used People;105706;5.2;12;5;7;41;0;2;0;2;0;3.1;89;30
8294;The Trumpet of the Swan;206367;3.4;40;5;35;12;3.2;15;1;14;6;2.9;930;39
8295;The Most Dangerous Game;23238;7.7;13;13;0;100;0;0;0;0;0;0;0;0
8302;The Front Page;71524;5.8;24;16;8;66;0;1;1;0;100;3.6;905;73
8327;Dolls;330229;6.7;36;27;9;75;6.9;13;12;1;92;4.2;3709;87
8330;Our Man in Havana;54152;7.7;5;5;0;100;0;0;0;0;0;0;0;0
8331;The Man Who Came to Dinner;33874;8;5;4;1;80;0;1;1;0;100;3.9;562;81
8332;Bloody Sunday;280491;7.9;102;94;8;92;8.2;30;28;2;93;4;2812;89
8334;Midnight Cowboy;64665;8.3;49;44;5;89;6.8;6;5;1;83;3.9;8994;87
8336;The Major and the Minor;35019;7.5;14;14;0;100;0;3;3;0;100;4;562;85
8337;The Caine Mutiny;46816;7.8;23;21;2;91;0;3;2;1;66;3.8;1792;85
8338;Black Narcissus;39192;8.7;23;23;0;100;0;3;3;0;100;4.1;1865;88
8340;Escape from Alcatraz;79116;7;17;16;1;94;0;1;1;0;100;3.6;14313;78
8341;Oliver Twist;380599;0;0;0;0;0;0;0;0;0;0;0;0;0
8360;Shrek 2;298148;7.6;210;186;24;88;7.3;40;35;5;87;3.5;228151;69
8361;The Day After Tomorrow;319262;5.3;208;95;113;45;5.2;42;18;24;42;3.2;174938;57
8362;Raising Helen;350028;4.6;126;28;98;22;4.7;35;6;29;17;3.2;23535;65
8363;Soul Plane;367085;3.6;97;18;79;18;3.9;27;4;23;14;2.8;10665;61
8364;How to Get the Man's Foot Outta Your Ass;367790;7.4;106;96;10;90;7.5;32;29;3;90;3.6;960;81
8365;The Mother;323298;7;88;68;20;77;7.4;32;29;3;90;3.4;862;61
8366;Saved!;332375;6.1;140;85;55;60;5.8;37;20;17;54;3.4;19848;75
8367;Le temps du loup;324197;6.2;53;33;20;62;6.5;16;12;4;75;3.5;1297;67
8368;Harry Potter and the Prisoner of Azkaban;304141;0;0;0;0;0;0;0;0;0;0;0;0;0
8369;Mindhunters;297284;4.3;114;29;85;25;3.6;32;2;30;6;3.2;6070;61
8370;Zatôichi;363226;7.2;113;98;15;86;7.4;29;27;2;93;3.9;10635;86
8371;The Chronicles of Riddick;296572;4.6;158;46;112;29;4;33;4;29;12;3.3;35951;73
8372;Garfield;356634;3.5;133;19;114;14;3.5;33;4;29;12;2.9;33314;54
8373;The Stepford Wives;327162;4.7;163;43;120;26;4.9;37;11;26;29;2.6;14476;36
8374;Akarui mirai;363235;6.6;20;14;6;70;5.3;7;3;4;42;3.6;823;70
8375;The Hunting of the President;391225;6.3;57;42;15;73;5.9;23;14;9;60;3.2;449;51
8376;Napoleon Dynamite;374900;6.3;162;114;48;70;5.8;35;23;12;65;3.3;106996;73
8377;City of Joy;103976;5;14;8;6;57;0;2;2;0;100;3.4;1490;70
8378;Doctor Who;116118;0;0;0;0;0;0;0;0;0;0;0;0;0
8379;The Dresser;85461;8.1;13;13;0;100;0;1;1;0;100;3.8;466;80
8380;Father Hood;106877;2.3;8;0;8;0;0;2;0;2;0;2.7;1547;35
8381;For Me and My Gal;34746;7.6;7;7;0;100;0;0;0;0;0;0;0;0
8382;Hello Again;93175;3.6;18;2;16;11;0;4;0;4;0;2.7;630;47
8383;Hope Springs;314431;4.5;12;3;9;25;0;1;1;0;100;2.8;1628;31
8384;Love Finds Andy Hardy;30386;0;0;0;0;0;0;0;0;0;0;0;0;0
8385;Lover Come Back;55100;6.4;8;7;1;87;0;0;0;0;0;0;0;0
8387;Police Academy: Mission to Moscow;110857;0;3;0;3;0;0;0;0;0;0;0;0;0
8388;Ring of Bright Water;64893;7.1;5;5;0;100;0;0;0;0;0;0;0;0
8391;Big Wednesday;77235;5.9;7;4;3;57;0;0;0;0;0;0;0;0
8392;Fool for Love;89160;5.5;11;8;3;72;0;3;2;1;66;3;339;37
8393;Give My Regards to Broad Street;87337;4;13;3;10;23;0;3;0;3;0;2.8;184;32
8395;The Last of Sheila;70291;7.3;11;10;1;90;0;1;1;0;100;3.8;402;77
8397;Miss March;1151922;2.5;76;4;72;5;2.4;14;0;14;0;2.7;39534;34
8398;Major Movie Star;1034320;0;2;0;2;0;0;0;0;0;0;0;0;0
8399;We're Not Married!;45317;0;2;1;1;50;0;0;0;0;0;0;0;0
8400;Wish You Were Here;418329;0;0;0;0;0;0;0;0;0;0;0;0;0
8401;The Adventures of Sherlock Holmes;31022;7.9;7;7;0;100;0;0;0;0;0;0;0;0
8402;Book of Love;376006;0;4;1;3;25;0;0;0;0;0;0;0;0
8403;Helen of Troy;49301;0;2;2;0;100;0;0;0;0;0;0;0;0
8404;The Hound of the Baskervilles;52905;7.8;11;11;0;100;0;0;0;0;0;0;0;0
8405;Vargtimmen;63759;7.5;16;14;2;87;0;3;2;1;66;3.9;1979;85
8407;The Molly Maguires;66090;6.6;9;8;1;88;0;2;1;1;50;3.4;501;57
8410;Suddenly;47542;6.4;7;6;1;85;0;1;1;0;100;3.3;506;59
8411;Urban Ghost Story;120423;0;4;4;0;100;0;0;0;0;0;0;0;0
8421;Muertos de risa;168080;0;0;0;0;0;0;0;0;0;0;0;0;0
8422;Kings Row;34946;7.6;13;13;0;100;0;0;0;0;0;0;0;0
8423;The Kid Brother;18051;0;3;3;0;100;0;0;0;0;0;0;0;0
8424;The Gay Divorcee;25164;7.8;8;8;0;100;0;0;0;0;0;0;0;0
8425;Meet the Applegates;100129;4.4;9;1;8;11;0;1;0;1;0;0;0;0
8426;Robotto kânibaru;93871;0;0;0;0;0;0;0;0;0;0;0;0;0
8427;Americathon;78766;0;0;0;0;0;0;0;0;0;0;0;0;0
8446;Sands of Iwo Jima;41841;7.4;10;10;0;100;0;0;0;0;0;0;0;0
8447;This Island Earth;47577;5;11;7;4;63;0;0;0;0;0;0;0;0
8450;Anthony Adverse;27300;0;2;0;2;0;0;0;0;0;0;0;0;0
8451;Blackboard Jungle;47885;7.1;21;16;5;76;0;3;2;1;66;3.5;811;72
8452;Moment by Moment;77942;0;0;0;0;0;0;0;0;0;0;0;0;0
8453;It Had to Be You;39500;0;0;0;0;0;0;0;0;0;0;0;0;0
8454;Luna Papa;170259;0;0;0;0;0;0;0;0;0;0;0;0;0
8455;Raising Victor Vargas;316188;7.9;105;101;4;96;8;31;31;0;100;3.8;1155;81
8456;Indagine su un cittadino al di sopra di ogni sospetto;65889;7.9;5;5;0;100;0;3;3;0;100;4.4;483;97
8457;True Love;98528;6.2;8;6;2;75;0;1;1;0;100;3.2;207;50
8458;Chacun son cinéma ou Ce petit coup au coeur quand la lumière s'éteint et que le film commence;973844;6.8;5;5;0;100;0;2;2;0;100;3.6;664;72
8459;The Heiress;41452;8.6;7;7;0;100;0;0;0;0;0;0;0;0
8460;State Fair;38116;6.4;5;4;1;80;0;0;0;0;0;0;0;0
8461;Dragon Seed;36777;0;3;2;1;66;0;0;0;0;0;0;0;0
8462;Executive Suite;46963;8;7;7;0;100;0;0;0;0;0;0;0;0
8463;Johnny Belinda;40495;7.1;7;6;1;85;0;0;0;0;0;0;0;0
8464;Super Size Me;390521;0;0;0;0;0;0;0;0;0;0;0;0;0
8465;Johnny Eager;33774;0;2;1;1;50;0;1;1;0;100;3.7;182;73
8477;La jetée;56119;8.4;21;19;2;90;0;3;2;1;66;4.4;3059;93
8478;Distant Voices, Still Lives;95037;7.9;15;13;2;86;0;1;1;0;100;4.2;292;87
8480;King of Kings;55047;6.2;14;11;3;78;0;4;2;2;50;3.7;879;75
8481;'Northwest Passage' (Book I -- Rogers' Rangers);32851;8.8;6;6;0;100;0;0;0;0;0;0;0;0
8482;The Picture of Dorian Gray;37988;7.9;9;8;1;88;0;0;0;0;0;0;0;0
8483;The Born Losers;61420;5.8;5;3;2;60;0;0;0;0;0;0;0;0
8484;Ningen no jôken;53114;7.3;8;7;1;87;0;3;2;1;66;4.4;321;94
8485;Samsara;196069;7.3;5;5;0;100;0;3;3;0;100;4.1;3198;85
8486;Bachelor Mother;31067;0;4;3;1;75;0;0;0;0;0;0;0;0
8487;Please Don't Eat the Daisies;54188;5.5;6;4;2;66;0;0;0;0;0;0;0;0
8488;Siddhartha;70689;6.7;17;10;7;58;6.4;7;4;3;57;3.3;225;57
8491;White Heat;42041;8.4;28;28;0;100;0;4;4;0;100;4.2;2557;93
8492;Scrooge;44008;7.7;23;19;4;82;0;3;2;1;66;3.3;4980;71
8493;Memphis Belle;100133;6;15;11;4;73;0;2;2;0;100;3.4;3799;75
8494;The Cincinnati Kid;59037;7.7;16;14;2;87;0;2;1;1;50;3.6;1393;77
8495;Animal Factory;204137;6.7;32;26;6;81;6.7;5;4;1;80;3.2;2952;55
8496;The Panic in Needle Park;67549;7;9;7;2;77;0;1;1;0;100;3.6;1885;74
8499;Pretty Baby;78111;6.9;14;11;3;78;0;0;0;0;0;0;0;0
8501;The Hitcher;455960;3.8;93;19;74;20;3.5;16;2;14;12;3.1;49309;59
8502;Show Boat;28249;9.4;8;8;0;100;0;0;0;0;0;0;0;0
8503;Ivanhoe;44760;5.6;10;7;3;70;0;0;0;0;0;0;0;0
8504;Box of Moon Light;115738;6.7;16;9;7;56;5.8;5;1;4;20;3.9;803;83
8505;Unagi;120408;7;25;19;6;76;6.7;6;5;1;83;3.8;686;81
8506;Fear X;289944;5.8;32;18;14;56;6.3;7;5;2;71;2.7;512;30
8507;Freaks;22913;8.3;41;39;2;95;0;3;3;0;100;4;6354;87
8511;The Immigrant;8133;0;0;0;0;0;0;0;0;0;0;0;0;0
8512;Silent Movie;75222;7.1;19;17;2;89;0;1;1;0;100;3.4;3857;65
8516;A Matter of Life and Death;38733;8.7;17;17;0;100;0;1;1;0;100;4.4;2083;94
8518;Anna Christie;20641;0;1;1;0;100;0;0;0;0;0;0;0;0
8519;The Bat People;71198;0;0;0;0;0;0;0;0;0;0;0;0;0
8520;Deep Cover;104073;6.6;20;17;3;85;5.8;8;6;2;75;3.4;1559;70
8521;Dr. Jekyll and Mr. Hyde;1159984;0;1;0;1;0;0;0;0;0;0;0;0;0
8522;My Little Chickadee;32828;7.4;10;9;1;90;0;0;0;0;0;0;0;0
8524;The High and the Mighty;47086;5.6;8;3;5;37;0;0;0;0;0;0;0;0
8525;The Ugly Dachshund;61135;0;3;2;1;66;0;0;0;0;0;0;0;0
8526;Around the World in 80 Days;327437;4.8;127;39;88;30;4.7;33;9;24;27;2.7;14038;45
8527;I'll Sleep When I'm Dead;319531;5.5;86;37;49;43;5.9;27;14;13;51;2.9;2107;38
8528;Dodgeball: A True Underdog Story;364725;6.3;159;111;48;69;6.3;36;23;13;63;3.4;118948;75
8529;The Terminal;362227;6.2;198;119;79;60;5.8;43;22;21;51;3.4;42895;72
8530;Dear Frankie;377752;6.8;109;88;21;80;6.8;32;26;6;81;4;6479;90
8531;White Chicks;381707;3.7;122;18;104;14;4.6;33;10;23;30;3;193197;62
8532;The Door in the Floor;348593;6.4;140;92;48;65;6.2;38;22;16;57;3.3;2273;63
8533;The Notebook;332280;0;0;0;0;0;0;0;0;0;0;0;0;0
8534;Deux frères;338512;6.6;112;87;25;77;6.2;32;25;7;78;3.4;4817;74
8535;De-Lovely;352277;5.7;153;74;79;48;5.2;40;17;23;42;3.3;2857;63
8537;Kaena: La prophétie;297753;3.9;30;2;28;6;3.8;12;0;12;0;2.9;1510;46
8540;Back to Bataan;37522;0;3;2;1;66;0;0;0;0;0;0;0;0
8541;Bloodhounds of Broadway;96953;0;0;0;0;0;0;0;0;0;0;0;0;0
8542;A Day at the Races;28772;7.8;12;12;0;100;0;0;0;0;0;0;0;0
8543;Flying Leathernecks;43547;6.8;7;6;1;85;0;1;1;0;100;3.4;821;62
8544;Now You See Him, Now You Don't;69031;0;1;0;1;0;0;0;0;0;0;0;0;0
8545;Briar Patch;220343;0;0;0;0;0;0;0;0;0;0;0;0;0
8571;Bob & Carol & Ted & Alice;64100;7.4;9;8;1;88;0;1;1;0;100;3.4;516;62
8572;The Littlest Rebel;26641;5.9;8;7;1;87;0;0;0;0;0;0;0;0
8573;Reconstruction;366943;6.4;37;28;9;75;6.8;13;10;3;76;4.1;1344;86
8574;A Claymation Christmas Celebration;272045;0;0;0;0;0;0;0;0;0;0;0;0;0
8575;Le battement d'ailes du papillon;243135;6;36;23;13;63;6.5;16;12;4;75;3.6;1840;71
8576;Kopps;339230;0;3;2;1;66;0;0;0;0;0;0;0;0
8577;Comandante;342213;5.6;13;8;5;61;0;1;0;1;0;3.5;658;63
8578;Undead;339840;4.3;74;22;52;29;3.2;20;1;19;5;3;4889;48
8579;The Scarlet and the Black;106124;\N;\N;\N;\N;\N;\N;\N;\N;\N;\N;\N;\N;\N
8580;Into the Woods;99851;0;0;0;0;0;0;0;0;0;0;0;0;0
8581;Pirates of Silicon Valley;168122;6.8;7;6;1;85;0;0;0;0;0;0;0;0
8582;Manufacturing Consent: Noam Chomsky and the Media;104810;8.1;7;7;0;100;0;0;0;0;0;0;0;0
8583;Twelve O'Clock High;41996;8.2;14;14;0;100;0;0;0;0;0;0;0;0
8584;Leave Her to Heaven;37865;8.4;17;17;0;100;7.5;5;5;0;100;3.8;937;81
8585;Rapa Nui;110944;0;0;0;0;0;0;0;0;0;0;0;0;0
8586;Roxie Hart;35272;7.1;9;8;1;88;0;0;0;0;0;0;0;0
8587;Mayor of the Sunset Strip;230512;7.4;75;65;10;86;7.4;27;25;2;92;3.5;553;67
8588;Killing Me Softly;250468;3.4;21;0;21;0;0;2;0;2;0;3;2072;46
8589;Talvisota;98437;0;0;0;0;0;0;0;0;0;0;0;0;0
8591;The Philadelphia Experiment;87910;5.1;10;5;5;50;0;0;0;0;0;0;0;0
8592;The Wheeler Dealers;57681;0;0;0;0;0;0;0;0;0;0;0;0;0
8593;Juice;104573;6.3;13;11;2;84;0;2;2;0;100;0;0;0
8594;The Secret Life of Girls;165086;0;1;0;1;0;0;0;0;0;0;0;0;0
8595;The Flim-Flam Man;61678;6.4;7;5;2;71;0;1;1;0;100;3.8;91;66
8596;Revenge of the Pink Panther;78163;6.7;16;13;3;81;0;0;0;0;0;0;0;0
8597;Whale Rider;298228;7.7;143;129;14;90;7.5;35;30;5;85;3.8;9564;87
8598;I Am Dina;281924;0;2;1;1;50;0;2;1;1;50;3.7;1055;74
8599;The Escapist;961728;6.1;42;27;15;64;6;10;6;4;60;3.3;2418;63
8600;Angels with Dirty Faces;29870;8;20;20;0;100;0;0;0;0;0;0;0;0
8601;Zéro de conduite: Jeunes diables au collège;24803;8.9;12;11;1;91;0;3;2;1;66;0;0;0
8602;Senki;834102;5.8;15;9;6;60;0;4;2;2;50;3.6;188;61
8603;Coming Out;97095;0;0;0;0;0;0;0;0;0;0;0;0;0
8604;Taxi;316732;3.4;104;11;93;10;3.8;27;5;22;18;2.8;15669;60
8605;Taxi 3;295721;0;1;1;0;100;0;0;0;0;0;0;0;0
8606;Pull My Daisy;52100;0;0;0;0;0;0;0;0;0;0;0;0;0
8607;Tokyo Godfathers;388473;7.1;57;51;6;89;7.1;21;19;2;90;4;3789;89
8608;Le boucher;64106;8.6;7;7;0;100;0;1;1;0;100;3.9;689;81
8609;Our Hospitality;14341;9.5;17;17;0;100;0;0;0;0;0;0;0;0
8610;Walk All Over Me;907680;0;4;2;2;50;0;1;0;1;0;3;609;37
8611;The Farmer's Daughter;39370;0;4;4;0;100;0;0;0;0;0;0;0;0
8612;Lassie Come Home;36098;7.5;7;6;1;85;0;0;0;0;0;0;0;0
8613;The Time of Your Life;40884;0;0;0;0;0;0;0;0;0;0;0;0;0
8614;Overboard;93693;5.1;21;11;10;52;0;3;1;2;33;3.2;9078;70
8615;The Mask of Fu Manchu;23194;6.6;7;6;1;85;0;0;0;0;0;0;0;0
8616;By the Light of the Silvery Moon;45586;0;1;1;0;100;0;0;0;0;0;0;0;0
8617;BUtterfield 8;53622;5.6;12;7;5;58;0;0;0;0;0;0;0;0
8618;Johnny Guitar;47136;8.4;23;22;1;95;0;3;2;1;66;4;1015;85
8619;Sister My Sister;111205;5.7;8;4;4;50;0;0;0;0;0;0;0;0
8620;El ángel exterminador;56732;8.9;17;16;1;94;0;2;1;1;50;4.3;2257;94
8621;Ivansxtc;238321;6.8;28;21;7;75;7.2;9;7;2;77;3.7;269;71
8622;Fahrenheit 9/11;361596;7.3;224;187;37;83;7.4;45;37;8;82;3.3;22990;69
8623;Roxanne;93886;7.3;33;29;4;87;6;6;4;2;66;3;5654;57
8624;Freedom Downtime;309614;0;0;0;0;0;0;0;0;0;0;0;0;0
8625;The Same River Twice;342956;6.7;31;21;10;67;6.7;14;10;4;71;3.8;44;67
8626;Dr. Terror's House of Horrors;59125;0;4;4;0;100;0;0;0;0;0;0;0;0
8628;Search and Destroy;114371;4;8;2;6;25;0;3;1;2;33;3;597;45
8629;The Book of Life;167059;7.5;9;8;1;88;0;0;0;0;0;0;0;0
8630;Such a Long Journey;120848;7.4;13;12;1;92;7.4;5;5;0;100;3.4;185;66
8631;Maxed Out: Hard Times, Easy Credit and the Era of Predatory Lenders;762117;7;48;42;6;87;6.6;19;15;4;78;3.1;68987;50
8632;Secret Society;217788;5.1;9;3;6;33;0;4;1;3;25;2.8;63;50
8633;The Last Starfighter;87597;6.2;26;19;7;73;0;1;0;1;0;3.3;6360;65
8634;Tank Girl;114614;4.9;33;14;19;42;5.3;9;4;5;44;2.8;7013;61
8635;Ultimo mondo cannibale;78437;0;2;1;1;50;0;0;0;0;0;0;0;0
8636;Spider-Man;145487;0;0;0;0;0;0;0;0;0;0;0;0;0
8637;America's Heart and Soul;381006;0;0;0;0;0;0;0;0;0;0;0;0;0
8638;Before Sunset;381681;8.3;158;150;8;94;8.4;39;38;1;97;4;20750;90
8639;The Clearing;331952;5.6;128;56;72;43;5.5;34;16;18;47;2.9;1494;35
8640;King Arthur;349683;4.9;183;57;126;31;5.2;38;12;26;31;3.2;57867;63
8642;Sleepover;368975;3.7;95;14;81;14;3.9;29;5;24;17;3.3;29842;62
8643;Another Cinderella Story;1071358;0;2;2;0;100;0;0;0;0;0;0;0;0
8644;I, Robot;343818;0;0;0;0;0;0;0;0;0;0;0;0;0
8645;Maria Full of Grace;390221;8;137;133;4;97;8.2;34;33;1;97;3.8;9542;84
8647;Follow That Dream;55992;0;2;2;0;100;0;0;0;0;0;0;0;0
8648;La niña de tus ojos;158030;0;0;0;0;0;0;0;0;0;0;0;0;0
8649;Gray Lady Down;77629;6;5;3;2;60;0;0;0;0;0;0;0;0
8650;Long Day's Journey Into Night;56196;8.3;13;12;1;92;0;1;1;0;100;3.9;807;82
8651;Man of La Mancha;68909;5.5;12;6;6;50;0;1;0;1;0;0;0;0
8652;The Night of the Following Day;64728;7.2;5;5;0;100;0;1;1;0;100;3.3;195;44
8653;Posse;107863;5.1;15;5;10;33;0;4;1;3;25;2.8;1087;45
8654;Prince Valiant;47365;0;0;0;0;0;0;0;0;0;0;0;0;0
8655;Rustlers' Rhapsody;89945;0;4;0;4;0;0;0;0;0;0;0;0;0
8656;Krótki film o zabijaniu;95468;7.7;12;10;2;83;0;3;2;1;66;4.2;1659;92
8657;The Tin Star;51087;0;4;4;0;100;0;0;0;0;0;0;0;0
8658;Zandalee;101004;4;6;2;4;33;0;0;0;0;0;0;0;0
8659;Brève traversée;299594;0;2;2;0;100;0;0;0;0;0;0;0;0
8660;Potop;72021;0;0;0;0;0;0;0;0;0;0;0;0;0
8661;How the West Was Won;56085;7.1;15;14;1;93;0;0;0;0;0;0;0;0
8662;Joan of Arc;151137;4.5;72;22;50;30;3.4;21;1;20;4;3.1;8110;57
8663;Live Forever;358569;5.6;5;4;1;80;0;0;0;0;0;0;0;0
8664;Mr. Klein;74916;0;0;0;0;0;0;0;0;0;0;0;0;0
8665;The Bourne Supremacy;372183;7.2;185;150;35;81;7;39;29;10;74;3.9;111547;89
8666;Catwoman;327554;3.1;177;17;160;9;3.3;39;4;35;10;2.2;23007;34
8667;A Home at the End of the World;359423;5.7;111;53;58;47;6.1;32;18;14;56;3.5;3425;66
8668;Some Girls;98356;0;1;0;1;0;0;0;0;0;0;0;0;0
8669;Stay Hungry;75268;6.5;6;5;1;83;0;1;1;0;100;2.9;807;34
8670;Das Testament des Dr. Mabuse;23563;8.2;10;9;1;90;0;0;0;0;0;0;0;0
8671;Zus & zo;245157;4.9;19;8;11;42;4;9;1;8;11;3;136;41
8672;Battle Hymn;50171;0;4;1;3;25;0;1;0;1;0;2.9;249;30
8673;Crash Dive;35763;0;3;1;2;33;0;0;0;0;0;0;0;0
8674;Disco Pigs;236157;4.8;5;1;4;20;0;0;0;0;0;0;0;0
8675;The Enemy Below;50356;0;4;3;1;75;0;0;0;0;0;0;0;0
8676;Fist of the North Star;113074;0;3;2;1;66;0;0;0;0;0;0;0;0
8677;Flash Gordon Conquers the Universe;32475;6.5;7;6;1;85;0;0;0;0;0;0;0;0
8678;Guns of the Magnificent Seven;64395;0;2;2;0;100;0;0;0;0;0;0;0;0
8679;The Deer Hunter;77416;8.3;44;40;4;90;7.1;5;4;1;80;4.1;27513;91
8680;Tras el cristal;90197;5;6;3;3;50;0;4;2;2;50;3.7;441;77
8681;Lancelot du Lac;71737;8.2;12;11;1;91;0;2;1;1;50;3.7;482;71
8682;The Last Valley;65969;0;2;2;0;100;0;0;0;0;0;0;0;0
8683;The Magnificent Seven Ride!;68897;0;0;0;0;0;0;0;0;0;0;0;0;0
8684;Un condamné à mort s'est échappé ou Le vent souffle où il veut;49902;8.5;17;17;0;100;0;1;1;0;100;4.3;1392;92
8685;Marcelino pan y vino;47216;0;0;0;0;0;0;0;0;0;0;0;0;0
8686;Morituri;59470;0;3;2;1;66;0;0;0;0;0;0;0;0
8687;Orgy of the Dead;54240;1.2;5;0;5;0;0;0;0;0;0;0;0;0
8688;Shalako;63592;0;4;1;3;25;0;1;0;1;0;2.9;691;34
8689;Shock to the System;780606;5;8;4;4;50;4.5;5;2;3;40;2.8;7652;33
8690;Slaughterhouse-Five;69280;7.4;13;10;3;76;0;0;0;0;0;0;0;0
8692;Wake Island;35530;7.4;5;5;0;100;0;0;0;0;0;0;0;0
8693;What Price Glory;45323;0;4;2;2;50;0;0;0;0;0;0;0;0
8694;You Were Never Lovelier;35583;7.4;5;5;0;100;0;0;0;0;0;0;0;0
8695;The Bachelor and the Bobby-Soxer;39169;6.2;8;6;2;75;0;1;0;1;0;3.7;1615;77
8696;Breezy;69822;0;2;1;1;50;0;0;0;0;0;0;0;0
8697;En la ciudad sin límites;311072;0;0;0;0;0;0;0;0;0;0;0;0;0
8698;The Comfort of Strangers;99292;5.7;13;8;5;61;0;2;0;2;0;3.4;597;58
8699;Dancing in September;219636;0;3;3;0;100;0;0;0;0;0;0;0;0
8700;Destination Tokyo;35799;0;4;3;1;75;0;0;0;0;0;0;0;0
8701;Dr. Jekyll and Ms. Hyde;112895;2.5;7;1;6;14;0;1;0;1;0;2.4;1292;25
8702;Dream Lover;109665;5.6;13;7;6;53;0;2;1;1;50;3;280;40
8703;Fausto 5.0;299873;0;0;0;0;0;0;0;0;0;0;0;0;0
8704;For Queen & Country;97373;0;0;0;0;0;0;0;0;0;0;0;0;0
8705;Funny About Love;99623;3.3;7;0;7;0;0;1;0;1;0;2.8;446;30
8706;The Greatest Game Ever Played;388980;6.2;109;68;41;62;5.7;27;15;12;55;3.6;15763;76
8708;Hometown Legend;260695;0;2;0;2;0;0;0;0;0;0;0;0;0
8709;How I Got Into College;97530;4.6;8;3;5;37;0;0;0;0;0;0;0;0
8710;Map of the Human Heart;104812;6.8;20;16;4;80;0;4;3;1;75;3.7;666;74
8711;Mr. Blandings Builds His Dream House;40613;7.1;14;11;3;78;0;0;0;0;0;0;0;0
8712;My Favorite Wife;29284;6.7;12;10;2;83;0;3;2;1;66;3.9;1364;85
8713;The New Adventures of Pippi Longstocking;93744;4.4;5;1;4;20;0;0;0;0;0;0;0;0
8714;Night and Day;38776;0;4;2;2;50;0;0;0;0;0;0;0;0
8715;No Name on the Bullet;52002;0;1;1;0;100;0;0;0;0;0;0;0;0
8716;The Plainsman;28108;0;0;0;0;0;0;0;0;0;0;0;0;0
8718;The Snake Pit;40806;0;3;3;0;100;0;0;0;0;0;0;0;0
8719;The Spoilers;35369;0;3;3;0;100;0;0;0;0;0;0;0;0
8720;Super Size Me;390521;0;0;0;0;0;0;0;0;0;0;0;0;0
8721;Tai-Pan;92042;3.7;5;1;4;20;0;1;0;1;0;2.9;427;37
8722;Two of a Kind;86494;4;10;2;8;20;0;1;0;1;0;2.9;2389;40
8723;The 13th Warrior;120657;4.6;86;28;58;32;4.9;18;7;11;38;3.2;24204;66
8724;Il gattopardo;57091;7.4;6;6;0;100;0;1;1;0;100;4.2;484;92
8725;Goodbye, Columbus;64381;7.1;9;9;0;100;0;0;0;0;0;0;0;0
8726;The President's Analyst;62153;7.1;20;16;4;80;8;5;5;0;100;3.6;371;73
8727;The Day of the Locust;72848;6.8;8;5;3;62;0;1;1;0;100;3.6;582;75
8728;The Creeping Flesh;68424;5.8;5;4;1;80;0;0;0;0;0;0;0;0
8729;Un amour de Swann;88315;0;4;3;1;75;0;1;1;0;100;3.2;261;48
8730;To End All Wars;243609;6.1;11;7;4;63;0;2;1;1;50;3.9;1957;85
8731;Moulin Rouge!;203009;7;168;130;38;77;6.1;35;23;12;65;3.7;110817;88
8732;The Belly of an Architect;92637;6.3;12;10;2;83;0;0;0;0;0;0;0;0
8733;Nid de guêpes;280990;0;0;0;0;0;0;0;0;0;0;0;0;0
8734;Love Happy;41604;0;2;2;0;100;0;0;0;0;0;0;0;0
8735;High School Confidential!;51724;6.3;9;6;3;66;0;1;1;0;100;3.3;853;54
8736;Out of the Blue;81291;6.2;5;4;1;80;0;1;1;0;100;3.9;294;80
8737;Crimetime;115976;0;1;0;1;0;0;0;0;0;0;0;0;0
8738;Une femme est une femme;55572;7.4;28;24;4;85;7.6;10;9;1;90;4;2893;86
8739;Mamma Roma;56215;7.8;9;9;0;100;0;0;0;0;0;0;0;0
8740;Donzoko;50330;8.2;5;4;1;80;0;1;1;0;100;3.9;685;82
8741;Ruby Cairo;107999;0;0;0;0;0;0;0;0;0;0;0;0;0
8742;Night Patrol;87795;0;0;0;0;0;0;0;0;0;0;0;0;0
8743;Biggles;90729;0;0;0;0;0;0;0;0;0;0;0;0;0
8744;Fancy Pants;42447;0;4;3;1;75;0;0;0;0;0;0;0;0
8745;The World of Suzie Wong;54483;0;2;2;0;100;0;0;0;0;0;0;0;0
8746;King of the Ants;328031;7.2;8;8;0;100;0;0;0;0;0;0;0;0
8747;Uncle Sam;118025;5.1;9;5;4;55;0;0;0;0;0;0;0;0
8748;Ieri, oggi, domani;57171;7.3;5;4;1;80;0;0;0;0;0;0;0;0
8749;La belle noiseuse;101428;8;22;22;0;100;8.2;6;6;0;100;3.9;797;83
8751;Deadly Is the Female;42530;8.2;27;26;1;96;0;2;1;1;50;3.8;881;83
8752;The Set-Up;41859;5.9;6;5;1;83;0;0;0;0;0;0;0;0
8753;Unprecedented: The 2000 Presidential Election;346091;0;0;0;0;0;0;0;0;0;0;0;0;0
8754;The Prime of Miss Jean Brodie;64840;6.9;14;13;1;92;0;2;2;0;100;3.8;987;81
8755;Il mio viaggio in Italia;173772;8.3;20;20;0;100;0;4;4;0;100;3.9;769;82
8756;The North Avenue Irregulars;79639;5.1;7;5;2;71;0;0;0;0;0;0;0;0
8757;Lovers and Other Strangers;66016;0;4;3;1;75;0;1;1;0;100;3.4;328;50
8758;Kotch;67314;0;4;2;2;50;0;1;0;1;0;3.4;272;59
8759;Greyfriars Bobby: The True Story of a Dog;54944;0;0;0;0;0;0;0;0;0;0;0;0;0
8760;Side Out;100613;0;4;0;4;0;0;0;0;0;0;0;0;0
8761;The Three Lives of Thomasina;57579;0;4;2;2;50;0;0;0;0;0;0;0;0
8762;No Deposit, No Return;74968;0;0;0;0;0;0;0;0;0;0;0;0;0
8763;The One and Only, Genuine, Original Family Band;63389;0;0;0;0;0;0;0;0;0;0;0;0;0
8765;This Gun for Hire;35432;7.3;13;12;1;92;0;1;1;0;100;3.7;648;80
8766;Black Angel;38360;0;4;3;1;75;0;0;0;0;0;0;0;0
8767;The Big Clock;40160;7.6;6;6;0;100;0;0;0;0;0;0;0;0
8768;CrissCross;104027;0;0;0;0;0;0;0;0;0;0;0;0;0
8769;The Fifth Musketeer;79152;0;1;1;0;100;0;0;0;0;0;0;0;0
8770;Evilspeak;82346;4.1;5;2;3;40;0;0;0;0;0;0;0;0
8771;Terror by Night;39017;6.5;7;5;2;71;0;0;0;0;0;0;0;0
8772;The Spy Who Came in from the Cold;59749;7.6;12;10;2;83;0;3;2;1;66;0;0;0
8773;Sherlock Holmes and the Secret Weapon;35317;0;2;1;1;50;0;0;0;0;0;0;0;0
8774;The Woman in Green;38259;7.2;8;8;0;100;0;0;0;0;0;0;0;0
8775;The Counterfeit Traitor;55871;0;3;2;1;66;0;0;0;0;0;0;0;0
8777;Roadkill;98209;\N;\N;\N;\N;\N;\N;\N;\N;\N;\N;\N;\N;\N
8778;Dressed to Kill;38494;6.2;5;4;1;80;0;0;0;0;0;0;0;0
8779;Bon voyage;310778;6.7;95;72;23;75;7.2;29;23;6;79;3.5;1025;69
8780;The Assassination Bureau;64045;5.9;5;4;1;80;0;2;2;0;100;3.5;334;69
8781;The Manchurian Candidate;56218;8.6;48;47;1;97;7.5;6;5;1;83;3.9;6006;89
8782;Thunderbirds;167456;4.1;99;19;80;19;3.9;29;5;24;17;2.7;4133;45
8783;The Village;368447;5.4;199;84;115;42;5.7;39;19;20;48;3;47806;59
8784;Garden State;333766;7.4;184;158;26;85;7.1;36;30;6;83;3.8;90523;87
8785;Bakushû;43313;8.8;9;9;0;100;0;1;1;0;100;4.1;762;91
8786;Le quai des brumes;30643;7.9;10;9;1;90;0;2;1;1;50;4.1;679;89
8787;Thunderbirds Are GO;61094;4.2;5;2;3;40;0;0;0;0;0;0;0;0
8788;Thunderbird 6;63694;0;3;1;2;33;0;0;0;0;0;0;0;0
8789;Castle Keep;64137;5.4;7;3;4;42;0;3;1;2;33;3;755;46
8790;Revengers Tragedy;286921;6.4;5;3;2;60;0;1;1;0;100;3.9;317;78
8791;Sip si 32 dou;115665;0;0;0;0;0;0;0;0;0;0;0;0;0
8792;Octane;323465;3.9;6;1;5;16;0;0;0;0;0;0;0;0
8793;PTU;250638;5.8;14;8;6;57;0;1;1;0;100;3.7;1107;79
8794;Neokonchennaya pyesa dlya mekhanicheskogo pianino;76446;0;1;1;0;100;0;0;0;0;0;0;0;0
8795;Musa;275083;0;1;1;0;100;0;0;0;0;0;0;0;0
8796;A Funny Thing Happened on the Way to the Forum;60438;7;17;14;3;82;0;0;0;0;0;0;0;0
8797;Death of a Salesman;89006;8.2;7;7;0;100;0;0;0;0;0;0;0;0
8798;Collateral;369339;7.4;223;192;31;86;7.2;44;36;8;81;3.5;43901;79
8799;Little Black Book;361841;4.4;108;23;85;21;4.1;31;5;26;16;2.8;12215;46
8800;Code 46;345061;6.1;96;50;46;52;5.5;32;10;22;31;3.3;2456;59
8801;In the Soup;104503;6.7;6;5;1;83;0;2;1;1;50;3.5;578;70
8803;Aoi haru;309291;0;0;0;0;0;0;0;0;0;0;0;0;0
8804;Une affaire de femmes;96336;7.4;10;8;2;80;0;1;0;1;0;3.7;435;73
8805;Juyuso seubgyuksageun;262246;0;1;1;0;100;0;0;0;0;0;0;0;0
8806;The Mask;110475;6.4;44;33;11;75;6.1;9;5;4;55;3.2;68419;66
8807;Harold & Kumar Go to White Castle;366551;6.5;144;106;38;73;6.7;30;22;8;73;3.5;61100;79
8808;The Princess Diaries 2: Royal Engagement;368933;4.6;113;29;84;25;4.8;28;10;18;35;3.2;63165;68
8809;Danny Deckchair;337960;5.7;75;40;35;53;5.9;24;14;10;58;3.6;1705;74
8810;AVP: Alien vs. Predator;370263;4.1;139;30;109;21;3.4;25;1;24;4;3;48807;51
8811;Yûgiô Duel Monsters: Hikari no pyramid;403703;3;62;3;59;4;2.8;19;0;19;0;3;2474;53
8812;Novo;291392;4.7;10;5;5;50;0;4;1;3;25;3.3;452;55
8813;We Don't Live Here Anymore;361309;6.4;122;79;43;64;6.8;34;24;10;70;3.2;2382;55
8814;Without a Paddle;364751;3.9;124;18;106;14;4.2;31;6;25;19;3.3;33540;73
8815;Exorcist: The Beginning;204313;3.6;123;14;109;11;3.3;23;1;22;4;2.8;14563;42
8818;It Happened at the World's Fair;57191;3.9;6;1;5;16;0;0;0;0;0;0;0;0
8821;Harum Scarum;59255;0;0;0;0;0;0;0;0;0;0;0;0;0
8822;The Spaceman and King Arthur;80062;0;3;1;2;33;0;0;0;0;0;0;0;0
8823;The Sting II;86370;0;0;0;0;0;0;0;0;0;0;0;0;0
8825;Cheerleader Camp;92744;0;1;0;1;0;0;0;0;0;0;0;0;0
8826;Ressources humaines;220726;7.8;31;30;1;96;7.8;7;7;0;100;3.7;375;77
8827;Bill Cosby: Himself;83652;7;5;4;1;80;0;0;0;0;0;0;0;0
8828;Dead Ringers;94964;7.7;35;29;6;82;5.7;6;3;3;50;3.6;4690;80
8829;Benji: Off the Leash!;315273;4.7;43;14;29;32;5;16;5;11;31;3.3;551;60
8830;Anacondas: The Hunt for the Blood Orchid;366174;4.3;116;31;85;26;4.5;28;8;20;28;2.5;14394;43
8831;Suspect Zero;324127;4.4;129;23;106;17;4.6;32;7;25;21;3;2578;43
8832;Tian di ying xiong;374330;6.1;31;21;10;67;5.6;10;5;5;50;3.3;1053;57
8833;Vanity Fair;241025;5.8;162;81;81;50;5.8;41;23;18;56;3;9329;52
8834;The Cookout;380277;2.8;42;2;40;4;2.6;14;1;13;7;2.9;1132;50
8835;Paparazzi;338325;3.4;77;14;63;18;2.8;14;0;14;0;2.8;2849;43
8836;Wicker Park;324554;4.3;120;28;92;23;4.3;30;7;23;23;3.5;12752;79
8837;Trigger Man;814365;6.9;9;8;1;88;0;3;3;0;100;2.8;140;45
8838;Alice Doesn't Live Here Anymore;71115;7.8;19;18;1;94;0;4;3;1;75;0;0;0
8839;The Mangler;113762;2.5;9;2;7;22;0;1;0;1;0;2.4;1314;25
8840;I Call First;63803;6.1;13;9;4;69;0;4;1;3;25;3.4;1323;61
8841;Seeing Other People;362129;5.5;33;13;20;39;5.3;13;6;7;46;2.9;579;35
8842;Past Midnight;105108;0;0;0;0;0;0;0;0;0;0;0;0;0
8843;A Million to Juan;110518;0;2;0;2;0;0;0;0;0;0;0;0;0
8844;Amator;78763;7.3;9;8;1;88;0;3;2;1;66;4;656;88
8845;Bez konca;86961;7.3;10;9;1;90;0;3;2;1;66;3.9;354;79
8846;Highwaymen;339147;3.2;15;2;13;13;0;1;0;1;0;3;1050;42
8847;Graffiti Bridge;99691;4.9;8;3;5;37;0;1;0;1;0;3;996;47
8848;I vitelloni;46521;8.8;22;22;0;100;8.9;11;11;0;100;4.1;1679;90
8849;Under the Cherry Moon;92133;3.8;22;6;16;27;5.3;5;2;3;40;3.3;1076;65
8850;Flipper;116322;4.8;17;5;12;29;5.4;5;1;4;20;2.6;6086;44
8851;Smile;397103;4;13;2;11;15;3.9;5;1;4;20;3.5;585;69
8852;Lord Jim;59399;5.7;13;7;6;53;0;3;0;3;0;3.3;613;54
8853;A Small Circle of Friends;81528;0;1;1;0;100;0;0;0;0;0;0;0;0
8854;Night of the Demons III;116073;0;2;0;2;0;0;0;0;0;0;0;0;0
8855;Witchboard;90327;4.8;8;3;5;37;0;0;0;0;0;0;0;0
8856;Roller Boogie;79822;3;6;0;6;0;0;1;0;1;0;3;585;49
8858;The Apple;80380;4.6;6;1;5;16;0;0;0;0;0;0;0;0
8859;Superbabies: Baby Geniuses 2;270846;2.2;40;0;40;0;2.5;17;0;17;0;2.1;1335;28
8860;Cellular;337921;5.8;146;80;66;54;5.8;32;17;15;53;3.2;13185;63
8861;Resident Evil: Apocalypse;318627;3.9;121;25;96;20;3.3;26;2;24;7;3.3;56756;70
8862;Criminal;362526;6.4;118;82;36;69;6.7;34;25;9;73;3.3;1400;58
8864;Mr 3000;339412;5.9;104;58;46;55;6.1;34;20;14;58;2.6;2928;35
8865;Sky Captain and the World of Tomorrow;346156;6.8;204;147;57;72;6.6;38;26;12;68;2.8;17325;43
8866;Wimbledon;360201;5.9;142;86;56;60;5.6;33;18;15;54;3.1;14484;57
8867;Anatomie de l'enfer;348529;3.6;34;9;25;26;3.7;15;4;11;26;2.9;861;42
8868;Head in the Clouds;338097;4.3;87;13;74;14;4.2;31;4;27;12;3.4;2782;62
8869;First Daughter;361620;3.7;83;7;76;8;3.5;24;0;24;0;2.8;13699;50
8870;The Forgotten;356618;5;168;51;117;30;4.7;34;10;24;29;2.9;13766;47
8871;The Last Shot;357054;5.9;66;40;26;60;5.7;21;13;8;61;2.8;795;30
8872;A Dirty Shame;365125;0;0;0;0;0;0;0;0;0;0;0;0;0
8873;Diarios de motocicleta;318462;7.5;153;128;25;83;7.6;37;31;6;83;4.1;22395;91
8874;Shaun of the Dead;365748;7.7;175;159;16;90;7.6;33;31;2;93;3.9;110759;91
8875;Come Back, Little Sheba;44509;6.4;6;4;2;66;0;0;0;0;0;0;0;0
8876;The Black Orchid;52631;4.6;5;1;4;20;0;1;0;1;0;3.6;104;66
8878;Class of Nuke 'Em High Part II: Subhumanoid Meltdown;101591;0;1;0;1;0;0;0;0;0;0;0;0;0
8879;Murder on the Orient Express;71877;7.4;19;19;0;100;0;1;1;0;100;3.5;3826;74
8880;The Mask;110475;6.4;44;33;11;75;6.1;9;5;4;55;3.2;68419;66
8881;Alexander's Ragtime Band;29852;0;2;1;1;50;0;0;0;0;0;0;0;0
8882;The Boston Strangler;62755;6.5;12;11;1;91;0;1;1;0;100;3.5;672;73
8883;The Last Flight of Noah's Ark;81031;4.4;5;2;3;40;0;1;0;1;0;2.9;399;42
8884;The Man with One Red Shoe;89543;4.6;13;6;7;46;0;1;0;1;0;2.8;2768;38
8885;The Sentinel;443632;5;134;44;90;32;5.1;32;11;21;34;3.1;26716;47
8886;Sssssss;70622;3.4;7;1;6;14;0;0;0;0;0;0;0;0
8887;Whispers in the Dark;105811;4.6;7;2;5;28;0;1;0;1;0;2.9;293;31
8889;The Legacy;79450;0;1;1;0;100;0;0;0;0;0;0;0;0
8890;The Alligator People;52549;0;3;1;2;33;0;0;0;0;0;0;0;0
8891;See No Evil, Hear No Evil;98282;3.4;11;2;9;18;0;1;0;1;0;3.3;6015;72
8892;Basket Case 3: The Progeny;103773;\N;\N;\N;\N;\N;\N;\N;\N;\N;\N;\N;\N;\N
8893;Basket Case 2;99108;0;4;4;0;100;0;0;0;0;0;0;0;0
8894;Orca;76504;3.8;12;2;10;16;0;0;0;0;0;0;0;0
8895;AKA;317052;6.2;31;18;13;58;6.6;12;8;4;66;3.1;250;50
8896;I Married a Monster from Outer Space;51756;6.2;12;10;2;83;0;0;0;0;0;0;0;0
8897;The Trojan Women;67881;0;2;2;0;100;0;1;1;0;100;3.1;225;50
8898;Robinson Crusoe;117496;0;3;1;2;33;0;0;0;0;0;0;0;0
8899;Hardcore;79271;6.7;19;16;3;84;0;1;1;0;100;3.4;560;64
8900;Watermelon Man;66550;0;3;3;0;100;0;0;0;0;0;0;0;0
8901;Flashpoint;1059475;\N;\N;\N;\N;\N;\N;\N;\N;\N;\N;\N;\N;\N
8902;Bug;470705;6.2;128;76;52;59;6.6;36;24;12;66;2.5;168834;31
8903;Planet Terror;1077258;6.1;23;17;6;73;0;0;0;0;0;0;0;0
8905;1492: Conquest of Paradise;103594;4.1;16;7;9;43;0;2;1;1;50;3;3372;47
8906;Cannibal Holocaust;78935;5.2;11;7;4;63;0;0;0;0;0;0;0;0
8907;Shark Tale;307453;5.2;173;61;112;35;5.5;34;13;21;38;3.2;78877;59
8908;Ladder 49;349710;0;0;0;0;0;0;0;0;0;0;0;0;0
8909;Black Cloud;363475;5.3;7;2;5;28;0;2;0;2;0;3.9;507;83
8910;I Heart Huckabees;356721;6.3;184;113;71;61;5.7;41;21;20;51;3.3;38441;75
8911;Raise Your Voice;361696;3.7;83;13;70;15;3.9;27;6;21;22;3.3;56922;74
8912;Taxi;316732;3.4;104;11;93;10;3.8;27;5;22;18;2.8;15669;60
8913;Around the Bend;384810;4.9;94;27;67;28;4.7;30;7;23;23;3.4;1012;65
8914;Primer;390384;6.5;115;83;32;72;6.4;28;20;8;71;3.8;10817;82
8915;Stage Beauty;368658;0;0;0;0;0;0;0;0;0;0;0;0;0
8916;Shall We Dance;358135;5.4;152;69;83;45;5.2;37;16;21;43;3;26935;63
8917;Team America: World Police;372588;6.9;191;145;46;75;6.4;38;26;12;68;3.4;43078;78
8918;Eulogy;349416;4.6;34;11;23;32;3.9;9;1;8;11;3.6;2744;71
8919;P.S.;380609;5.8;78;43;35;55;5.6;27;14;13;51;3;1406;41
8920;The Country Girl;46874;7.2;6;5;1;83;0;0;0;0;0;0;0;0
8921;The Rose Tattoo;48563;7.8;5;4;1;80;0;0;0;0;0;0;0;0
8922;Epidemic;92972;5.4;6;2;4;33;0;2;2;0;100;3.3;1016;60
8923;Tess;80009;7;16;13;3;81;0;4;4;0;100;3.6;1705;73
8924;I Wanna Hold Your Hand;77714;6.4;17;14;3;82;0;1;0;1;0;3.5;625;72
8925;Spinning Boris;324619;0;0;0;0;0;0;0;0;0;0;0;0;0
8926;Circle of Iron;78975;4.6;7;3;4;42;0;0;0;0;0;0;0;0
8927;The Cannonball Run;82136;4.2;29;9;20;31;0;3;0;3;0;3.1;6545;59
8928;Dance of the Vampires;61655;6.1;29;19;10;65;0;4;2;2;50;3.8;3901;77
8929;Black Beauty;109279;0;0;0;0;0;0;0;0;0;0;0;0;0
8930;De fem benspænd;354575;7.6;57;50;7;87;8;15;14;1;93;4;1809;84
8931;Born Rich;342143;0;0;0;0;0;0;0;0;0;0;0;0;0
8932;It's Alive;71675;0;1;0;1;0;0;0;0;0;0;0;0;0
8933;Le déclin de l'empire américain;90985;7.3;12;11;1;91;0;1;1;0;100;3.7;1522;79
8934;Bébé's Kids;103783;4.1;7;1;6;14;0;0;0;0;0;0;0;0
8935;All I Want for Christmas;101301;2.3;6;0;6;0;0;1;0;1;0;3.1;1740;55
8936;La vie et rien d'autre;98596;0;4;4;0;100;0;0;0;0;0;0;0;0
8937;Friday Night Lights;390022;7.1;166;134;32;80;7.5;39;34;5;87;3.6;36154;84
8938;Tarnation;390538;7.6;100;92;8;92;8.2;34;33;1;97;3.9;2007;82
8939;The Final Cut;364343;5.4;75;29;46;38;4.9;26;8;18;30;3;4745;48
8941;Riding the Bullet;355954;4.2;21;6;15;28;3.1;6;0;6;0;2.9;1830;40
8942;Spin;362174;5.1;7;3;4;42;0;1;0;1;0;3.7;271;71
8943;Being Julia;340012;6.7;123;94;29;76;6.5;35;24;11;68;3.5;1947;71
8944;The Dust Factory;329030;2.9;11;1;10;9;0;3;0;3;0;3.6;977;65
8945;Thérèse;92090;7.8;6;5;1;83;0;2;1;1;50;3.8;225;78
8946;Surviving Christmas;252028;3;109;8;101;7;2.9;29;2;27;6;2.6;4192;37
8947;The Grudge;391198;5.1;153;61;92;39;4.8;33;8;25;24;2.9;54794;57
8948;Alfie;375173;5.5;149;73;76;48;5.2;38;16;22;42;2.9;15367;49
8949;Sideways;375063;8.6;212;205;7;96;8.7;42;41;1;97;3.4;35809;77
8950;The Machinist;361862;6.6;132;99;33;75;6.7;33;25;8;75;3.7;41645;82
8951;Vera Drake;383694;7.9;155;142;13;91;8;40;36;4;90;3.8;3338;82
8952;Duo luo tian shi;112913;7.9;19;18;1;94;0;4;4;0;100;4;4014;86
8954;Lightning in a Bottle;396705;7.4;61;53;8;86;7.4;22;20;2;90;3.6;343;78
8955;Undertow;360130;5.9;116;64;52;55;6.1;34;19;15;55;3.4;1926;65
8956;Enduring Love;375735;6.2;96;57;39;59;6.2;34;20;14;58;3.3;2543;60
8957;Saw;387564;5.4;161;77;84;47;4.9;32;10;22;31;3.7;144186;86
8958;Ray;350258;7.3;194;157;37;80;7.7;41;35;6;85;3.8;32696;87
8959;Birth;337876;5.2;138;54;84;39;5.3;39;14;25;35;2.8;5483;41
8960;Voices of Iraq;430745;6.1;15;9;6;60;5.9;12;6;6;50;4;111;86
8961;The Incredibles;317705;0;0;0;0;0;0;0;0;0;0;0;0;0
8962;Fade to Black;80711;4.9;11;5;6;45;0;1;1;0;100;3.3;379;54
8963;It's All About Love... og Thomas Vinterberg;345449;\N;\N;\N;\N;\N;\N;\N;\N;\N;\N;\N;\N;\N
8964;Callas Forever;274407;0;0;0;0;0;0;0;0;0;0;0;0;0
8965;The Polar Express;338348;6.4;186;104;82;55;6.2;39;21;18;53;3.2;22358;65
8966;Kinsey;362269;7.6;187;168;19;89;7.9;39;36;3;92;3.4;6162;72
8967;Seed of Chucky;387575;4.4;71;23;48;32;3.9;18;2;16;11;2.6;15727;52
8968;After the Sunset;367479;4.4;138;25;113;18;4.2;33;4;29;12;3.1;6886;56
8969;Bridget Jones: The Edge of Reason;317198;4.7;149;40;109;26;4.7;35;10;25;28;3.1;41759;64
8970;Finding Neverland;308644;7.4;200;165;35;82;7.3;39;31;8;79;3.7;77596;84
8971;Veer-Zaara;420332;0;3;3;0;100;0;2;2;0;100;4.2;4026;87
8972;National Treasure: Book of Secrets;465234;4.7;118;39;79;33;4.6;25;8;17;32;3.6;1237906;72
8973;La mala educación;275491;7.5;134;118;16;88;7.8;35;30;5;85;3.9;13423;85
8974;The SpongeBob SquarePants Movie;345950;6.2;123;84;39;68;6.2;33;23;10;69;3.2;19811;74
8976;San-Antonio;375040;0;0;0;0;0;0;0;0;0;0;0;0;0
8977;Alexander;346491;3.9;193;31;162;16;4;41;5;36;12;2.7;29540;43
8978;Christmas with the Kranks;388419;2.8;131;6;125;4;3.4;33;1;32;3;2.9;11697;46
8979;Guerrilla: The Taking of Patty Hearst;390299;0;0;0;0;0;0;0;0;0;0;0;0;0
8980;Notre musique;360845;6.6;54;36;18;66;6.9;17;12;5;70;3.7;949;69
8981;Closer;376541;6.6;201;137;64;68;6.6;42;31;11;73;3.5;50768;80
8982;I Am David;327919;5.2;34;13;21;38;5.3;10;3;7;30;4;1967;86
8983;Shi mian mai fu;385004;7.8;163;143;20;87;8.1;39;37;2;94;3.6;35657;81
8984;Ocean's Twelve;349903;5.9;174;96;78;55;6.1;38;23;15;60;3.4;108512;67
8985;Blade: Trinity;359013;4.5;162;43;119;26;4.4;33;7;26;21;3.4;62827;70
8986;The Bellboy;53644;6.9;9;6;3;66;0;0;0;0;0;0;0;0
8987;Le monde selon Bush;416043;0;0;0;0;0;0;0;0;0;0;0;0;0
8988;Cinderfella;53716;0;4;3;1;75;0;0;0;0;0;0;0;0
8989;Damn Yankees!;51516;5.9;7;5;2;71;0;0;0;0;0;0;0;0
8990;The Delicate Delinquent;50301;0;3;1;2;33;0;0;0;0;0;0;0;0
8991;The Disorderly Orderly;58018;\N;\N;\N;\N;\N;\N;\N;\N;\N;\N;\N;\N;\N
8992;The Errand Boy;54853;5.7;8;4;4;50;0;0;0;0;0;0;0;0
8993;The Family Jewels;59166;0;4;3;1;75;0;0;0;0;0;0;0;0
8994;The Ladies Man;213790;3.2;71;8;63;11;3.3;18;3;15;16;2.6;2790;43
8995;Doing Time for Patsy Cline;119002;6.1;9;7;2;77;0;4;2;2;50;2.7;50;33
8996;Stateside;339727;4.3;46;11;35;23;4.1;20;4;16;20;3.4;526;62
8997;The Stooge;45192;0;1;0;1;0;0;0;0;0;0;0;0;0
8998;That's Entertainment!;72272;8;13;13;0;100;0;1;1;0;100;3.7;1093;79
8999;That's Entertainment, Part II;75323;0;3;2;1;66;0;0;0;0;0;0;0;0
9000;That's Entertainment! III;111408;0;0;0;0;0;0;0;0;0;0;0;0;0
9001;The Wackiest Ship in the Army;54453;0;2;1;1;50;0;0;0;0;0;0;0;0
9002;Alexander;346491;3.9;193;31;162;16;4;41;5;36;12;2.7;29540;43
9003;Conquest of Space;47947;0;3;2;1;66;0;0;0;0;0;0;0;0
9004;D.A.R.Y.L.;88979;3.7;6;2;4;33;0;0;0;0;0;0;0;0
9005;Fire in the Sky;106912;5.1;14;5;9;35;0;3;0;3;0;3.1;2891;56
9007;I'll Be Seeing You;36940;0;1;1;0;100;0;0;0;0;0;0;0;0
9008;The Invisible Man Returns;32635;5.9;9;8;1;88;0;0;0;0;0;0;0;0
9009;The Last Minute;275468;\N;\N;\N;\N;\N;\N;\N;\N;\N;\N;\N;\N;\N
9010;Jeux d'enfants;364517;5.2;78;34;44;43;5.1;26;10;16;38;4.2;14602;90
9011;Portrait of Jennie;40705;7.9;11;10;1;90;0;0;0;0;0;0;0;0
9012;Ruby Gentry;45109;6.9;6;4;2;66;0;1;1;0;100;3.1;162;43
9013;Secret Honor;88074;7.4;11;8;3;72;0;3;2;1;66;3.6;540;72
9014;Since You Went Away;37280;6.5;6;4;2;66;0;0;0;0;0;0;0;0
9015;A Slipping-Down Life;162662;4.7;65;17;48;26;4.5;24;7;17;29;3.2;316;49
9017;Oliver Twist;380599;0;0;0;0;0;0;0;0;0;0;0;0;0
9018;Control Room;391024;7.8;108;104;4;96;7.8;29;28;1;96;3.9;1430;86
9019;Celsius 41.11: The Temperature at Which the Brain... Begins to Die;424885;3.9;18;2;16;11;4;10;1;9;10;2.6;208;26
25736;Dr. Jekyll and Mr. Hyde;1159984;0;1;0;1;0;0;0;0;0;0;0;0;0
25737;Der Golem, wie er in die Welt kam;11237;7.9;8;8;0;100;0;1;1;0;100;0;0;0
25744;Häxan;13257;7.4;15;13;2;86;0;1;1;0;100;3.8;1213;80
25746;The Hunchback of Notre Dame;31455;8.3;9;9;0;100;0;0;0;0;0;0;0;0
25750;Sherlock Jr.;15324;0;0;0;0;0;0;0;0;0;0;0;0;0
25752;The Freshman;99615;7.3;32;30;2;93;7.2;8;7;1;87;3.1;2525;52
25753;Greed;15881;9.3;16;16;0;100;0;4;4;0;100;0;0;0
25755;The Phantom of the Opera;293508;5;165;54;111;32;4.6;37;10;27;27;3.7;70849;86
25757;The Jazz Singer;80948;3.7;20;3;17;15;0;3;1;2;33;3.4;857;71
25759;Oktyabr;18217;7.1;7;6;1;85;0;1;1;0;100;4;780;83
25762;Unknown;450340;5.1;44;17;27;38;4.6;17;4;13;23;3.3;6616;57
25763;Die Büchse der Pandora;18737;8.5;23;21;2;91;8.1;8;6;2;75;4.1;1316;88
25764;The Cameraman;18742;8.8;13;13;0;100;0;0;0;0;0;0;0;0
25766;The In Crowd;163676;2.7;52;1;51;1;2.4;14;0;14;0;2.6;925;41
25769;Steamboat Bill, Jr.;19421;9.1;15;15;0;100;0;0;0;0;0;0;0;0
25771;Un chien andalou;20530;9.2;18;18;0;100;0;3;3;0;100;4.1;5685;86
25773;Little Caesar;21079;7.6;17;15;2;88;0;2;2;0;100;3.6;1977;72
25774;L'âge d'or;21577;8.7;23;21;2;91;0;2;2;0;100;4;1547;82
25777;Monkey Business;22158;7.8;12;11;1;91;0;0;0;0;0;0;0;0
25783;The Return of Doctor X;31851;0;3;0;3;0;0;0;0;0;0;0;0;0
25788;Scarface;86250;7.5;50;44;6;88;8;5;4;1;80;4.1;121090;93
25793;Interview with the Vampire: The Vampire Chronicles;110148;5.8;45;26;19;57;4.6;10;4;6;40;3.7;77706;85
25795;Dinner at Eight;23948;8.6;16;16;0;100;0;0;0;0;0;0;0;0
25797;Gold Diggers of 1933;24069;9;8;8;0;100;0;0;0;0;0;0;0;0
25798;De fortabte sjæles ø;466449;0;0;0;0;0;0;0;0;0;0;0;0;0
25802;The Son of Kong;24593;4.6;9;3;6;33;0;0;0;0;0;0;0;0
25805;L'atalante;24844;8.7;23;23;0;100;8;7;7;0;100;4.3;1388;91
25825;Balls of Fury;424823;4.2;127;29;98;22;4.5;24;8;16;33;2.8;85682;36
25826;Libeled Lady;27884;7.9;9;7;2;77;0;0;0;0;0;0;0;0
25827;Mr. Deeds Goes to Town;27996;8.4;13;12;1;92;0;0;0;0;0;0;0;0
25828;The Petrified Forest;28096;7.6;8;8;0;100;0;0;0;0;0;0;0;0
25832;Wife vs. Secretary;28505;0;0;0;0;0;0;0;0;0;0;0;0;0
25833;Camille;28683;7.3;10;9;1;90;0;1;1;0;100;3.9;1060;82
25835;Dead End;308152;6.1;7;6;1;85;0;0;0;0;0;0;0;0
25839;Nothing Sacred;29322;9;9;9;0;100;0;0;0;0;0;0;0;0
25840;The Prisoner of Zenda;45053;0;1;0;1;0;0;0;0;0;0;0;0;0
25841;Stage Door Canteen;36384;0;2;1;1;50;0;0;0;0;0;0;0;0
25850;The Holiday;457939;0;0;0;0;0;0;0;0;0;0;0;0;0
25855;The Roaring Twenties;31867;7.3;10;10;0;100;0;0;0;0;0;0;0;0
25856;Wuthering Heights;32145;7.9;16;16;0;100;0;1;1;0;100;3.9;2525;84
25865;Letters from Iwo Jima;498380;8.2;196;178;18;90;8.3;40;37;3;92;3.8;73433;85
25866;The Sea Hawk;33028;8.7;12;12;0;100;0;0;0;0;0;0;0;0
25868;Ball of Fire;33373;8.3;23;23;0;100;0;4;4;0;100;4.1;864;89
25870;Here Comes Mr. Jordan;33712;7.4;15;15;0;100;0;0;0;0;0;0;0;0
25878;Across the Pacific;34428;0;2;2;0;100;0;0;0;0;0;0;0;0
25885;Prelude to War;35209;0;0;0;0;0;0;0;0;0;0;0;0;0
25886;Random Harvest;35238;7.6;9;8;1;88;0;0;0;0;0;0;0;0
25888;Action in the North Atlantic;35608;0;1;1;0;100;0;0;0;0;0;0;0;0
25891;Heaven Can Wait;35979;7.8;9;8;1;88;0;0;0;0;0;0;0;0
25893;The Memphis Belle: A Story of a Flying Fortress;36152;0;0;0;0;0;0;0;0;0;0;0;0;0
25898;Vredens dag;36506;8.5;20;20;0;100;7.5;5;5;0;100;4.2;732;92
25899;Cover Girl;36723;6.9;9;8;1;88;0;0;0;0;0;0;0;0
25900;The Curse of the Cat People;36733;7.3;23;20;3;86;0;3;2;1;66;0;0;0
25901;Henry V;97499;8.2;32;32;0;100;7.8;7;7;0;100;4;3619;87
25903;The Mask of Dimitrios;37055;0;2;2;0;100;0;0;0;0;0;0;0;0
25904;Ministry of Fear;37075;7.2;10;10;0;100;0;0;0;0;0;0;0;0
25905;The Miracle of Morgan's Creek;37077;8.1;20;18;2;90;0;3;3;0;100;3.9;836;83
25906;Mr. Skeffington;37094;6.4;6;4;2;66;0;0;0;0;0;0;0;0
25908;Passage to Marseille;37166;0;0;0;0;0;0;0;0;0;0;0;0;0
25914;Ivan Groznyy;37824;8.7;9;9;0;100;0;1;1;0;100;4.1;999;90
25916;They Were Expendable;38160;7.9;8;7;1;87;0;0;0;0;0;0;0;0
25923;Great Expectations;119223;5.4;32;12;20;37;5.4;7;3;4;42;3.4;10607;76
25924;Humoresque;38622;5.9;5;3;2;60;0;0;0;0;0;0;0;0
25927;The Strangers;482606;5;146;65;81;44;4.8;26;13;13;50;3.1;55773;48
25929;Nightmare Alley;39661;7.8;10;10;0;100;0;2;2;0;100;3.9;576;83
25930;Odd Man Out;39677;8;22;22;0;100;0;3;3;0;100;4;556;84
25931;Road to Rio;39776;6.8;6;6;0;100;0;0;0;0;0;0;0;0
25934;The Godfather;68646;9;66;66;0;100;8.4;11;11;0;100;4.4;172072;97
25937;Easter Parade;40308;7.3;17;15;2;88;0;4;4;0;100;3.8;2172;83
25938;Fort Apache;40369;8.3;13;13;0;100;0;0;0;0;0;0;0;0
25940;The Lady from Shanghai;439663;0;0;0;0;0;0;0;0;0;0;0;0;0
25941;Yi ge mo sheng nu ren de lai xin;424234;0;0;0;0;0;0;0;0;0;0;0;0;0
25942;Louisiana Story;40550;7.3;14;11;3;78;0;2;2;0;100;3.4;214;59
25943;The Naked City;40636;7.2;12;11;1;91;0;2;2;0;100;3.8;960;78
25945;They Live by Night;40872;\N;\N;\N;\N;\N;\N;\N;\N;\N;\N;\N;\N;\N
25946;The Three Musketeers;108333;4.8;24;7;17;29;0;3;0;3;0;3.2;13783;67
25947;Unfaithfully Yours;40919;7.8;14;13;1;92;0;2;2;0;100;3.9;650;86
25951;In the Good Old Summertime;41507;6.5;7;5;2;71;0;2;1;1;50;3.8;870;79
25952;A Letter to Three Wives;41587;8.5;10;10;0;100;0;1;1;0;100;3.8;921;82
25954;Orphée;41719;9.5;15;15;0;100;0;1;1;0;100;4.2;1007;91
25960;Les enfants terribles;42436;6.6;8;6;2;75;0;1;1;0;100;3.8;405;74
25961;The Gunfighter;42531;7.6;7;7;0;100;0;0;0;0;0;0;0;0
25962;King Solomon's Mines;42646;7.4;11;10;1;90;0;0;0;0;0;0;0;0
25963;Los olvidados;42804;8.8;31;29;2;93;0;4;3;1;75;4.4;1531;95
25964;Shûbun;42958;0;4;3;1;75;0;1;1;0;100;3.6;527;69
25971;Carrie;74285;8;42;38;4;90;6.4;7;4;3;57;3.3;23161;70
25975;Saikaku ichidai onna;45112;8.8;8;8;0;100;0;0;0;0;0;0;0;0
25977;Abbott and Costello Meet Dr. Jekyll and Mr. Hyde;45469;6;6;5;1;83;0;0;0;0;0;0;0;0
25993;Z Channel: A Magnificent Obsession;405496;8;13;13;0;100;0;0;0;0;0;0;0;0
25995;Miyamoto Musashi;47444;0;2;2;0;100;0;0;0;0;0;0;0;0
25996;A Star Is Born;29606;7.3;11;11;0;100;0;0;0;0;0;0;0;0
25999;Into the Wild;758758;7.5;181;149;32;82;7.2;37;27;10;72;4.2;82515;90
26002;Mr. Arkadin;48393;7.1;18;15;3;83;0;2;2;0;100;3.9;707;80
26005;Zoku Miyamoto Musashi: Ichijôji no kettô;48579;0;0;0;0;0;0;0;0;0;0;0;0;0
26007;Tuntematon sotilas;48752;0;0;0;0;0;0;0;0;0;0;0;0;0
26012;Miyamoto Musashi kanketsuhen: kettô Ganryûjima;49710;0;0;0;0;0;0;0;0;0;0;0;0;0
26038;Teacher's Pet;350194;6.5;72;54;18;75;6.7;25;19;6;76;2.8;370;38
26048;Ningen no jôken;53115;0;0;0;0;0;0;0;0;0;0;0;0;0
26049;Nobi;53121;7.8;13;13;0;100;0;4;4;0;100;4.2;428;91
26052;Pickpocket;53168;9.3;19;19;0;100;0;2;2;0;100;4.1;1733;88
26055;Ukigusa;53390;8.4;20;19;1;95;0;3;3;0;100;4.2;745;91
26059;Onna ga kaidan wo agaru toki;54144;8.2;13;13;0;100;0;0;0;0;0;0;0;0
26064;Warui yatsu hodo yoku nemuru;54460;7.7;16;16;0;100;0;3;3;0;100;4.1;1723;91
26067;The Deadly Companions;54795;6.4;5;4;1;80;0;1;0;1;0;3.2;166;38
26073;Ningen no jôken;55233;0;0;0;0;0;0;0;0;0;0;0;0;0
26078;Advise & Consent;55728;7.7;10;8;2;80;0;2;1;1;50;3.9;594;88
26079;David and Lisa;55892;7.1;10;8;2;80;0;3;2;1;66;0;0;0
26082;Seppuku;56058;0;3;3;0;100;0;1;1;0;100;4.5;1585;96
26084;The Music Man;56262;7.9;15;14;1;93;0;0;0;0;0;0;0;0
26085;Mutiny on the Bounty;26752;8.2;28;26;2;92;7.5;6;5;1;83;3.7;1846;79
26094;L'eclisse;56736;7.4;15;13;2;86;0;4;3;1;75;4.2;1924;90
26096;The Cardinal;56907;6;10;6;4;60;0;2;1;1;50;3.4;252;53
26101;McLintock!;57298;0;3;2;1;66;0;0;0;0;0;0;0;0
26107;The Prize Winner of Defiance, Ohio;406158;6.1;79;46;33;58;6.1;28;14;14;50;3.2;7811;55
26110;36 Hours;57809;0;1;1;0;100;0;0;0;0;0;0;0;0
26111;Becket;57877;7.3;24;18;6;75;6.4;9;6;3;66;4.1;1602;88
26112;Behold a Pale Horse;57879;7;7;6;1;85;0;2;1;1;50;3.4;71;65
26113;The Best Man;430919;0;1;1;0;100;0;0;0;0;0;0;0;0
26116;Hush...Hush, Sweet Charlotte;58213;7.3;19;16;3;84;0;0;0;0;0;0;0;0
26117;Natural Born Killers;110632;6;29;15;14;51;5.9;7;3;4;42;3.5;39062;80
26119;The Naked Kiss;58390;7.4;9;8;1;88;0;0;0;0;0;0;0;0
26122;Onibaba;58430;6.6;11;9;2;81;0;3;1;2;33;4.1;1496;91
26123;Robin and the 7 Hoods;58529;5.9;9;4;5;44;0;0;0;0;0;0;0;0
26124;Robinson Crusoe on Mars;58530;6.4;12;11;1;91;0;0;0;0;0;0;0;0
26128;What a Way to Go!;58743;4.1;5;0;5;0;0;2;0;2;0;3.7;212;67
26131;La battaglia di Algeri;58946;9;70;69;1;98;8.9;17;17;0;100;4.4;4133;95
26133;A Charlie Brown Christmas;59026;8.5;12;11;1;91;0;0;0;0;0;0;0;0
26134;Dracula: Prince of Darkness;59127;6.3;12;10;2;83;0;1;0;1;0;3.3;1485;63
26136;The Hallelujah Trail;59250;0;3;2;1;66;0;0;0;0;0;0;0;0
26138;House on Haunted Hill;51744;7;19;18;1;94;0;2;1;1;50;3.4;4234;70
26139;In Harm's Way;59309;5.2;10;5;5;50;0;0;0;0;0;0;0;0
26142;Major Dundee;59418;7.3;30;29;1;96;7.3;14;14;0;100;3.3;808;61
26144;Operation Crossbow;59549;5.7;5;3;2;60;0;0;0;0;0;0;0;0
26147;A Thousand Clowns;59798;6.9;9;7;2;77;0;0;0;0;0;0;0;0
26148;Strangers on a Train;44079;8.7;40;39;1;97;7.3;5;4;1;80;4;9106;91
26150;Andrey Rublyov;60107;8.7;14;13;1;92;0;2;1;1;50;4.5;3531;94
26151;Au hasard Balthazar;60138;9.2;29;29;0;100;9;7;7;0;100;4.2;1694;87
26152;Batman;60153;6.2;22;18;4;81;0;1;1;0;100;3;13951;51
26155;Khartoum;60588;6.6;9;8;1;88;0;0;0;0;0;0;0;0
26158;Ostre sledované vlaky;60802;7.7;14;14;0;100;0;1;1;0;100;4;1286;87
26159;Tôkyô nagaremono;61101;7.5;7;7;0;100;0;1;1;0;100;0;0;0
26163;Dont Look Back;61589;8.4;17;17;0;100;0;4;4;0;100;4.2;1544;91
26170;La mariée était en noir;61955;7.6;9;9;0;100;0;3;3;0;100;3.7;1464;78
26171;Play Time;62136;8.7;34;34;0;100;8.3;9;9;0;100;4.3;2267;91
26172;Grosse Pointe Blank;119229;7.1;57;44;13;77;6.5;15;11;4;73;3.7;17815;85
26174;Shooting Dogs;420901;7.2;60;50;10;83;6.5;18;13;5;72;3.9;11089;81
26176;Titicut Follies;62374;7.2;5;5;0;100;0;1;1;0;100;4.2;367;91
26178;Two for the Road;62407;7.2;12;10;2;83;0;0;0;0;0;0;0;0
26181;The War Wagon;62472;0;0;0;0;0;0;0;0;0;0;0;0;0
26185;Dracula Has Risen from the Grave;62909;6.6;13;10;3;76;0;0;0;0;0;0;0;0
26187;Head;63049;0;0;0;0;0;0;0;0;0;0;0;0;0
26189;I Love You, Alice B. Toklas!;63115;0;0;0;0;0;0;0;0;0;0;0;0;0
26198;Yours, Mine and Ours;443295;3.3;105;6;99;5;3.7;28;1;27;3;3.2;36270;64
26199;Alice's Restaurant;64002;6;14;9;5;64;0;4;3;1;75;3.4;935;61
26203;Colossus: The Forbin Project;64177;0;4;4;0;100;0;0;0;0;0;0;0;0
26208;Ma nuit chez Maud;64612;8;15;14;1;93;0;2;2;0;100;4.1;2027;85
26211;More;64694;0;3;1;2;33;0;1;0;1;0;3.7;386;71
26222;Dodesukaden;65649;5.8;6;3;3;50;0;0;0;0;0;0;0;0
26225;Le genou de Claire;65772;8.4;19;18;1;94;0;3;3;0;100;3.9;808;82
26226;Hi, Mom!;65836;7.2;8;5;3;62;0;0;0;0;0;0;0;0
26228;En kärlekshistoria;65955;0;0;0;0;0;0;0;0;0;0;0;0;0
26230;On a Clear Day You Can See Forever;66181;6.3;8;8;0;100;0;0;0;0;0;0;0;0
26231;Performance;66214;7.4;19;17;2;89;0;1;0;1;0;3.9;1292;81
26240;The Beguiled;66819;6.9;10;9;1;90;0;0;0;0;0;0;0;0
26241;The Devil's Advocate;118971;6.2;43;28;15;65;5.8;10;4;6;40;3.4;30966;78
26242;Duel;67023;7.7;36;31;5;86;0;2;1;1;50;3.6;6809;80
26246;Johnny Got His Gun;67277;6.6;20;14;6;70;0;4;1;3;25;4.1;1730;88
26249;Lo chiamavano Trinità...;67355;0;2;0;2;0;0;1;0;1;0;3.7;1690;79
26251;Mon oncle Antoine;67439;0;4;4;0;100;0;0;0;0;0;0;0;0
26258;El topo;67866;6.8;31;23;8;74;6.8;6;4;2;66;4.1;4272;86
26265;Dr. Phibes Rises Again;68503;5.5;9;4;5;44;0;0;0;0;0;0;0;0
26269;Kozure ôkami: Ko wo kashi ude kashi tsukamatsuru;68815;\N;\N;\N;\N;\N;\N;\N;\N;\N;\N;\N;\N;\N
26270;Kozure Ôkami: Sanzu no kawa no ubaguruma;68816;0;4;4;0;100;0;0;0;0;0;0;0;0
26271;Lady Sings the Blues;68828;6.7;12;9;3;75;0;4;3;1;75;3.9;1795;85
26277;Slither;439815;6.9;129;110;19;85;6.4;29;22;7;75;3.2;31835;58
26280;Traffic;181865;8;149;136;13;91;7.8;39;36;3;92;3.5;26217;81
26283;Charley Varrick;69865;7.4;7;6;1;85;0;0;0;0;0;0;0;0
26285;Dark Star;69945;6.5;21;17;4;80;0;4;2;2;50;3.4;3930;65
26289;Emperor of the North Pole;70030;0;4;3;1;75;0;2;1;1;50;3.8;503;81
26294;Il mio nome è Nessuno;70215;0;1;1;0;100;0;0;0;0;0;0;0;0
26301;Save the Tiger;70640;7;10;9;1;90;0;1;1;0;100;3.5;617;63
26302;Scarecrow;70643;7.7;12;8;4;66;0;3;1;2;33;3.7;1738;79
26303;The Banger Sisters;280460;5.3;140;66;74;47;5.1;34;14;20;41;2.7;4139;45
26306;Theater of Blood;70791;7.4;23;22;1;95;0;2;2;0;100;3.6;1253;75
26313;California Split;71269;7.3;11;10;1;90;7.1;5;4;1;80;3.8;753;81
26318;Le fantôme de la liberté;71487;8.3;16;14;2;87;0;4;4;0;100;4.1;1386;90
26323;The Groove Tube;71583;3.8;8;1;7;12;0;0;0;0;0;0;0;0
26326;The Holy Mountain;71615;6.9;18;15;3;83;7.5;6;6;0;100;4.3;3854;90
26336;The Adventure of Sherlock Holmes' Smarter Brother;72608;0;2;1;1;50;0;0;0;0;0;0;0;0
26339;Dolemite;72895;4.6;5;2;3;40;0;0;0;0;0;0;0;0
26345;The Great Waldo Pepper;73075;5.9;7;5;2;71;0;1;1;0;100;3.2;560;50
26349;Night Moves;73453;7.4;17;14;3;82;0;4;4;0;100;0;0;0
26350;Professione: reporter;73580;8.1;64;58;6;90;9;15;15;0;100;4;2771;85
26359;Novecento;74084;5.9;14;6;8;42;0;3;0;3;0;4.1;2572;86
26360;L'argent de poche;74152;7.7;11;11;0;100;0;3;3;0;100;4;793;85
26364;From Noon Till Three;74553;0;1;0;1;0;0;0;0;0;0;0;0;0
26366;Harlan County U.S.A.;74605;9.1;7;7;0;100;0;2;2;0;100;4.2;797;88
26371;The Missouri Breaks;74906;6.5;18;15;3;83;0;3;1;2;33;3.3;1054;61
26375;Silver Streak;75223;6.4;18;15;3;83;0;1;1;0;100;3.4;1982;68
26379;Jesus of Nazareth;75520;0;3;3;0;100;0;0;0;0;0;0;0;0
26386;High Anxiety;76141;6.4;26;19;7;73;0;1;0;1;0;3.4;4006;67
26388;The Hound of the Baskervilles;52905;7.8;11;11;0;100;0;0;0;0;0;0;0;0
26391;Gangs of New York;217505;7.1;200;149;51;74;6.5;42;28;14;66;3.5;35768;76
26393;Sorcerer;76740;7.1;15;12;3;80;0;1;1;0;100;3.8;787;79
26394;The Turning Point;76843;5.9;11;6;5;54;0;0;0;0;0;0;0;0
26398;Capricorn One;77294;6;17;10;7;58;0;1;0;1;0;0;0;0
26404;In Praise of Older Women;77728;\N;\N;\N;\N;\N;\N;\N;\N;\N;\N;\N;\N;\N
26413;Se ying diu sau;78252;0;2;1;1;50;0;0;0;0;0;0;0;0
26414;Wedding Crashers;396269;6.7;180;135;45;75;6.9;38;28;10;73;3.5;215271;70
26422;Hair;79261;7.2;15;14;1;93;0;0;0;0;0;0;0;0
26425;The In-Laws;314786;4.9;126;44;82;34;4.9;35;12;23;34;2.9;2546;42
26431;Opening Night;79672;7.8;21;20;1;95;0;3;3;0;100;4.1;1012;91
26462;Bad Boys;112442;4.8;41;16;25;39;3.7;9;1;8;11;3.5;67658;79
26464;Blue Thunder;85255;6.2;19;15;4;78;0;0;0;0;0;0;0;0
26465;D.C. Cab;85387;0;2;0;2;0;0;0;0;0;0;0;0;0
26472;El Norte;85482;7.5;9;8;1;88;0;0;0;0;0;0;0;0
26476;Merry Christmas Mr. Lawrence;85933;6.2;19;15;4;78;5;5;2;3;40;3.9;1571;83
26479;The Pirates of Penzance;86112;7.3;12;10;2;83;0;0;0;0;0;0;0;0
26483;Rock & Rule;86203;0;3;1;2;33;0;0;0;0;0;0;0;0
26485;Rumble Fish;86216;6;23;16;7;69;5;5;2;3;40;3.6;6328;78
26487;Star 80;86355;7.3;9;8;1;88;0;1;1;0;100;3.3;628;62
26488;The Star Chamber;86356;6;14;10;4;71;0;1;0;1;0;3;539;40
26491;To Be or Not to Be;35446;8.7;34;33;1;97;7;5;4;1;80;4.2;1733;92
26492;Twilight Zone: The Movie;86491;5.8;30;20;10;66;0;4;2;2;50;3.2;7313;56
26494;SubUrbia;120238;6.3;21;13;8;61;6.4;6;3;3;50;3.3;1247;66
26495;Yellowbeard;86618;5;9;2;7;22;0;1;0;1;0;3.3;1410;63
26497;Another Country;86904;0;3;2;1;66;0;0;0;0;0;0;0;0
26498;Boy Meets Girl;86994;0;1;1;0;100;0;0;0;0;0;0;0;0
26504;Cloak & Dagger;87065;5;5;2;3;40;0;0;0;0;0;0;0;0
26509;Electric Dreams;87197;5.4;5;2;3;40;0;1;1;0;100;3.6;758;72
26513;The Ice Pirates;87451;3.9;9;1;8;11;0;0;0;0;0;0;0;0
26521;Racing with the Moon;87968;6.1;10;6;4;60;0;3;3;0;100;3.3;795;57
26524;The Times of Harvey Milk;88275;8.3;16;16;0;100;0;1;1;0;100;4.2;1883;93
26527;¿Qué he hecho yo para merecer esto!!;88461;7.6;6;6;0;100;0;1;1;0;100;3.8;1849;80
26544;Heaven Help Us;89264;5.6;5;2;3;40;0;1;0;1;0;3.5;872;67
26547;Ging chat goo si;89374;6.9;12;10;2;83;0;1;1;0;100;3.7;4759;84
26550;Mishima: A Life in Four Chapters;89603;7.4;20;19;1;95;0;2;2;0;100;4.2;932;91
26554;The Quiet Earth;89869;6.2;8;5;3;62;0;0;0;0;0;0;0;0
26555;Spies Like Us;90056;4.6;18;8;10;44;0;0;0;0;0;0;0;0
26558;The Stuff;90094;6.1;8;5;3;62;0;1;0;1;0;3.1;1354;48
26561;Vision Quest;90270;5.4;12;7;5;58;0;1;1;0;100;3.5;1468;71
26562;White Nights;90319;5.1;13;6;7;46;0;1;0;1;0;3.4;1109;74
26564;'Round Midnight;90557;8.1;17;17;0;100;8.3;6;6;0;100;4.1;809;88
26566;The Best of Times;90713;4.7;12;4;8;33;0;1;0;1;0;2.9;1014;41
26567;Club Paradise;90856;0;0;0;0;0;0;0;0;0;0;0;0;0
26577;Nobody's Fool;91642;0;4;0;4;0;0;1;0;1;0;3;289;43
26578;Offret;91670;7.2;25;20;5;80;0;4;3;1;75;4.4;1787;92
26585;Ying hung boon sik;92263;7.3;14;13;1;92;0;0;0;0;0;0;0;0
26599;La ley del deseo;93412;7.4;11;11;0;100;0;2;2;0;100;3.8;1875;79
26603;Prince of Darkness;93777;5.1;19;9;10;47;0;1;0;1;0;3.3;3606;59
26606;Sien nui yau wan;93978;7.8;8;6;2;75;0;0;0;0;0;0;0;0
26614;The Bourne Identity;258463;7;180;148;32;82;6.9;37;30;7;81;3.9;125823;91
26616;Cobra Verde;94888;6.9;14;12;2;85;0;3;2;1;66;3.7;950;74
26629;Killer Klowns from Outer Space;95444;5.6;13;9;4;69;0;0;0;0;0;0;0;0
26649;Lonesome Dove;96639;\N;\N;\N;\N;\N;\N;\N;\N;\N;\N;\N;\N;\N
26662;Majo no takkyûbin;97814;0;0;0;0;0;0;0;0;0;0;0;0;0
26663;Monsieur Hire;97904;8;11;11;0;100;0;2;2;0;100;3.9;441;84
26676;Almost an Angel;99018;3.9;7;2;5;28;0;1;0;1;0;0;0;0
26677;Black Rainbow;99143;0;3;3;0;100;0;0;0;0;0;0;0;0
26680;Cry-Baby;99329;6.7;37;30;7;81;6.2;6;4;2;66;3.3;38084;75
26681;Die xue jie tou;99426;8.4;5;5;0;100;0;0;0;0;0;0;0;0
26682;New York Beat Movie;208993;5.7;21;15;6;71;6.7;8;7;1;87;3.7;653;71
26686;Ghost Dad;99654;2.2;19;1;18;5;0;4;1;3;25;2.5;2569;38
26688;Hard to Kill;99739;3.7;10;3;7;30;0;1;0;1;0;2.7;4865;52
26693;It;99864;5.6;10;7;3;70;0;0;0;0;0;0;0;0
26694;Ju Dou;99902;8.3;14;14;0;100;0;3;3;0;100;3.9;1328;86
26695;The Krays;99951;6.4;12;10;2;83;0;2;2;0;100;3.7;1447;82
26696;Lionheart;100029;4;11;3;8;27;0;3;1;2;33;3;2754;54
26698;Narrow Margin;100224;6;11;7;4;63;0;2;0;2;0;3;630;42
26700;Nuns on the Run;100280;4.7;18;8;10;44;0;2;1;1;50;2.9;1378;48
26704;State of Grace;100685;6.8;15;13;2;86;0;2;2;0;100;3.7;2900;79
26713;A Fei zheng chuan;101258;7.7;29;26;3;89;8.1;13;12;1;92;4;3441;87
26726;Predator;93773;6.8;37;28;9;75;0;4;2;2;50;3.5;52908;83
26729;Hearts of Darkness: A Filmmaker's Apocalypse;102015;8.5;24;24;0;100;8.2;6;6;0;100;4.1;3043;90
26734;A Kiss Before Dying;49414;0;4;3;1;75;0;0;0;0;0;0;0;0
26743;Omohide poro poro;102587;0;3;3;0;100;0;0;0;0;0;0;0;0
26744;Once Around;102590;5.9;18;12;6;66;5.4;5;3;2;60;3.5;705;71
26745;Other People's Money;102609;4.6;14;5;9;35;0;2;1;1;50;2.8;936;42
26746;Out for Justice;102614;3.6;20;4;16;20;0;4;1;3;25;3;3054;57
26750;Quigley Down Under;102744;5.5;15;9;6;60;0;2;0;2;0;3.2;3350;67
26758;Tous les matins du monde;103110;7.2;9;8;1;88;0;2;1;1;50;4.1;1291;87
26770;Diggstown;104107;5.5;13;7;6;53;0;0;0;0;0;0;0;0
26776;Kurenai no buta;104652;8.2;12;12;0;100;0;0;0;0;0;0;0;0
26778;Ladybugs;104670;3.7;13;2;11;15;0;1;0;1;0;2.6;2093;41
26782;The Mambo Kings;104802;6.6;19;15;4;78;0;2;2;0;100;3.3;1188;61
26788;Qiu Ju da guan si;105197;8;14;12;2;85;0;2;1;1;50;3.9;768;83
26791;Shining Through;105391;4.4;13;4;9;30;0;2;1;1;50;3.4;1160;71
26792;Sidekick;410603;7.3;13;13;0;100;0;0;0;0;0;0;0;0
26796;Un coeur en hiver;105682;7.7;13;11;2;84;0;2;2;0;100;4.1;1098;88
26803;Änglagård;105916;7.2;5;4;1;80;0;1;1;0;100;3.7;254;72
26810;Bad Boy Bubby;106341;6.9;6;5;1;83;0;1;0;1;0;4;2270;87
26811;Bai fa mo nu zhuan;106342;8.1;7;7;0;100;0;0;0;0;0;0;0;0
26812;Barbarians at the Gate;106356;6;6;4;2;66;0;0;0;0;0;0;0;0
26819;Kakushi-toride no san-akunin;51808;8.6;22;22;0;100;0;2;2;0;100;4.1;6021;90
26828;Mr. Nanny;107612;2.4;14;1;13;7;0;3;0;3;0;2.3;4808;38
26834;Philadelphia Experiment II;107819;0;0;0;0;0;0;0;0;0;0;0;0;0
26838;The Snapper;108170;7.4;31;30;1;96;7.8;7;7;0;100;0;0;0
26840;Sonatine;108188;7.3;24;21;3;87;6.4;6;4;2;66;0;0;0
26841;Splitting Heirs;108207;3.8;12;1;11;8;0;2;0;2;0;2.6;577;34
26842;Tai ji: Zhang San Feng;108281;0;0;0;0;0;0;0;0;0;0;0;0;0
26861;Freaked;109838;5.4;15;7;8;46;0;1;1;0;100;3.3;1649;59
26865;Jing wu ying xiong;110200;7.9;11;11;0;100;0;0;0;0;0;0;0;0
26870;Major League II;110442;3.3;21;1;20;4;2.7;6;0;6;0;2.8;4428;45
26875;Una pura formalità;110917;7;5;4;1;80;0;1;0;1;0;4.2;605;91
26898;Gonin;113194;6.8;6;5;1;83;0;0;0;0;0;0;0;0
26901;The Last of the Mohicans;104691;8;32;31;1;96;7.9;7;7;0;100;3.6;34073;84
26903;Mimi wo sumaseba;113824;7.4;9;8;1;88;0;0;0;0;0;0;0;0
26915;Tromeo and Juliet;114733;0;3;2;1;66;0;0;0;0;0;0;0;0
26934;Sik san;116426;0;3;3;0;100;0;0;0;0;0;0;0;0
26939;Kauas pilvet karkaavat;116752;7.1;9;9;0;100;7.2;5;5;0;100;4.1;737;90
26950;Sgt. Kabukiman N.Y.P.D.;117609;0;0;0;0;0;0;0;0;0;0;0;0;0
26965;Beautiful Boxer;401248;6.7;35;28;7;80;6.7;12;9;3;75;3.9;879;88
26974;Gummo;119237;4.7;35;12;23;34;4.1;6;1;5;16;3.6;5657;76
26976;Chicago Cab;119278;5.3;8;4;4;50;0;1;1;0;100;3.2;473;51
26982;Men with Guns;119657;7.6;26;23;3;88;0;4;4;0;100;3.9;476;84
26985;Nirvana;119794;0;2;0;2;0;0;0;0;0;0;0;0;0
26989;Perdita Durango;119879;5.3;9;3;6;33;0;0;0;0;0;0;0;0
26996;Safe House;120051;0;1;0;1;0;0;0;0;0;0;0;0;0
27005;Interview;480269;6;121;70;51;57;5.8;31;15;16;48;3.2;14637;53
27020;Gia;123865;\N;\N;\N;\N;\N;\N;\N;\N;\N;\N;\N;\N;\N
27022;Thursday;124901;3.9;6;2;4;33;0;0;0;0;0;0;0;0
27109;Shurayukihime;158714;0;2;2;0;100;0;0;0;0;0;0;0;0
27114;Takedown;159784;0;0;0;0;0;0;0;0;0;0;0;0;0
27186;Kirikou et la sorcière;181627;7.4;24;23;1;95;7.8;8;8;0;100;3.9;1078;85
27193;Taxi 2;183869;0;3;2;1;66;0;0;0;0;0;0;0;0
27255;Bad ma ra khahad bord;209463;8.4;25;24;1;96;0;4;4;0;100;3.9;888;82
27266;2046;212712;7.4;106;89;17;83;7.3;30;25;5;83;3.9;14211;84
27271;Gohatto;213682;6.6;21;14;7;66;0;2;2;0;100;3.5;1242;70
27316;Ruang talok 69;235154;6.6;17;16;1;94;0;3;3;0;100;3.4;613;74
27317;Ôdishon;235198;7;61;47;14;77;6.6;12;9;3;75;3.8;14430;81
27338;The Hole;242527;5.8;15;8;7;53;0;1;0;1;0;3.1;5670;58
27340;The Sleeping Dictionary;242888;0;3;0;3;0;0;0;0;0;0;0;0;0
27362;Kabhi Khushi Kabhie Gham...;248126;0;0;0;0;0;0;0;0;0;0;0;0;0
27368;Astérix & Obélix: Mission Cléopâtre;250223;6.3;7;6;1;85;0;1;0;1;0;3.6;4436;78
27370;Late Night Shopping;250491;5.7;5;3;2;60;0;0;0;0;0;0;0;0
27376;Der Tunnel;251447;6.9;25;21;4;84;6.9;12;10;2;83;4;713;92
27391;The Laramie Project;257850;7;12;11;1;91;0;1;1;0;100;3.7;1662;78
27397;Gongdong gyeongbi guyeok JSA;260991;6.9;12;9;3;75;0;3;1;2;33;4;2656;90
27402;Dagon;264508;5.4;9;5;4;55;0;0;0;0;0;0;0;0
27408;Ripley's Game;265651;7.2;21;20;1;95;0;4;4;0;100;3.4;2169;63
27410;Conspiracy;1043838;0;2;0;2;0;0;1;0;1;0;2.5;968;22
27416;Jalla! Jalla!;269389;5.4;8;4;4;50;0;1;0;1;0;3.7;1390;76
27432;The Beautiful Country;273108;0;0;0;0;0;0;0;0;0;0;0;0;0
27434;Darkness;273517;2.7;52;2;50;3;2;11;0;11;0;2.6;4153;37
27436;Mockingbird Don't Sing;273822;0;1;0;1;0;0;0;0;0;0;0;0;0
27450;Blueberry;276830;4.2;7;2;5;28;0;0;0;0;0;0;0;0
27456;Shackleton's Antarctic Adventure;280105;0;0;0;0;0;0;0;0;0;0;0;0;0
27491;Kairo;286751;6.8;48;35;13;72;6.4;14;10;4;71;3.3;3346;61
27509;Carolina;289889;0;2;1;1;50;0;0;0;0;0;0;0;0
27513;Hundstage;290661;5.4;33;16;17;48;6.5;11;7;4;63;3.6;603;70
27523;Yeopgijeogin geunyeo;293715;0;2;2;0;100;0;0;0;0;0;0;0;0
27528;The Warriors;80120;7.4;30;28;2;93;0;0;0;0;0;0;0;0
27537;Nothing Is Private;787523;5.3;110;52;58;47;5;33;16;17;48;3.4;2878;61
27555;Fubar;302585;6.2;11;6;5;54;0;1;1;0;100;0;0;0
27563;Katakuri-ke no kôfuku;304262;0;0;0;0;0;0;0;0;0;0;0;0;0
27564;Sex Is Comedy;304678;6.4;46;32;14;69;6.5;19;12;7;63;3.1;1109;52
27573;Stratosphere Girl;306097;\N;\N;\N;\N;\N;\N;\N;\N;\N;\N;\N;\N;\N
27584;Dead End;308152;6.1;7;6;1;85;0;0;0;0;0;0;0;0
27587;Pure;308772;\N;\N;\N;\N;\N;\N;\N;\N;\N;\N;\N;\N;\N
27592;Boksuneun naui geot;310775;6.2;53;29;24;54;5.7;12;6;6;50;4;10632;86
27604;Jisatsu sâkuru;312843;5.7;6;3;3;50;0;0;0;0;0;0;0;0
27608;Immortel (ad vitam);314063;5.1;7;3;4;42;0;0;0;0;0;0;0;0
27611;Battlestar Galactica;314979;0;1;1;0;100;0;0;0;0;0;0;0;0
27618;A Sound of Thunder;318081;2.9;96;6;90;6;2.9;23;1;22;4;2.4;12447;24
27620;Stupeur et tremblements;318725;7.3;35;32;3;91;7.5;15;13;2;86;3.7;726;74
27627;Oasis;320193;7.7;28;25;3;89;7.9;12;12;0;100;4;289;85
27636;Herr Lehmann;322545;0;0;0;0;0;0;0;0;0;0;0;0;0
27644;Ricordati di me;323807;5.8;33;18;15;54;5.9;9;5;4;55;3.4;361;58
27648;Bright Young Things;325123;6.3;107;70;37;65;6.5;32;21;11;65;3.5;1866;64
27660;The Animatrix;328832;6.7;17;15;2;88;0;1;1;0;100;3.4;35884;68
27664;The Brown Bunny;330099;5.1;89;39;50;43;4.8;30;13;17;43;2.9;2486;48
27674;11:14;331811;6.8;11;11;0;100;0;1;1;0;100;3.6;6342;75
27679;Xiao cheng zhi chun;332831;7.4;35;31;4;88;7.6;11;11;0;100;3.5;338;65
27685;Bring It on Again;334965;0;0;0;0;0;0;0;0;0;0;0;0;0
27689;Les rivières pourpres II - Les anges de l'apocalypse;337103;0;2;0;2;0;0;0;0;0;0;0;0;0
27700;Ondskan;338309;6.6;36;24;12;66;5.8;11;5;6;45;3.9;2971;85
27706;Lemony Snicket's A Series of Unfortunate Events;339291;6.6;154;109;45;70;6.6;32;19;13;59;3.2;60437;61
27716;De grønne slagtere;342492;6.3;27;17;10;62;5.6;12;5;7;41;3.9;1464;84
27721;Un long dimanche de fiançailles;344510;7.4;142;110;32;77;7.3;35;28;7;80;3.9;22939;84
27722;Ruang rak noi nid mahasan;345549;7.4;40;36;4;90;7.8;11;11;0;100;4.1;3086;89
27727;Gegen die Wand;347048;0;0;0;0;0;0;0;0;0;0;0;0;0
27728;Innocence;347246;6.3;94;61;33;64;6.4;24;17;7;70;3.8;8464;80
27731;Neko no ongaeshi;347618;7;17;16;1;94;0;2;2;0;100;3.9;9609;81
27734;Country of My Skull;349260;4.8;81;18;63;22;5.1;28;6;22;21;3.3;748;59
27735;Unstoppable;349889;\N;\N;\N;\N;\N;\N;\N;\N;\N;\N;\N;\N;\N
27736;Te doy mis ojos;350193;7.6;33;30;3;90;7.2;11;9;2;81;3.6;1070;78
27741;Tasogare Seibei;351817;8.2;68;67;1;98;7.9;22;22;0;100;4.2;3512;93
27744;La finestra di fronte;352343;6.1;65;41;24;63;6.2;27;19;8;70;4;1928;85
27746;Ginger Snaps: Unleashed;353489;6.9;15;14;1;93;0;3;3;0;100;3.2;5388;65
27765;Trauma;363143;4.7;15;5;10;33;0;2;0;2;0;2.6;731;28
27768;Confidences trop intimes;363532;7.3;100;87;13;87;7.2;32;27;5;84;3.4;696;65
27772;Ju-on;364385;0;0;0;0;0;0;0;0;0;0;0;0;0
27773;Oldeuboi;364569;7.3;127;102;25;80;7.1;30;24;6;80;4.3;41925;94
27776;Feux rouges;365190;7.2;85;71;14;83;7.4;31;26;5;83;3.4;433;64
27778;Ginger Snaps Back: The Beginning;365265;0;4;3;1;75;0;0;0;0;0;0;0;0
27783;El abrazo partido;366137;6.7;47;39;8;82;7.3;17;15;2;88;3.7;516;72
27788;The Jacket;366627;5.4;157;68;89;43;5.1;32;11;21;34;3.5;22896;72
27790;20 Million Miles to Earth;50084;6.4;8;7;1;87;0;0;0;0;0;0;0;0
27792;The Saddest Music in the World;366996;7.1;99;77;22;77;6.9;27;20;7;74;3.7;1821;77
27797;O Homem Que Copiava;367859;6.2;32;21;11;65;5.4;12;5;7;41;3.9;896;83
27801;Ong-bak;368909;6.9;102;87;15;85;6.5;25;19;6;76;3.8;16639;85
27803;Mar adentro;369702;7.6;128;107;21;83;7.5;36;29;7;80;4.1;10334;92
27808;Spanglish;371246;5.9;162;85;77;52;5.8;40;21;19;52;3;21732;62
27812;Festival Express;372279;7.6;76;73;3;96;7.7;28;28;0;100;3.8;857;79
27815;Les choristes;372824;6.5;105;71;34;67;6.3;29;18;11;62;4.1;8414;92
27816;Saints and Soldiers;373283;6.4;33;21;12;63;5.9;13;8;5;61;3.9;4284;81
27820;Die Geschichte vom weinenden Kamel;373861;7.6;102;96;6;94;7.6;29;28;1;96;4;1514;84
27821;The Interpreter;373926;6;189;109;80;57;6.2;40;25;15;62;3.1;14657;56
27822;Open Water;374102;6.6;189;136;53;71;7.1;38;30;8;78;2.4;8148;31
27826;Touch of Pink;374277;5;61;22;39;36;5;20;8;12;40;3.4;1401;63
27828;De zaak Alzheimer;374345;6.8;67;56;11;83;6.9;22;19;3;86;3.7;1053;77
27830;Bobby Jones: Stroke of Genius;375104;4.6;74;19;55;25;4.3;28;8;20;28;3.4;708;63
27831;Layer Cake;375912;7.1;133;108;25;81;7.4;31;26;5;83;3.7;37167;83
27833;Silver City;376890;\N;\N;\N;\N;\N;\N;\N;\N;\N;\N;\N;\N;\N
27834;Vozvrashchenie;376968;0;0;0;0;0;0;0;0;0;0;0;0;0
27837;Flight of the Phoenix;377062;4.8;115;34;81;29;4.4;27;5;22;18;3;7566;48
27838;Mean Creek;377091;7.3;117;105;12;89;7.5;35;32;3;91;3.6;5554;79
27839;The Ring Two;377109;4.4;178;36;142;20;4.7;37;10;27;27;2.8;39779;54
27841;The Visual Bible: The Gospel of John;377992;5;50;18;32;36;4.9;16;4;12;25;4.3;425;88
27843;Machuca;378284;7.5;37;33;4;89;7.7;11;10;1;90;4.1;1842;90
27846;The Corporation;379225;7.4;107;97;10;90;7.6;30;28;2;93;4;5815;89
27850;The Yes Men;379593;7;82;70;12;85;6.8;28;22;6;78;3.4;1444;65
27851;Ae Fond Kiss...;380366;7.4;24;21;3;87;0;4;4;0;100;3.7;1269;73
27857;Så som i himmelen;382330;6.7;6;5;1;83;0;2;2;0;100;4.3;3319;90
27864;She Hate Me;384533;3.9;99;19;80;19;3.8;36;7;29;19;3.3;1915;61
27865;Azumi;384819;5.4;32;15;17;46;4.5;11;3;8;27;3.9;4714;82
27866;In My Father's Den;385017;7.3;9;9;0;100;0;1;1;0;100;4.1;1184;90
27869;Taegukgi hwinalrimyeo;386064;6.7;41;33;8;80;6.6;17;14;3;82;4.2;5475;91
27873;Metallica: Some Kind of Monster;387412;7.6;121;107;14;88;7.5;32;30;2;93;3.7;5021;83
27874;Going the Distance;388285;2.8;5;0;5;0;0;2;0;2;0;3.3;5047;61
27875;Redemption: The Stan Tookie Williams Story;388367;0;0;0;0;0;0;0;0;0;0;0;0;0
27876;Schultze Gets the Blues;388395;6.8;63;45;18;71;7;20;14;6;70;3.5;678;71
27878;Born Into Brothels: Calcutta's Red Light Kids;388789;7.9;105;101;4;96;7.9;29;27;2;93;4.2;4144;91
27879;Dig!;388888;7.8;69;62;7;89;7.9;21;19;2;90;4.1;2189;89
27882;Riding Giants;389326;7.5;94;87;7;92;7.5;29;28;1;96;4.1;1482;93
27884;Word Wars;390632;7.1;35;31;4;88;6.9;16;13;3;81;3.5;889;66
27888;When Will I Be Loved;396271;4.6;71;23;48;32;4.3;27;7;20;25;2.6;695;31
27899;What the #$*! Do We (K)now!?;399877;4.6;75;25;50;33;4.7;24;10;14;41;3.5;5742;69
27904;A Scanner Darkly;405296;6.6;174;119;55;68;6.7;37;23;14;62;3.4;46764;70
27905;Casshern;405821;6;9;6;3;66;0;0;0;0;0;0;0;0
27912;Outfoxed: Rupert Murdoch's War on Journalism;418038;6.9;59;50;9;84;6.9;18;16;2;88;3.7;1346;76
30659;Noel;383534;4.3;34;9;25;26;3.1;12;0;12;0;3.3;1805;55
30701;Campanadas a medianoche;59012;8;12;11;1;91;0;4;3;1;75;4.3;774;90
30707;Million Dollar Baby;405159;8.3;224;204;20;91;8.6;40;38;2;95;3.8;64852;87
30712;The Narrow Margin;44954;8.3;7;7;0;100;0;0;0;0;0;0;0;0
30721;Hell Is for Heroes;56062;6.5;6;5;1;83;0;0;0;0;0;0;0;0
30745;Gokudô kyôfu dai-gekijô: Gozu;361668;6.2;53;38;15;71;6;14;11;3;78;3.9;2732;81
30747;Bu san;377556;7.5;33;27;6;81;7.5;11;10;1;90;3.6;632;70
30749;Hotel Rwanda;395169;7.9;188;170;18;90;7.7;37;32;5;86;4;52962;94
30783;Sei donne per l'assassino;58567;7.6;9;7;2;77;0;0;0;0;0;0;0;0
30793;Charlie and the Chocolate Factory;367594;0;0;0;0;0;0;0;0;0;0;0;0;0
30803;Bin-jip;423866;7.3;87;75;12;86;7.2;24;19;5;79;4.3;7442;93
30810;The Life Aquatic with Steve Zissou;362270;6.3;14;10;4;71;5.9;9;6;3;66;3.8;65;81
30812;The Aviator;338751;7.8;212;185;27;87;7.5;44;36;8;81;3.4;27084;73
30816;The Phantom of the Opera;293508;5;165;54;111;32;4.6;37;10;27;27;3.7;70849;86
30818;Beyond the Sea;363473;5.2;150;63;87;42;5.1;34;14;20;41;3.3;3905;64
30820;The Woodsman;361127;7.3;129;112;17;86;7.5;34;31;3;91;3.5;4219;74
30822;In Good Company;385267;7.1;160;134;26;83;6.9;37;28;9;75;3;9983;51
30825;Meet the Fockers;290002;5.2;157;60;97;38;5.1;38;15;23;39;3.5;187397;63
30846;The Assassination of Richard Nixon;364961;6.6;130;87;43;66;6.3;31;16;15;51;3.4;3593;67
30848;A Love Song for Bobby Long;369672;5.5;98;42;56;42;5.3;27;12;15;44;3.7;5803;80
30850;The Merchant of Venice;379889;6.7;123;88;35;71;6.8;35;24;11;68;3.5;4764;72
30883;Fat Albert;396592;4.4;81;18;63;22;4.4;30;7;23;23;2.7;6431;53
30890;Le chiavi di casa;345032;6.9;25;20;5;80;7.4;7;6;1;85;3.7;367;75
30892;In the Realms of the Unreal;390123;6.8;61;43;18;70;7;19;15;4;78;3.8;1043;77
30894;White Noise;375210;3.5;146;13;133;8;3.5;33;3;30;9;2.7;14878;44
30896;Underclassman;373416;2.8;79;5;74;6;2.8;25;1;24;4;2.7;3200;44
30898;The Upside of Anger;365885;6.8;168;125;43;74;6.5;34;23;11;67;3.2;4962;60
30942;Arrowhead;45518;0;1;0;1;0;0;0;0;0;0;0;0;0
30949;The Grateful Dead;76104;0;0;0;0;0;0;0;0;0;0;0;0;0
30952;Last Train from Gun Hill;52993;0;4;3;1;75;0;0;0;0;0;0;0;0
30954;The Naked Jungle;47264;7;6;5;1;83;0;0;0;0;0;0;0;0
30970;A Handful of Dust;95274;0;3;2;1;66;0;1;1;0;100;3;754;41
30977;The Pickle;107824;4.5;5;1;4;20;0;2;1;1;50;2.4;58;19
30981;Wetherby;90310;7.6;5;4;1;80;0;1;1;0;100;3.1;194;43
30991;Powwow Highway;98112;7.2;9;9;0;100;0;1;1;0;100;4;600;87
30994;Little Miss Marker;25410;\N;\N;\N;\N;\N;\N;\N;\N;\N;\N;\N;\N;\N
30996;Little Miss Marker;25410;\N;\N;\N;\N;\N;\N;\N;\N;\N;\N;\N;\N;\N
31000;Sweet Liberty;92035;5.7;12;9;3;75;0;1;0;1;0;3;337;34
31004;La vie promise;295004;5.6;22;10;12;45;5.2;10;4;6;40;3.2;202;48
31011;It's All True;107233;7;20;16;4;80;6.4;5;4;1;80;3.2;261;56
31026;The Phantom of the Opera;293508;5;165;54;111;32;4.6;37;10;27;27;3.7;70849;86
31030;I Remember Mama;40458;7.5;15;14;1;93;0;2;2;0;100;4;582;83
31032;The Last Horror Movie;319728;5.9;9;5;4;55;0;0;0;0;0;0;0;0
31035;Testament;86429;7.2;7;6;1;85;0;1;1;0;100;3.7;455;70
31038;Smooth Talk;90037;6.6;9;7;2;77;0;2;1;1;50;3.1;280;41
31040;Distant Thunder;95036;5.2;6;3;3;50;0;1;1;0;100;3.1;151;37
31042;Hell's Angels;20960;7.3;10;9;1;90;0;0;0;0;0;0;0;0
31047;Jinxed!;84173;0;1;0;1;0;0;0;0;0;0;0;0;0
31049;Out Cold;253798;2.9;48;4;44;8;3;15;1;14;6;3.5;7234;84
31053;Heart of America;279037;0;4;1;3;25;0;0;0;0;0;0;0;0
31060;A Show of Force;100606;0;0;0;0;0;0;0;0;0;0;0;0;0
31079;Kaijûtô no kessen: Gojira no musuko;61856;5.1;7;5;2;71;0;0;0;0;0;0;0;0
31083;Man Trouble;104804;3.7;11;2;9;18;0;1;0;1;0;2.6;637;17
31086;Jingi naki tatakai;70246;6.5;6;3;3;50;0;0;0;0;0;0;0;0
31090;Führer Ex;329106;0;1;0;1;0;0;0;0;0;0;0;0;0
31101;Stander;326208;6.5;62;45;17;72;6.5;16;12;4;75;3.6;1039;77
31104;Hester Street;73107;6.2;6;4;2;66;0;0;0;0;0;0;0;0
31107;Mikey and Nicky;74901;6.4;11;8;3;72;0;0;0;0;0;0;0;0
31109;The Bigamist;45557;0;2;2;0;100;0;0;0;0;0;0;0;0
31112;Libertarias;113649;0;0;0;0;0;0;0;0;0;0;0;0;0
31114;Imaginary Heroes;373024;5.2;101;35;66;34;5;30;11;19;36;3.8;3294;80
31116;Sergeant York;34167;6.9;18;15;3;83;0;2;1;1;50;4;1263;87
31123;Tais-toi!;310203;0;1;1;0;100;0;0;0;0;0;0;0;0
31148;Dzien swira;330243;0;2;2;0;100;0;0;0;0;0;0;0;0
31150;The Wizard;98663;4.3;17;4;13;23;0;3;0;3;0;3.1;3783;60
31156;Abbott and Costello Meet the Invisible Man;43255;5.5;8;6;2;75;0;0;0;0;0;0;0;0
31160;Abbott and Costello Meet the Killer, Boris Karloff;41085;0;0;0;0;0;0;0;0;0;0;0;0;0
31162;The Life and Death of Peter Sellers;352520;6.2;19;14;5;73;0;3;1;2;33;3.4;2594;69
31184;Appurushîdo;401233;4.7;32;8;24;25;4.4;14;2;12;14;3.7;5608;76
31188;La voie lactée;66534;7.7;14;13;1;92;0;2;2;0;100;4;669;84
31193;The Many Adventures of Winnie the Pooh;76363;8.1;11;10;1;90;0;1;1;0;100;3.6;3913;81
31221;Elektra;357277;3.7;150;15;135;10;3.8;33;4;29;12;2.6;26366;47
31223;Racing Stripes;376105;4.9;98;34;64;34;5.1;25;12;13;48;3;10332;56
31225;Coach Carter;393162;6.1;142;92;50;64;6;35;21;14;60;3.7;56395;85
31247;Sullivan's Travels;34240;8.7;29;29;0;100;0;2;2;0;100;4.2;2289;90
31251;Iceman;87452;0;1;1;0;100;0;0;0;0;0;0;0;0
31255;Ice Station Zebra;63121;5.3;12;6;6;50;0;1;0;1;0;3.2;1042;53
31260;Boys Town;29942;7.1;14;14;0;100;0;0;0;0;0;0;0;0
31263;Torremolinos 73;339806;6.4;40;28;12;70;6.7;20;15;5;75;3.5;502;68
31270;Shivers;73705;6.8;19;16;3;84;0;2;1;1;50;3.4;2264;61
31309;Rocco e i suoi fratelli;54248;7.8;17;16;1;94;0;4;3;1;75;4.2;1288;92
31347;Christmas in July;32338;7.9;16;15;1;93;0;4;3;1;75;4;244;87
31349;I Married a Witch;34881;7.7;14;14;0;100;0;2;2;0;100;3.7;260;67
31359;Moolaadé;416991;0;0;0;0;0;0;0;0;0;0;0;0;0
31362;This Girl's Life;343095;5.6;7;3;4;42;0;1;1;0;100;3.1;508;47
31364;Salinui chueok;353969;7.7;34;30;4;88;7.9;9;9;0;100;4.2;3096;93
31367;The Chase;109402;4.8;16;5;11;31;0;3;0;3;0;2.6;2631;36
31408;Sommersturm;420206;5.7;30;15;15;50;5.7;13;7;6;53;3.8;1586;80
31410;Der Untergang;363163;0;0;0;0;0;0;0;0;0;0;0;0;0
31420;Assault on Precinct 13;398712;5.9;160;96;64;60;6;36;23;13;63;3.1;12635;54
31422;Are We There Yet?;368578;3.3;113;13;100;11;3.6;32;3;29;9;3.1;29416;62
31424;Alone in the Dark;369226;1.7;116;1;115;0;1.7;26;0;26;0;2.1;8641;21
31427;Hide and Seek;382077;3.8;153;19;134;12;4.3;35;6;29;17;3.1;22573;60
31429;Aliens of the Deep;417415;7;61;51;10;83;7.5;21;18;3;85;3.2;1182;50
31431;Boogeyman;357507;3.4;85;11;74;12;3.2;11;0;11;0;2.5;13866;38
31433;The Wedding Date;372532;3.8;136;14;122;10;3.9;31;3;28;9;3.2;34530;68
31435;Inside I'm Dancing;417791;5.8;69;34;35;49;5.6;21;9;12;42;4.1;2819;89
31437;Dare mo shiranai;408664;8;91;85;6;93;8.4;28;27;1;96;4.2;3440;92
31445;Employee of the Month;424993;4;88;18;70;20;3.9;25;4;21;16;3.2;54090;61
31447;Magic in the Water;113737;3.6;8;1;7;12;0;2;0;2;0;3.3;642;59
31467;The Great White Hope;65797;5.5;6;2;4;33;0;3;1;2;33;3.8;213;74
31485;Léon;110413;6.8;39;30;9;76;5.8;8;4;4;50;4.1;59011;94
31494;Everyday People;365020;6.3;8;6;2;75;0;4;4;0;100;2.9;87;41
31522;Die Ehe der Maria Braun;79095;8.5;14;13;1;92;0;3;3;0;100;4.1;858;89
31528;Beau Geste;31088;8.1;9;9;0;100;0;0;0;0;0;0;0;0
31545;The Hole;242527;5.8;15;8;7;53;0;1;0;1;0;3.1;5670;58
31547;Lektionen in Finsternis;104706;8;9;9;0;100;0;0;0;0;0;0;0;0
31553;Double Dragon;106761;3.2;10;0;10;0;0;3;0;3;0;2.1;3610;29
31555;Mac and Me;95560;2.4;14;0;14;0;0;2;0;2;0;2.7;2264;43
31577;Scorchers;102861;0;0;0;0;0;0;0;0;0;0;0;0;0
31584;Rosenstrasse;298131;5.8;61;34;27;55;5.6;25;13;12;52;3.5;359;66
31588;Casque d'or;43386;8.4;11;11;0;100;0;3;3;0;100;3.7;397;76
31590;Touchez pas au grisbi;46451;8.3;23;23;0;100;8.8;7;7;0;100;4;630;83
31594;The MatchMaker;119632;5.6;26;14;12;53;0;4;2;2;50;3.3;1220;66
31598;The Ballad of the Sad Cafe;101404;6.4;5;4;1;80;0;3;2;1;66;3.6;69;64
31600;The Deceivers;94979;5.1;5;1;4;20;0;1;0;1;0;3.1;252;50
31610;Zi hudie;363290;5.5;20;9;11;45;5.8;8;4;4;50;3.1;578;42
31613;Five Easy Pieces;65724;8.2;30;25;5;83;6.5;5;3;2;60;3.9;4148;85
31617;El Cid;54847;6.5;12;11;1;91;0;1;1;0;100;3.6;1234;73
31658;Hauru no ugoku shiro;347149;7.5;148;127;21;85;7.3;36;30;6;83;4.1;56005;93
31660;Suchîmubôi;348121;6;87;51;36;58;6.1;28;16;12;57;3.5;4805;70
31682;The Nomi Song;402406;7.2;36;34;2;94;7.3;15;15;0;100;3.8;302;79
31685;Hitch;386588;6.3;178;122;56;68;6.3;34;21;13;61;3.4;189230;65
31687;Pooh's Heffalump Movie;407121;6.6;84;67;17;79;6.2;23;17;6;73;3.5;2927;71
31689;Deep Throat;68468;\N;\N;\N;\N;\N;\N;\N;\N;\N;\N;\N;\N;\N
31692;Uncle Nino;327210;4.4;33;7;26;21;4.2;13;3;10;23;3.7;109;70
31694;Bride & Prejudice;361411;6.1;131;84;47;64;6.8;32;26;6;81;3.3;17555;67
31696;Constantine;360486;5.5;214;98;116;45;4.7;42;10;32;23;3.5;71421;75
31698;Son of the Mask;362165;2.8;101;6;95;5;3.1;25;0;25;0;2.1;4576;32
31700;Because of Winn-Dixie;317132;5.8;118;63;55;53;5.8;31;17;14;54;3.3;6908;70
31702;Lakposhtha parvaz mikonand;424227;7.8;70;62;8;88;7.7;21;19;2;90;4.3;2998;93
31705;Beautiful Boxer;401248;6.7;35;28;7;80;6.7;12;9;3;75;3.9;879;88
31724;Pauly Shore Is Dead;284674;5.7;13;8;5;61;0;1;1;0;100;2.4;2127;28
31737;Bunny Lake Is Missing;58997;6.9;9;8;1;88;0;1;1;0;100;3.7;715;76
31742;Jeremy;70238;0;1;1;0;100;0;0;0;0;0;0;0;0
31747;Don't Tell Her It's Me;99450;0;1;1;0;100;0;0;0;0;0;0;0;0
31750;Until September;88330;3.3;5;0;5;0;0;2;0;2;0;3.5;159;63
31770;Night and the City;105001;5.7;10;6;4;60;0;2;1;1;50;3;376;33
31785;Paha maa;388318;0;0;0;0;0;0;0;0;0;0;0;0;0
31804;Nochnoy dozor;403358;5.9;125;73;52;58;5.9;30;17;13;56;3.3;19774;70
31807;Dot the I;326835;4.6;59;15;44;25;4.6;23;4;19;17;3.8;2535;78
31854;Road to Morocco;35262;7.8;12;11;1;91;0;0;0;0;0;0;0;0
31867;Man of the House;331933;3.3;60;5;55;8;3.9;16;4;12;25;3.1;10877;59
31878;Kung fu;373074;7.6;172;154;18;89;7.4;39;33;6;84;3.6;37633;86
31900;Travellers and Magicians;378906;\N;\N;\N;\N;\N;\N;\N;\N;\N;\N;\N;\N;\N
31903;Zelary;288330;6.7;51;37;14;72;6.6;15;11;4;73;4.1;638;89
31909;Dr. Giggles;104139;3.9;14;3;11;21;0;0;0;0;0;0;0;0
31923;The Three Musketeers;108333;4.8;24;7;17;29;0;3;0;3;0;3.2;13783;67
31930;Masculin féminin: 15 faits précis;60675;\N;\N;\N;\N;\N;\N;\N;\N;\N;\N;\N;\N;\N
31934;The Four Feathers;240510;5.4;149;61;88;40;5.6;32;13;19;40;3.2;6869;65
31950;Night of the Demon;50766;8;10;10;0;100;0;0;0;0;0;0;0;0
31952;Kontroll;373981;7;64;52;12;81;6.6;18;13;5;72;4;2770;88
31956;5x2;354356;6.2;68;44;24;64;6;20;12;8;60;3.6;1684;69
31973;Germania anno zero;39417;9.2;9;9;0;100;0;0;0;0;0;0;0;0
31998;Ett hål i mitt hjärta;381682;4;17;7;10;41;3.6;8;2;6;25;2.8;704;39
32002;Bigger Than the Sky;363504;3.6;16;2;14;12;3.2;9;0;9;0;3.1;458;51
32009;Diary of a Mad Black Woman;422093;3.9;108;17;91;15;4.4;30;8;22;26;4;28144;89
32011;Cursed;257516;0;0;0;0;0;0;0;0;0;0;0;0;0
32013;In the Loop;1226774;7.8;158;148;10;93;7.7;29;27;2;93;2.9;31450;76
32017;The Pacifier;395699;3.7;127;26;101;20;3.4;32;5;27;15;3.2;48314;70
32019;Be Cool;377471;4.6;168;50;118;29;4.2;38;6;32;15;2.8;15817;48
32022;Gunner Palace;424129;7;102;86;16;84;7.2;32;27;5;84;3.4;649;63
32025;Walk on Water;352994;6.5;74;53;21;71;6.1;23;15;8;65;4;1438;86
32029;Hostage;340163;5;154;54;100;35;4.3;36;6;30;16;3.3;22771;69
32031;I, Robot;343818;0;0;0;0;0;0;0;0;0;0;0;0;0
32049;The Laughing Policeman;70292;5.9;5;4;1;80;0;1;1;0;100;3.1;219;43
32058;Class Action;101590;6.1;23;17;6;73;0;4;4;0;100;3;742;45
32060;The Cat and the Canary;17739;6.9;6;5;1;83;0;0;0;0;0;0;0;0
32062;Courage Mountain;97115;0;0;0;0;0;0;0;0;0;0;0;0;0
32074;Kiss the Bride;296711;5.4;6;2;4;33;0;0;0;0;0;0;0;0
32076;Gojira, Ebirâ, Mosura: Nankai no daiketto;60464;0;2;1;1;50;0;0;0;0;0;0;0;0
32078;Gojira VS Mekagojira;107027;0;2;2;0;100;0;0;0;0;0;0;0;0
32082;That Championship Season;84784;6.2;5;3;2;60;0;0;0;0;0;0;0;0
32084;Crush;245407;\N;\N;\N;\N;\N;\N;\N;\N;\N;\N;\N;\N;\N
32088;DNA;118912;0;1;0;1;0;0;0;0;0;0;0;0;0
32090;The Riches;496343;\N;\N;\N;\N;\N;\N;\N;\N;\N;\N;\N;\N;\N
32109;Les triplettes de Belleville;286244;0;0;0;0;0;0;0;0;0;0;0;0;0
32116;Oh, God! You Devil;87835;5.1;7;2;5;28;0;0;0;0;0;0;0;0
32120;A Killer Among Friends;104612;\N;\N;\N;\N;\N;\N;\N;\N;\N;\N;\N;\N;\N
32124;Deus É Brasileiro;350804;0;0;0;0;0;0;0;0;0;0;0;0;0
32128;Blackball;337879;4.8;13;5;8;38;0;0;0;0;0;0;0;0
32139;The Agony and the Ecstasy;58886;7;5;5;0;100;0;0;0;0;0;0;0;0
32141;Return to Peyton Place;55370;0;1;0;1;0;0;0;0;0;0;0;0;0
32149;Butch and Sundance: The Early Days;78919;0;0;0;0;0;0;0;0;0;0;0;0;0
32151;It Happened to Jane;52933;0;2;0;2;0;0;0;0;0;0;0;0;0
32153;Once Upon a Forest;107745;4.4;5;0;5;0;0;2;0;2;0;3.3;913;67
32156;Hello Down There;64417;0;2;2;0;100;0;0;0;0;0;0;0;0
32158;All in a Night's Work;54615;0;0;0;0;0;0;0;0;0;0;0;0;0
32160;Twentieth Century;25919;7.7;24;21;3;87;0;2;2;0;100;3.7;487;74
32162;My Sister Eileen;35105;6.6;5;4;1;80;0;1;1;0;100;3.7;99;73
32166;Strangers When We Meet;54345;0;4;3;1;75;0;0;0;0;0;0;0;0
32170;The Chronicles of Narnia: Prince Caspian;499448;6.3;179;120;59;67;6.2;37;23;14;62;3.8;154104;78
32174;The Green Berets;63035;3.5;8;2;6;25;0;0;0;0;0;0;0;0
32179;Ascenseur pour l'échafaud;51378;8;41;38;3;92;8.1;14;13;1;92;4.2;1819;91
32211;Thriller - en grym film;72285;4.3;5;2;3;40;0;1;0;1;0;3.5;1247;67
32213;Cube Zero;377713;0;3;3;0;100;0;0;0;0;0;0;0;0
32234;Being Julia;340012;6.7;123;94;29;76;6.5;35;24;11;68;3.5;1947;71
32239;Jigureul jikyeora!;354668;7.3;38;33;5;86;7.4;12;11;1;91;4;1746;86
32261;Thirty Seconds Over Tokyo;37366;0;4;4;0;100;0;0;0;0;0;0;0;0
32285;The Boys from County Clare;337631;5.9;28;13;15;46;5.8;11;4;7;36;3.4;443;67
32289;Ice Princess;396652;5.6;102;53;49;51;5.4;29;14;15;48;3.1;33981;66
32291;Melinda and Melinda;378947;5.8;154;82;72;53;6;39;22;17;56;3.1;2565;45
32294;Milk and Honey;347540;\N;\N;\N;\N;\N;\N;\N;\N;\N;\N;\N;\N;\N
32296;Miss Congeniality 2: Armed & Fabulous;385307;4;144;21;123;14;4;33;3;30;9;3;34010;59
32298;Guess Who;372237;5.4;148;64;84;43;4.7;36;9;27;25;3.1;27344;59
32300;D.E.B.S.;367631;4.7;58;23;35;39;4.7;21;8;13;38;2.9;4690;52
32302;A League of Ordinary Gentlemen;430289;7.3;34;31;3;91;7.2;14;13;1;92;3.5;155;64
32314;Incident at Loch Ness;374639;6.2;47;29;18;61;5.5;16;7;9;43;3.4;894;66
32316;Frozen River;978759;7.3;125;109;16;87;7.9;26;24;2;92;3.2;9338;71
32318;Virginia's Run;307639;\N;\N;\N;\N;\N;\N;\N;\N;\N;\N;\N;\N;\N
32325;Yanks;80157;5.9;7;5;2;71;0;0;0;0;0;0;0;0
32329;Paradise Alley;78056;0;4;1;3;25;0;0;0;0;0;0;0;0
32333;Mávahlátur;281176;6.7;32;27;5;84;7.3;12;11;1;91;3.4;199;64
32335;Caballos salvajes;112609;0;0;0;0;0;0;0;0;0;0;0;0;0
32342;Woman Thou Art Loosed;399901;5.5;56;29;27;51;5.4;23;12;11;52;4;869;86
32345;Arrowsmith;21622;7.1;6;5;1;83;0;0;0;0;0;0;0;0
32347;Barbary Coast;26097;7.4;10;10;0;100;0;2;2;0;100;3.1;211;43
32349;Stella Dallas;29608;6.2;5;4;1;80;0;0;0;0;0;0;0;0
32352;The Princess and the Cobbler;112389;0;4;1;3;25;0;1;0;1;0;3.7;1335;74
32354;Böse Zellen;372814;6.4;16;10;6;62;7.1;5;4;1;80;3.2;206;50
32361;Come and Get It;27459;7.5;9;8;1;88;0;2;2;0;100;3.1;281;48
32369;Panic in the Streets;42832;7.3;18;17;1;94;0;2;2;0;100;3.5;554;72
32371;Call Northside 777;40202;7.2;15;11;4;73;0;1;0;1;0;3.5;657;70
32375;Der junge Törless;60574;0;0;0;0;0;0;0;0;0;0;0;0;0
32381;Bells Are Ringing;53645;6.8;8;6;2;75;0;0;0;0;0;0;0;0
32383;Finian's Rainbow;62974;5.6;11;6;5;54;0;4;2;2;50;3.3;1023;57
32385;Toolbox Murders;367153;5.9;15;7;8;46;0;1;1;0;100;2.8;1770;36
32387;Dai-bosatsu tôge;60277;6.9;7;5;2;71;0;0;0;0;0;0;0;0
32389;Profundo carmesí;117394;0;0;0;0;0;0;0;0;0;0;0;0;0
32392;800 balas;292886;5.8;11;5;6;45;5.6;5;2;3;40;3.2;1505;56
32395;Matango;57295;0;3;2;1;66;0;0;0;0;0;0;0;0
32444;U-Carmen e-Khayelitsha;445776;7.4;20;19;1;95;7.8;7;7;0;100;3.2;1204;50
32456;Heisei tanuki gassen pompoko;110008;7;5;4;1;80;0;0;0;0;0;0;0;0
32460;Knockin' on Heaven's Door;119472;0;0;0;0;0;0;0;0;0;0;0;0;0
32469;We're No Angels;98625;5.1;18;9;9;50;0;1;1;0;100;2.9;2176;43
32525;Madame de...;46022;8.7;22;22;0;100;7.7;5;5;0;100;4.3;591;94
32582;The Wild Parrots of Telegraph Hill;424565;7.7;94;89;5;94;7.7;28;28;0;100;3.9;1161;83
32584;The Ballad of Jack and Rose;357110;5.7;110;51;59;46;5.6;34;15;19;44;3.4;2469;64
32587;Sin City;401792;\N;\N;\N;\N;\N;\N;\N;\N;\N;\N;\N;\N;\N
32589;Beauty Shop;388500;5.3;114;43;71;37;5.8;28;14;14;50;3.3;11288;70
32591;Comme une image;374583;7.6;98;85;13;86;8;31;29;2;93;3.5;1003;66
32593;Dust to Glory;386423;6.2;68;41;27;60;6;21;12;9;57;4.2;728;86
32596;Sahara;318649;5.2;171;66;105;38;5;34;15;19;44;3;24489;61
32598;Fever Pitch;332047;6.2;172;110;62;63;6;38;19;19;50;3;14004;62
32600;Eros;343663;\N;\N;\N;\N;\N;\N;\N;\N;\N;\N;\N;\N;\N
32602;Winter Solstice;365938;6.4;80;48;32;60;6.8;25;18;7;72;3;420;44
32605;Smile;397103;4;13;2;11;15;3.9;5;1;4;20;3.5;585;69
32617;Sinbad and the Eye of the Tiger;76716;6;8;5;3;62;0;0;0;0;0;0;0;0
32620;Pas sur la bouche;356999;7.1;8;6;2;75;0;2;2;0;100;3.1;663;48
32625;Krakatoa: East of Java;64555;3.7;6;0;6;0;0;0;0;0;0;0;0;0
32627;Rhinestone;88001;2.8;9;1;8;11;0;1;0;1;0;2.5;1290;37
32632;Electra Glide in Blue;70022;6.2;8;6;2;75;0;0;0;0;0;0;0;0
32646;Bring on the Night;88855;0;0;0;0;0;0;0;0;0;0;0;0;0
32649;Una giornata particolare;76085;0;2;2;0;100;0;0;0;0;0;0;0;0
32657;L'homme qui plantait des arbres;93488;0;0;0;0;0;0;0;0;0;0;0;0;0
32666;Lady Killers;376717;0;0;0;0;0;0;0;0;0;0;0;0;0
32668;Blind Horizon;337881;0;4;2;2;50;0;0;0;0;0;0;0;0
32674;Islands in the Stream;76211;6.3;5;4;1;80;0;0;0;0;0;0;0;0
32677;Go for Broke!;43590;0;4;1;3;25;0;0;0;0;0;0;0;0
32721;Battle of the Bulge;58947;6.7;6;4;2;66;0;0;0;0;0;0;0;0
32743;Ringu 0: Bâsudei;235712;0;2;1;1;50;0;0;0;0;0;0;0;0
32770;Brødre;386342;7.5;71;63;8;88;7.8;24;22;2;91;3.8;1141;84
32781;Hawaii;60491;0;1;0;1;0;0;0;0;0;0;0;0;0
32792;Il deserto rosso;58003;8.4;11;11;0;100;0;2;2;0;100;4.1;1182;86
32825;Seksmisja;88083;0;0;0;0;0;0;0;0;0;0;0;0;0
32844;Waterloo Bridge;33238;6.4;5;4;1;80;0;1;1;0;100;4;1003;88
32853;Le chagrin et la pitié;383974;\N;\N;\N;\N;\N;\N;\N;\N;\N;\N;\N;\N;\N
32862;With Six You Get Eggroll;63821;0;2;2;0;100;0;0;0;0;0;0;0;0
32875;Jour de fête;40497;8.2;13;13;0;100;0;1;1;0;100;4;736;83
32882;The Big Store;33388;5.3;9;6;3;66;0;0;0;0;0;0;0;0
32892;Ivanovo detstvo;56111;8.6;9;9;0;100;0;1;1;0;100;4.2;1542;93
32954;The Chant of Jimmie Blacksmith;77318;0;3;3;0;100;0;0;0;0;0;0;0;0
32966;Let Him Have It;102288;7.3;12;11;1;91;0;1;1;0;100;3.9;381;83
32988;Sunshine Cleaning;862846;6.3;158;112;46;70;6.4;34;26;8;76;3.3;81677;59
33004;The Hitch Hikers Guide to the Galaxy;81874;\N;\N;\N;\N;\N;\N;\N;\N;\N;\N;\N;\N;\N
33036;The Eiger Sanction;72926;6.4;12;9;3;75;0;1;1;0;100;0;0;0
33072;Vérités et mensonges;72962;7.3;24;21;3;87;0;3;3;0;100;4.1;1945;89
33085;The Amityville Horror;384806;4.2;155;37;118;23;3.9;33;7;26;21;3.2;31070;64
33113;Act of Violence;41088;6.8;10;9;1;90;0;2;2;0;100;3.8;227;78
33124;NaPolA;384369;6.5;38;26;12;68;6.6;13;9;4;69;3.9;1085;86
33126;The Frisco Kid;79180;5.8;14;8;6;57;0;1;0;1;0;3.3;1432;60
33132;State Property 2;403537;3.5;14;2;12;14;4;10;2;8;20;3.9;1114;82
33134;The Year of the Yao;360216;6.2;32;21;11;65;6.1;11;7;4;63;3.6;562;67
33136;House of D;372334;3.8;101;10;91;9;3.6;29;2;27;6;3.6;2769;74
33138;Palindromes;362004;5.3;113;47;66;41;5.7;34;16;18;47;3.5;3088;70
33145;A Lot Like Love;391304;4.9;123;50;73;40;5;33;12;21;36;3.5;20461;76
33148;King's Ransom;388183;2.4;50;1;49;2;2.2;14;0;14;0;2.7;933;37
33150;The Game of Their Lives;354595;0;0;0;0;0;0;0;0;0;0;0;0;0
33152;The Bridges of Madison County;112579;7.2;40;36;4;90;7.9;9;9;0;100;3.6;11573;83
33154;Enron: The Smartest Guys in the Room;1016268;\N;\N;\N;\N;\N;\N;\N;\N;\N;\N;\N;\N;\N
33158;xXx: State of the Union;329774;3.8;135;22;113;16;3.9;31;4;27;12;2.9;20840;53
33162;Kingdom of Heaven;320661;5.5;185;72;113;38;5.9;37;19;18;51;3.5;82821;72
33164;House of Wax;397065;4.3;148;37;111;25;4.5;30;6;24;20;2.8;39495;54
33166;Crash;375679;7.1;197;148;49;75;7.1;39;30;9;76;4;98746;89
33168;Jiminy Glick in Lalawood;347369;4.6;44;10;34;22;4.7;19;4;15;21;2.6;694;31
33171;Mysterious Skin;370986;7.2;99;83;16;83;7.6;29;26;3;89;4;9458;89
33188;Mischief;89601;5.2;5;3;2;60;0;0;0;0;0;0;0;0
33191;Jubal;48233;0;4;4;0;100;0;0;0;0;0;0;0;0
33193;Viva Maria!;59956;0;2;0;2;0;0;0;0;0;0;0;0;0
33237;San Francisco;28216;7.4;7;7;0;100;0;0;0;0;0;0;0;0
33296;Buying the Cow;218864;0;3;1;2;33;0;0;0;0;0;0;0;0
33312;The Cocoanuts;19777;7.5;19;18;1;94;0;2;2;0;100;3.6;1293;71
33340;Kizzu ritân;116767;0;4;4;0;100;0;0;0;0;0;0;0;0
33358;Off the Map;332285;6.6;92;64;28;69;6.6;26;18;8;69;3.8;818;82
33410;Crackerjack;291832;6.5;5;5;0;100;0;0;0;0;0;0;0;0
33421;Dear Wendy;342272;5.1;60;22;38;36;4.2;16;3;13;18;3.2;7054;54
33437;Danny the Dog;342258;6.2;128;83;45;64;5.9;31;15;16;48;3.5;17781;77
33451;Brutti, sporchi e cattivi;74252;\N;\N;\N;\N;\N;\N;\N;\N;\N;\N;\N;\N;\N
33454;Léolo;104782;8.3;9;9;0;100;0;3;3;0;100;4.1;1393;87
33493;Star Wars: Episode III - Revenge of the Sith;121766;7.2;253;202;51;79;6.6;43;29;14;67;3.1;198824;64
33495;Kicking & Screaming;384642;5.1;137;57;80;41;5;31;12;19;38;3;14260;51
33499;Monster-in-Law;369735;4.2;162;26;136;16;3.9;40;5;35;12;3.2;50840;63
33539;Deep Blue Sea;149261;5.7;89;51;38;57;5.8;22;14;8;63;2.8;26286;44
33558;The Snow Walker;337721;6.8;13;11;2;84;0;3;2;1;66;3.7;895;76
33564;Divorzio all'italiana;55913;7.9;16;16;0;100;7.8;5;5;0;100;4;1181;90
33585;9 Songs;411705;4.4;92;23;69;25;4.5;29;8;21;27;2.7;3152;35
33592;Nabbeun namja;307213;5.2;31;13;18;41;5;10;3;7;30;3.6;1440;72
33603;Simon;393775;5.6;5;3;2;60;0;4;2;2;50;4.1;338;87
33608;December 7th;35790;0;0;0;0;0;0;0;0;0;0;0;0;0
33615;Madagascar;351283;6;185;102;83;55;6;36;14;22;38;3.4;131512;70
33621;Somersault;381429;6.9;64;53;11;82;6.8;18;15;3;83;3.2;9811;53
33629;Airborne;106233;2.9;6;1;5;16;0;1;0;1;0;0;0;0
33639;Mad Hot Ballroom;438205;7.1;115;96;19;83;7.5;32;31;1;96;3.8;2138;80
33644;Dominion: Prequel to the Exorcist;449086;4.7;43;13;30;30;4.7;15;4;11;26;2.7;5628;35
33646;The Longest Yard;398165;4.8;163;51;112;31;5.2;35;14;21;40;3.3;198675;67
33649;Saving Face;384504;6.7;81;70;11;86;7;25;23;2;92;4;2669;87
33660;Cinderella Man;352248;7.4;206;164;42;79;7.6;43;35;8;81;3.8;44272;88
33669;The Sisterhood of the Traveling Pants;403508;6.7;128;98;30;76;7.2;31;29;2;93;3.4;38616;78
33672;Lords of Dogtown;355702;6;141;77;64;54;6.5;33;20;13;60;3.6;15495;81
33675;Après vous...;344604;6;64;36;28;56;6.3;20;12;8;60;3.5;850;67
33677;The School of Rock;332379;7.8;188;172;16;91;8.2;39;38;1;97;3.2;183700;63
33679;Mr. & Mrs. Smith;356910;6;202;116;86;57;5.6;39;18;21;46;3.4;230941;63
33681;The Adventures of Sharkboy and Lavagirl 3-D;424774;4.3;120;24;96;20;4;31;5;26;16;2.5;5829;42
33683;Haute tension;338095;5.2;126;52;74;41;4.9;24;11;13;45;3.4;11124;68
33685;The Honeymooners;373908;3.6;109;15;94;13;3.6;30;4;26;13;2.8;2118;42
33688;Parineeta;437407;0;2;2;0;100;0;1;1;0;100;3.8;1102;81
33722;Ladies in Lavender.;377084;6.1;89;56;33;62;6.3;27;17;10;62;3.5;2044;65
33725;It's All Gone Pete Tong;388139;6.5;70;54;16;77;6.1;21;14;7;66;3.9;3974;87
33750;Voces inocentes;387914;6.8;47;32;15;68;7.1;16;11;5;68;4.3;1831;93
33781;Quo Vadis;43949;6.4;8;7;1;87;0;0;0;0;0;0;0;0
33794;Batman Begins;372784;7.7;257;217;40;84;6.6;43;26;17;60;3.9;184482;90
33815;The Perfect Man;380623;3.2;117;6;111;5;3.5;31;3;28;9;3.2;49341;69
33817;My Summer of Love;382189;7.4;87;78;9;89;7.8;30;29;1;96;3.5;3593;69
33819;Heights;382073;6.3;101;65;36;64;5.8;29;16;13;55;3.6;1284;73
33821;The Deal;848281;0;4;2;2;50;0;2;0;2;0;2.7;714;28
33823;The Bridge of San Luis Rey;356443;2.9;24;1;23;4;2.8;11;0;11;0;2.7;689;34
33826;Saint Ralph;384488;6.3;67;42;25;62;6.1;24;15;9;62;3.8;1289;83
33830;Herbie Fully Loaded;400497;5.4;139;58;81;41;5.6;32;15;17;46;2.8;18840;54
33832;Yes Man;1068680;5.2;144;62;82;43;4.9;31;12;19;38;3.7;141478;72
33834;Land of the Dead;418819;6.6;169;124;45;73;6.4;32;21;11;65;3.1;28194;56
33836;Bewitched;374536;4.6;182;44;138;24;4.3;41;8;33;19;2.5;17310;39
33838;Rize;436724;7;89;74;15;83;7;29;25;4;86;4;2579;84
33880;Me and You and Everyone We Know;415978;7.4;108;88;20;81;7.6;35;29;6;82;3.9;12252;85
33896;Sam gang yi;420251;6.8;62;52;10;83;6.5;23;16;7;69;3.7;5014;75
33903;Die fetten Jahre sind vorbei;408777;6.5;75;52;23;69;6.4;22;14;8;63;4;6418;89
33905;Somebody Up There Likes Me;49778;6.7;10;8;2;80;0;3;3;0;100;3.9;753;86
33966;Cop and ½;106613;2.8;12;2;10;16;0;2;1;1;50;2.3;1861;33
34002;Room Service;30696;5.8;10;7;3;70;0;0;0;0;0;0;0;0
34018;At the Circus;31060;6.9;9;9;0;100;0;0;0;0;0;0;0;0
34048;War of the Worlds;407304;7;244;178;66;72;6.7;42;28;14;66;2.9;162092;45
34065;Billion Dollar Brain;61405;0;4;2;2;50;0;1;0;1;0;3.1;957;45
34072;La marche de l'empereur;428803;7.8;163;153;10;93;7.6;38;35;3;92;3.5;18536;76
34129;Rebound;376108;3.7;89;12;77;13;4;29;4;25;13;2.9;5853;52
34143;Dark Water;382628;5.5;148;67;81;45;5.3;36;15;21;41;2.7;18535;38
34148;De battre mon coeur s'est arrêté;411270;7.2;91;77;14;84;6.9;28;22;6;78;3.9;3473;83
34150;Fantastic Four;120667;4.5;200;54;146;27;4.7;34;10;24;29;3.2;95962;57
34153;Murderball;436613;8.4;137;134;3;97;8.4;35;35;0;100;3.9;3228;87
34155;Saraband;299478;7.9;78;73;5;93;8.2;26;24;2;92;3.9;1427;83
34158;Julie Johnson;239509;0;0;0;0;0;0;0;0;0;0;0;0;0
34162;Wedding Crashers;396269;6.7;180;135;45;75;6.9;38;28;10;73;3.5;215271;70
34164;Happy Endings;361693;6;104;58;46;55;6;33;16;17;48;3.4;3035;63
34170;C.H.O.M.P.S;78924;0;2;0;2;0;0;0;0;0;0;0;0;0
34177;The Hindenburg;73113;5.1;11;5;6;45;0;1;0;1;0;3;497;40
34185;Staying Together;98383;5.8;5;4;1;80;0;1;0;1;0;3.2;295;61
34189;Twin Sitters;122768;0;0;0;0;0;0;0;0;0;0;0;0;0
34193;Earth: Final Conflict;123816;\N;\N;\N;\N;\N;\N;\N;\N;\N;\N;\N;\N;\N
34198;Les poupées russes;409184;6.6;47;34;13;72;6.8;17;11;6;64;3.6;8145;76
34271;Hustle & Flow;410097;7.3;153;126;27;82;7.5;37;30;7;81;3.6;17513;80
34292;Hardware;99740;6.1;9;5;4;55;0;1;0;1;0;3.2;1157;60
34299;Appaloosa;800308;6.6;156;119;37;76;6.6;34;25;9;73;3.2;19629;55
34319;The Island;399201;5.4;184;74;110;40;5.2;36;14;22;38;3.3;41199;67
34321;The Bad News Bears;74174;7.4;24;22;2;91;7.2;5;5;0;100;3.3;4926;74
34323;The Devil's Rejects;395584;5.4;131;70;61;53;5.4;27;13;14;48;3.6;27834;79
34326;Last Days;403217;5.9;111;64;47;57;6;35;23;12;65;3.1;5692;53
34330;V for Vendetta;434409;6.8;233;169;64;72;6.2;37;23;14;62;3.9;226041;88
34332;Sky High;405325;6.5;124;90;34;72;6.6;27;18;9;66;3;28338;58
34334;Stealth;382992;3.8;138;18;120;13;3.6;31;2;29;6;2.9;14786;50
34336;Must Love Dogs;417001;5;145;50;95;34;5;32;11;21;34;3;16710;57
34338;The Aristocrats;436078;0;0;0;0;0;0;0;0;0;0;0;0;0
34353;Twice in a Lifetime;90223;7.4;6;5;1;83;0;1;1;0;100;3;200;45
34359;Georgy Girl;60453;7.1;9;8;1;88;0;0;0;0;0;0;0;0
34405;Serenity;379786;7.1;176;143;33;81;7.1;33;28;5;84;3.8;60506;89
34437;Broken Flowers;412019;7.4;184;160;24;86;7.4;40;34;6;85;3.3;21466;68
34482;The Browning Version;109340;6.7;16;13;3;81;0;3;1;2;33;3.5;322;63
34499;The Heart Is Deceitful Above All Things;368774;5;49;20;29;40;3;15;1;14;6;3.6;2672;70
34520;The Dukes of Hazzard;377818;3.6;164;22;142;13;3.7;37;8;29;21;2.9;27455;58
34523;The Chumscrubber;406650;4.9;58;20;38;34;4.8;8;3;5;37;3.5;6925;76
34526;Secuestro express;371939;5.7;42;22;20;52;6.2;13;8;5;61;3.2;1109;73
34528;Junebug;418773;7.5;126;108;18;85;7.8;33;31;2;93;3.4;7517;72
34530;Deuce Bigalow: European Gigolo;367652;2.8;100;10;90;10;3;24;2;22;8;2.7;16038;51
34532;The Skeleton Key;397101;5.3;147;56;91;38;5;33;8;25;24;3.1;23528;63
34534;Four Brothers;430105;0;0;0;0;0;0;0;0;0;0;0;0;0
34536;The Great Raid;326905;5.3;119;43;76;36;4.9;28;8;20;28;3.6;3417;73
34538;Asylum;804443;0;2;0;2;0;0;1;0;1;0;2.2;1071;17
34540;Pretty Persuasion;381505;5;76;25;51;32;4.4;27;4;23;14;3.4;2958;64
34542;Grizzly Man;427312;8;134;125;9;93;8.3;35;35;0;100;3.6;9472;82
34579;The 24th Day;246404;3.7;14;3;11;21;3.8;8;2;6;25;3.4;768;60
34583;Prime Cut;69121;5.8;10;7;3;70;0;1;1;0;100;3.3;584;60
34608;The Best of Everything;52619;0;4;2;2;50;0;0;0;0;0;0;0;0
34643;The Three Stooges Meet Hercules;56579;0;3;0;3;0;0;0;0;0;0;0;0;0
34645;Race with the Devil;73600;5;5;2;3;40;0;0;0;0;0;0;0;0
34648;Akasia;380164;0;0;0;0;0;0;0;0;0;0;0;0;0
34767;My Date with Drew;378407;6;64;45;19;70;5.7;21;14;7;66;3.1;2652;53
35015;Duma;361715;7.5;59;55;4;93;7.4;25;23;2;92;3.3;11201;57
35836;The 40 Year Old Virgin;405422;7.2;179;153;26;85;7.1;36;31;5;86;3.6;141534;81
35957;Red Eye;421239;6.7;178;141;37;79;7.2;37;33;4;89;3.2;32710;66
36056;Man of the West;51899;8.7;6;6;0;100;0;0;0;0;0;0;0;0
36152;A Nightmare on Elm Street: The Dream Child;97981;4.1;27;8;19;29;0;4;1;3;25;2.9;17837;56
36276;Caché;387898;7.8;128;113;15;88;8.2;31;29;2;93;3.5;16387;71
36397;Valiant;361089;5;109;33;76;30;4.6;25;3;22;12;2.8;6330;39
36401;The Brothers Grimm;355295;5.1;177;66;111;37;4.8;34;10;24;29;2.9;36907;47
36477;The Baxter;401244;5.1;73;24;49;32;4.8;24;6;18;25;3.7;1793;76
36509;The Cave;402901;3.5;105;12;93;11;3;24;1;23;4;2.8;10980;38
36511;Undiscovered;434424;3.2;66;5;61;7;3.5;24;3;21;12;3.1;1795;53
36513;Dirty Deeds;280605;5.7;13;8;5;61;0;3;1;2;33;0;0;0
36517;The Constant Gardener;387131;7.6;181;151;30;83;8.2;36;33;3;91;3.5;31578;81
36519;Transporter 2;388482;0;0;0;0;0;0;0;0;0;0;0;0;0
36523;Margaret Cho: Assassin;462333;4.7;24;9;15;37;5.1;12;6;6;50;3.3;467;61
36525;Just Like Heaven;425123;5.7;148;84;64;56;5.2;30;12;18;40;3.6;90795;77
36527;Proof;377107;6.4;138;87;51;63;6.4;34;20;14;58;3.2;15629;57
36529;Lord of War;399295;6.2;141;86;55;60;5.6;33;14;19;42;3.6;51125;84
36531;Venom;428251;3.1;62;6;56;9;3.5;19;3;16;15;2.6;2557;30
36533;Cry_Wolf;384286;4;43;10;33;23;4.6;10;4;6;40;3;9727;57
36535;Everything Is Illuminated;404030;6.5;118;79;39;66;6.3;30;17;13;56;3.9;17347;88
36537;Thumbsucker;318761;6.7;107;75;32;70;6.8;27;19;8;70;3.3;10573;68
36539;The Thing About My Folks;429177;5.5;64;28;36;43;5;20;8;12;40;2.8;3150;40
36541;Succubus: Hell Bent;775544;\N;\N;\N;\N;\N;\N;\N;\N;\N;\N;\N;\N;\N
36553;In Old Chicago;29047;0;3;1;2;33;0;0;0;0;0;0;0;0
36708;Family Guy Presents Stewie Griffin: The Untold Story;385690;0;0;0;0;0;0;0;0;0;0;0;0;0
36752;Revenge of the Ninja;86192;0;0;0;0;0;0;0;0;0;0;0;0;0
37211;Go West;32536;6.5;9;8;1;88;0;0;0;0;0;0;0;0
37240;Why We Fight;436971;7;108;86;22;79;7.1;32;24;8;75;3.3;6585;79
37287;Gertrud;58138;7.7;9;6;3;66;0;1;0;1;0;3.8;476;77
37335;Da zui xia;59079;0;0;0;0;0;0;0;0;0;0;0;0;0
37380;Doom;419706;3.9;128;24;104;18;3.8;24;4;20;16;2.7;28789;47
37382;Domino;421054;0;0;0;0;0;0;0;0;0;0;0;0;0
37384;Waiting...;348333;4.2;87;26;61;29;3.9;25;6;19;24;3.4;35090;76
37386;Æon Flux;402022;3.3;102;10;92;9;3.5;19;2;17;10;2.9;50363;47
37475;An Unfinished Life;350261;5.9;140;74;66;52;5.4;32;14;18;43;3.3;13634;65
37477;Yes Man;1068680;5.2;144;62;82;43;4.9;31;12;19;38;3.7;141478;72
37545;Woyzeck;80149;7.3;11;9;2;81;0;2;1;1;50;3.8;1117;79
37720;The Exorcism of Emily Rose;404032;4.9;6;2;4;33;0;0;0;0;0;0;0;0
37727;Flightplan;408790;5.3;169;63;106;37;5.5;35;13;22;37;3.2;35131;56
37729;Corpse Bride;121164;7.2;182;152;30;83;7.6;34;31;3;91;3.5;98441;76
37731;Hooligans;385002;5.5;61;28;33;45;5.4;19;9;10;47;3.9;56992;87
37733;A History of Violence;399146;7.9;201;175;26;87;8.4;36;34;2;94;3.4;45849;68
37736;Oliver Twist;380599;0;0;0;0;0;0;0;0;0;0;0;0;0
37739;The Greatest Game Ever Played;388980;6.2;109;68;41;62;5.7;27;15;12;55;3.6;15763;76
37741;Capote;379725;8.2;179;161;18;89;8.6;39;39;0;100;3.5;35934;72
37830;Final Fantasy VII: Advent Children;385700;5.7;6;2;4;33;0;0;0;0;0;0;0;0
37837;Crustacés et coquillages;428430;5.6;50;25;25;50;5;16;7;9;43;3.5;393;63
37844;Roll Bounce;403455;0;0;0;0;0;0;0;0;0;0;0;0;0
37846;Daltry Calhoun;339642;3.6;28;2;26;7;3.8;9;0;9;0;2.6;4398;34
37853;Into the Blue;378109;4;123;26;97;21;4.5;31;10;21;32;3.1;24229;67
37855;The Prize Winner of Defiance, Ohio;406158;6.1;79;46;33;58;6.1;28;14;14;50;3.2;7811;55
37857;MirrorMask;366780;5.9;87;47;40;54;5.6;26;11;15;42;3.6;20173;77
37955;Innocence;375233;6.7;17;11;6;64;6.9;8;6;2;75;3.7;1170;73
37957;Indiana Jones and the Kingdom of the Crystal Skull;367882;6.9;246;190;56;77;6.1;41;25;16;60;3.4;252104;59
37976;Francesco, giullare di Dio;42477;8.4;14;14;0;100;0;2;2;0;100;3.9;443;84
38038;Wallace & Gromit in The Curse of the Were-Rabbit;312004;8.1;172;163;9;94;7.8;35;33;2;94;3.4;30852;72
38061;Kiss Kiss Bang Bang;373469;7.4;146;122;24;83;7;35;28;7;80;3.7;46555;83
38095;Dalkomhan insaeng;456912;8.1;8;8;0;100;0;0;0;0;0;0;0;0
38188;Bubble;454792;0;0;0;0;0;0;0;0;0;0;0;0;0
38198;Darwin's Nightmare;424024;7.6;51;47;4;92;7.5;20;18;2;90;3.9;1596;83
38294;Beowulf & Grendel;402057;5.4;33;16;17;48;5.2;13;5;8;38;2.9;7530;43
38304;No Direction Home: Bob Dylan;367555;8;14;13;1;92;0;3;3;0;100;4.3;3390;94
38388;Goal!;380389;5.2;80;35;45;43;5.2;23;10;13;43;3.7;33414;77
38499;Angels in America;318997;\N;\N;\N;\N;\N;\N;\N;\N;\N;\N;\N;\N;\N
38600;Factotum;417658;6.8;111;84;27;75;6.5;29;17;12;58;3.2;9868;51
38701;Don't Come Knocking;377800;5.4;100;42;58;42;5.4;27;11;16;40;3;13487;40
38798;In Her Shoes;388125;6.9;162;121;41;74;6.4;38;23;15;60;3.2;31531;65
38824;Äideistä parhain;343221;0;3;3;0;100;0;1;1;0;100;4;941;85
38886;The Squid and the Whale;367089;7.9;138;129;9;93;8.2;35;35;0;100;3.6;28511;76
38992;Two for the Money;417217;4.7;109;23;86;21;5.3;29;5;24;17;3.1;9296;52
38994;Separate Lies;369053;6.8;88;63;25;71;7.1;29;22;7;75;3.2;726;46
39052;Star Wreck: In the Pirkinning;472566;0;0;0;0;0;0;0;0;0;0;0;0;0
39183;Brokeback Mountain;388795;8.2;233;202;31;86;8.1;42;38;4;90;3.4;82054;77
39231;Elizabethtown;368709;4.6;168;46;122;27;4.1;36;7;29;19;3.1;42584;65
39234;North Country;395972;6.7;166;114;52;68;6.8;38;26;12;68;3.5;14739;72
39292;Good Night, and Good Luck.;433383;8.1;213;200;13;93;8.2;41;39;2;95;3.6;37838;73
39307;Dreamer: Inspired by a True Story;418647;6.3;115;73;42;63;6.1;29;17;12;58;3.6;21404;74
39369;Detective Story;43465;6.1;9;6;3;66;0;0;0;0;0;0;0;0
39381;The Proposition;421238;7.3;123;107;16;86;7.4;31;27;4;87;3.6;20228;77
39390;The Gospel;451069;4.9;37;12;25;32;5.1;13;5;8;38;3.5;1967;78
39394;Dandelion;338133;6.2;12;8;4;66;0;4;2;2;50;3.7;657;75
39398;C.S.A.: The Confederate States of America;389828;7;65;51;14;78;7;20;16;4;80;3.2;1917;50
39400;The Fog;432291;2.7;66;3;63;4;2.8;11;0;11;0;2.5;14642;35
39402;Loggerheads;406038;6.5;46;33;13;71;6.4;18;13;5;72;2.8;4784;36
39408;Left Behind: World at War;443567;0;2;0;2;0;0;0;0;0;0;0;0;0
39410;Protocols of Zion;436686;6.4;56;39;17;69;5.8;19;11;8;57;2.9;4921;40
39414;Shopgirl;338427;6.3;146;88;58;60;6.5;37;24;13;64;3;17702;51
39416;Kids in America;408961;0;0;0;0;0;0;0;0;0;0;0;0;0
39419;Where the Truth Lies;373450;0;0;0;0;0;0;0;0;0;0;0;0;0
39421;After School Special;302297;0;2;0;2;0;0;1;0;1;0;2.9;2657;39
39425;Emmanuel's Gift;447016;6.4;22;18;4;81;5.6;8;6;2;75;3.6;352;76
39427;Stay;371257;4.6;119;31;88;26;4.2;33;5;28;15;3.4;20956;68
39429;I Confess;45897;7.2;20;17;3;85;0;3;2;1;66;3.6;2474;70
39435;The Legend of Zorro;386140;4.8;133;34;99;25;4.8;30;8;22;26;3.2;32197;61
39441;New York Doll;436629;7.3;51;46;5;90;7.1;14;13;1;92;3.9;843;84
39444;The Weather Man;384680;6.1;131;76;55;58;6;33;17;16;51;2.9;22086;51
39446;Saw II;432348;4.6;116;41;75;35;3.9;27;6;21;22;3.2;183455;66
39449;Prime;387514;5.6;116;57;59;49;5.7;31;15;16;48;3.1;17427;52
39474;Subarashiki nichiyôbi;39871;6.8;7;6;1;85;0;3;3;0;100;3.7;268;75
39659;Teorema;63678;7.4;14;12;2;85;0;4;4;0;100;4;1151;80
39703;Little Fish;382810;6.6;21;18;3;85;6.2;6;5;1;83;2.8;6910;47
39715;American Pie Presents Band Camp;436058;3.7;5;1;4;20;0;0;0;0;0;0;0;0
39869;Manderlay;342735;5.6;97;49;48;50;4.3;26;8;18;30;3.6;3901;77
39886;Nine Lives;420015;6.7;84;63;21;75;7.3;23;19;4;82;3.1;4724;54
39896;Don't Be a Menace to South Central While Drinking Your Juice in the Hood;116126;4.5;24;7;17;29;5.6;7;3;4;42;0;0;0
40010;Temporada de patos;407246;7.1;73;66;7;90;7.6;22;20;2;90;0;0;0
40148;Revolver;365686;3.5;61;10;51;16;3.1;19;1;18;5;3.3;15328;60
40278;Jarhead;418763;6.3;195;119;76;61;6;40;21;19;52;3.3;52128;68
40337;Ha-Ushpizin;426155;7.4;61;57;4;93;7.7;21;21;0;100;4;763;86
40339;Chicken Little;371606;5.4;156;56;100;35;5.5;34;8;26;23;3.2;54371;56
40412;Dead Man's Shoes;419677;5.7;40;23;17;57;4.5;11;4;7;36;3.9;22081;83
40414;Joyeux Noël;424205;6.8;91;69;22;75;7.1;26;22;4;84;3.6;9688;80
40491;Tulitikkutehtaan tyttö;98532;0;3;3;0;100;0;0;0;0;0;0;0;0
40494;Zombie ja Kummitusjuna;103337;0;3;3;0;100;0;0;0;0;0;0;0;0
40574;Get Rich or Die Tryin';430308;4.4;118;20;98;16;5;27;6;21;22;3.3;42176;73
40581;Just Friends;433400;5.1;96;40;56;41;5;27;10;17;37;3.4;46041;73
40583;Syriana;365737;6.9;193;139;54;72;7.5;43;37;6;86;3.3;38319;65
40586;Calamari Union;87020;0;0;0;0;0;0;0;0;0;0;0;0;0
40614;Derailed;398017;4.6;125;25;100;20;4.6;34;6;28;17;3.1;25982;61
40629;Pride & Prejudice;414387;7.7;164;140;24;85;7.6;37;32;5;86;3.8;101164;88
40723;Wolf Creek;416315;5.5;108;57;51;52;5.2;27;14;13;51;3;24198;50
40732;The Descent;435625;7.3;165;139;26;84;7;30;22;8;73;3.3;49487;71
40752;Takeshis';478044;5.4;5;2;3;40;0;0;0;0;0;0;0;0
40815;Harry Potter and the Goblet of Fire;330373;7.4;216;190;26;87;7.2;36;32;4;88;3.4;275215;74
40817;Dinner with Friends;271461;6.4;7;6;1;85;0;0;0;0;0;0;0;0
40819;Walk the Line;358273;7.3;202;166;36;82;7.1;40;30;10;75;3.9;112102;86
40826;Rent;294870;5.8;168;79;89;47;5.5;34;13;21;38;3.5;58040;83
40833;I pugni in tasca;59619;0;4;4;0;100;0;0;0;0;0;0;0;0
40851;Zathura: A Space Adventure;406375;6.5;157;118;39;75;6.6;30;22;8;73;3;23630;54
40870;Movie Crazy;23241;0;1;0;1;0;0;0;0;0;0;0;0;0
40887;Lonesome Jim;385056;6;89;53;36;59;5.7;24;10;14;41;2.9;12480;41
40946;Sarah Silverman: Jesus Is Magic;422528;6.1;98;63;35;64;6.2;27;18;9;66;3.2;9920;55
40952;Bee Season;387059;5.4;104;44;60;42;4.9;32;11;21;34;2.8;3415;37
40955;Breakfast on Pluto;411195;6.1;114;64;50;56;5.8;28;13;15;46;3.3;14498;73
40959;The Ice Harvest;400525;0;0;0;0;0;0;0;0;0;0;0;0;0
40962;Yours, Mine and Ours;443295;3.3;105;6;99;5;3.7;28;1;27;3;3.2;36270;64
40964;In the Mix;426615;3.2;37;5;32;13;3.3;14;1;13;7;2.9;13084;48
40966;The Libertine;375920;4.6;116;35;81;30;4.6;30;7;23;23;3.2;22316;57
40969;First Descent;455475;5.7;61;33;28;54;5.3;21;10;11;47;3;5006;54
40973;The Wild Geese;78492;6.8;5;3;2;60;0;0;0;0;0;0;0;0
40988;Hondo;45883;7.1;5;4;1;80;0;0;0;0;0;0;0;0
41014;L'uccello dalle piume di cristallo;65143;7.5;21;19;2;90;0;3;2;1;66;3.7;1755;79
41025;A Good Woman;379306;5.3;81;30;51;37;5.6;25;8;17;32;2.7;9179;44
41136;Taxi Driver;75314;8.7;50;49;1;98;7.7;9;8;1;88;4.1;58145;93
41285;Match Point;416320;7.2;205;158;47;77;7.9;40;36;4;90;3.4;41276;78
41336;Nazarín;51983;7.8;10;8;2;80;0;2;0;2;0;4.1;418;87
41411;Inside Deep Throat;418753;7;120;99;21;82;6.6;40;27;13;67;3.4;1737;61
41425;The Dying Gaul;384929;5.8;67;33;34;49;5.7;23;10;13;43;3.1;778;55
41527;Paradise Now;445620;7.5;99;88;11;88;7.4;30;26;4;86;3.8;9101;81
41564;The Kid & I;416891;4.4;27;9;18;33;4.8;12;4;8;33;2.7;2087;40
41566;The Chronicles of Narnia: The Lion, the Witch and the Wardrobe;363771;6.9;206;156;50;75;7.1;38;29;9;76;3.1;260071;62
41569;King Kong;360717;7.7;242;202;40;83;7.6;39;30;9;76;2.8;207337;52
41571;Memoirs of a Geisha;397535;5.4;158;56;102;35;5.4;36;11;25;30;3.7;71263;82
41573;The Family Stone;356680;5.9;151;79;72;52;6.1;35;21;14;60;3.2;49319;63
41575;Wu ji;417976;5.2;77;24;53;31;5.2;26;11;15;42;2.9;11585;41
41585;Kiss of Death;113552;6.4;36;24;12;66;7.2;12;9;3;75;2.9;2125;39
41617;Havoc;285175;5.2;10;4;6;40;0;0;0;0;0;0;0;0
41627;Jôi-uchi: Hairyô tsuma shimatsu;61847;7.4;7;7;0;100;0;2;2;0;100;4.1;907;91
41699;Ivan Groznyy: Skaz vmroy - Boyarskyy zagovor;51790;6.2;11;7;4;63;6.2;5;4;1;80;2.4;42;33
41716;Matador;91495;7.2;16;15;1;93;7.3;5;4;1;80;3.7;5436;75
41721;Look Both Ways;382806;6.6;56;43;13;76;6.8;20;16;4;80;3.5;2027;69
41769;Mozart and the Whale;392465;0;3;2;1;66;0;2;2;0;100;3.8;3940;77
41831;They Died with Their Boots On;34277;6.5;10;8;2;80;0;0;0;0;0;0;0;0
41863;The Three Burials of Melquiades Estrada;419294;7.4;136;115;21;84;7.5;33;26;7;78;3.7;7818;80
41997;Munich;408306;7.5;197;153;44;77;6.8;38;23;15;60;3.6;47552;78
42002;The Producers;395251;5.8;150;76;74;50;5;36;10;26;27;3.1;31343;63
42004;Transamerica;407265;6.8;134;102;32;76;6.8;35;27;8;77;3.6;21396;77
42007;Rumor Has It...;398375;4.4;110;22;88;20;4.2;30;4;26;13;3;41917;51
42009;Cheaper by the Dozen 2;452598;3.6;91;6;85;6;3.9;27;3;24;11;3.2;93712;64
42011;Fun with Dick and Jane;369441;4.9;131;38;93;29;5.2;30;9;21;30;3.2;80127;58
42013;The Ring;298130;6.6;169;120;49;71;6.3;32;18;14;56;3;146246;50
42015;Casanova;402894;5.6;130;56;74;43;6;37;18;19;48;3.1;29998;57
42018;Mrs Henderson Presents;413015;6.6;136;90;46;66;6.7;36;26;10;72;3.3;11358;64
42021;The White Countess;384686;6;87;44;43;50;6;27;15;12;55;2.9;8910;39
42053;Dirty Love;327643;2.2;28;1;27;3;1.6;10;0;10;0;3.4;3700;67
42094;El espíritu de la colmena;70040;8.9;18;18;0;100;8.8;7;7;0;100;0;0;0
42197;Keeping Mum;444653;5.9;85;48;37;56;5.9;25;15;10;60;3.6;6183;74
42213;Goodnight, Mister Tom;175680;0;0;0;0;0;0;0;0;0;0;0;0;0
42217;Banshun;41154;8.8;17;17;0;100;0;3;3;0;100;4.3;1093;92
42418;The New World;402399;6.6;169;102;67;60;6.7;40;22;18;55;2.9;27173;51
42556;7 Faces of Dr. Lao;57812;7.2;5;5;0;100;0;0;0;0;0;0;0;0
42602;The Boys of Baraka;444608;6.8;42;31;11;73;6.8;13;10;3;76;4;627;84
42632;Chinjeolhan geumjassi;451094;7;84;62;22;73;7.3;22;18;4;81;4;23638;86
42634;Chlopaki nie placza;238119;\N;\N;\N;\N;\N;\N;\N;\N;\N;\N;\N;\N;\N
42681;49th Parallel;33627;7.1;8;7;1;87;0;0;0;0;0;0;0;0
42718;Banlieue 13;414852;7;108;87;21;80;6.7;29;23;6;79;3.6;25880;72
42721;BloodRayne;383222;2.3;49;2;47;4;2.3;13;1;12;7;2.5;34745;31
42723;Hostel;450278;5.8;100;59;41;59;5.6;16;6;10;37;3.1;72216;59
42725;Grandma's Boy;456554;3.7;60;11;49;18;2.8;16;1;15;6;3.8;55076;85
42728;Tristan + Isolde;375154;4.9;121;39;82;32;5.3;30;13;17;43;3.4;53037;73
42730;Glory Road;385726;0;0;0;0;0;0;0;0;0;0;0;0;0
42732;Last Holiday;408985;5.8;114;62;52;54;6.1;27;16;11;59;3.3;31706;70
42734;Hoodwinked!;443536;5.5;122;58;64;47;4.8;28;10;18;35;3.1;60552;58
42736;April's Shower;325007;3.6;14;3;11;21;4.2;9;3;6;33;2.6;750;37
42738;Underworld: Evolution;401855;3.7;100;15;85;15;3.5;16;1;15;6;3.6;111035;77
42740;Looking for Comedy in the Muslim World;433116;5.4;108;46;62;42;5.4;30;11;19;36;2.5;4171;26
42783;Tini zabutykh predkiv;58642;8;16;16;0;100;8.8;5;5;0;100;4.4;312;91
42900;Cul-de-sac;60268;7.5;14;12;2;85;0;4;2;2;50;3.8;1039;78
43011;The Dunwich Horror;65669;4.4;5;1;4;20;0;0;0;0;0;0;0;0
43333;Water;240200;7.6;89;81;8;91;7.8;30;28;2;93;3.9;14962;81
43376;Sophie Scholl - Die letzten Tage;426578;7.3;94;82;12;87;7.2;25;23;2;92;3.8;7998;83
43391;Matti;390245;0;2;2;0;100;0;1;1;0;100;2.7;533;27
43396;The World's Fastest Indian;412080;6.9;136;111;25;81;6.3;29;20;9;68;3.8;6841;88
43419;Bandidas;416496;5.4;13;8;5;61;0;2;1;1;50;3;8063;47
43460;A Cock and Bull Story;423409;7.6;120;109;11;90;7.9;32;30;2;93;3.3;8622;60
43556;Annapolis;417433;3.9;110;11;99;10;4.1;29;1;28;3;3.2;13763;64
43558;Big Momma's House 2;421729;3.1;70;4;66;5;3.4;17;2;15;11;3.4;86119;69
43560;Nanny McPhee;396752;6.6;130;95;35;73;6.4;29;19;10;65;3.2;48480;63
43679;Final Destination 3;414982;5.1;114;51;63;44;5;25;8;17;32;3.4;76527;69
43684;Something New;437777;6.1;105;64;41;60;6.8;26;21;5;80;3.1;15411;65
43708;Da Block Party;791621;0;0;0;0;0;0;0;0;0;0;0;0;0
43710;Madame Curie;36126;6.3;6;5;1;83;0;0;0;0;0;0;0;0
43744;Imagine Me & You;421994;4.9;94;30;64;31;4.7;23;5;18;21;3.4;21511;68
43836;The Pink Panther;383216;4.1;139;31;108;22;4.1;32;6;26;18;3;52976;59
43853;The Business;429715;5.8;6;3;3;50;0;0;0;0;0;0;0;0
43869;Curious George;381971;6.1;103;71;32;68;6.1;27;19;8;70;3.2;24897;65
43871;Firewall;408345;4.6;153;29;124;18;4.8;38;6;32;15;3;32315;48
43899;Tony Takitani;420260;7.4;52;46;6;88;8.1;17;17;0;100;3.9;1083;80
43904;When a Stranger Calls;455857;3.2;88;8;80;9;3.1;14;1;13;7;3.1;53427;55
43906;Tamara;401815;4.3;28;9;19;32;4.7;8;2;6;25;2.7;7152;43
43908;London;449061;3.3;36;5;31;13;2.7;14;0;14;0;2.9;7900;57
43910;Neil Young: Heart of Gold;473692;8;97;87;10;89;7.9;32;28;4;87;2.9;12241;51
43912;Freedomland;349467;4.6;148;34;114;22;4.7;36;13;23;36;2.7;15783;31
43914;Winter Passing;380817;5.4;52;21;31;40;5.2;18;7;11;38;2.9;7599;57
43917;Eight Below;397313;6.5;139;99;40;71;6.1;31;16;15;51;3.4;27593;80
43919;Date Movie;466342;2.4;83;5;78;6;2.7;15;2;13;13;2.8;89201;51
43921;Running Scared;404390;4.5;128;51;77;39;4.4;31;10;21;32;3.6;35992;77
43923;Madea's Family Reunion;455612;4.5;53;14;39;26;4.9;17;7;10;41;3.7;23761;85
43926;Doogal;763304;3.1;49;4;45;8;2.6;15;0;15;0;2.5;8367;27
43928;Ultraviolet;370032;2.8;76;7;69;9;2.1;17;0;17;0;2.6;46298;42
43930;Just My Luck;397078;3.7;108;14;94;12;3.9;30;4;26;13;3;85958;60
43932;Pulse;454919;3.5;66;7;59;10;3.1;19;1;18;5;2.7;30788;38
43934;Deep Sea;424942;7.7;32;29;3;90;7;12;10;2;83;3.8;3812;75
43936;16 Blocks;450232;5.9;157;87;70;55;5.8;35;18;17;51;3.2;31478;60
43987;Half Light;412798;4.1;7;2;5;28;0;0;0;0;0;0;0;0
44004;Failure to Launch;427229;4.6;147;37;110;25;5.2;33;13;20;39;3.2;86609;60
44022;Ice Age: The Meltdown;438097;6.1;142;82;60;57;6.2;27;16;11;59;3.6;162267;76
44058;The Big White;402850;4;10;3;7;30;0;2;0;2;0;3.3;2197;56
44073;Stromboli;41931;6.5;5;4;1;80;0;0;0;0;0;0;0;0
44161;Free Zone;441761;5;46;12;34;26;4.8;14;2;12;14;2.7;10638;26
44168;The Naked Spur;44953;8;11;11;0;100;0;1;1;0;100;3.8;668;77
44189;Ask the Dust;384814;5.1;103;37;66;35;5.5;32;16;16;50;2.8;14077;37
44191;V for Vendetta;434409;6.8;233;169;64;72;6.2;37;23;14;62;3.9;226041;88
44193;She's the Man;454945;0;0;0;0;0;0;0;0;0;0;0;0;0
44195;Thank You for Smoking;427944;7.3;177;152;25;85;6.9;38;28;10;73;3.7;55103;84
44197;Find Me Guilty;419749;6;104;62;42;59;6.2;32;17;15;53;3.1;19411;51
44199;Inside Man;454848;7.3;195;168;27;86;7.5;40;35;5;87;3.7;84980;81
44204;Tsotsi;468565;7.4;126;102;24;80;7.8;29;26;3;89;3.8;11397;83
44225;Aquamarine;429591;5.5;86;45;41;52;5.6;27;15;12;55;3.1;60073;66
44301;Laitakaupungin valot;458242;6.4;37;25;12;67;5.5;12;6;6;50;3.6;1806;69
44397;The Hills Have Eyes;454841;5.3;133;65;68;48;5;30;12;18;40;3.1;75042;64
44399;The Shaggy Dog;393735;4.4;103;28;75;27;4.8;29;10;19;34;2.9;41890;50
44494;Son of the Pink Panther;108187;2.8;18;3;15;16;0;2;0;2;0;2.5;1039;29
44511;Unknown White Male;436864;6.5;76;56;20;73;6.7;22;17;5;77;2.7;6598;42
44555;Das Leben der Anderen;405094;8.2;148;138;10;93;8.3;43;41;2;95;4.4;48886;95
44587;Nanook of the North;13427;8.6;21;21;0;100;0;3;3;0;100;3.7;1130;77
44595;Alien: Resurrection;118583;5.8;64;35;29;54;6.1;17;9;8;52;3;25498;50
44613;Take the Lead;446046;5.4;119;52;67;43;5.2;31;12;19;38;3.5;92007;78
44633;The Devil and Daniel Johnston;436231;7.5;105;93;12;88;7.9;28;26;2;92;3.7;11571;74
44653;L'argent;85180;8.3;16;15;1;93;0;1;1;0;100;4;719;83
44657;Mouchette;61996;7.3;11;9;2;81;0;3;2;1;66;4.2;975;89
44665;Lucky Number Slevin;425210;0;0;0;0;0;0;0;0;0;0;0;0;0
44694;Volver;441909;7.8;160;147;13;91;7.9;41;39;2;95;4;29813;88
44709;Akeelah and the Bee;437800;7;132;110;22;83;7;28;23;5;82;3.6;27397;74
44729;Larry the Cable Guy: Health Inspector;462395;2.4;37;2;35;5;2.2;13;0;13;0;3.1;8141;66
44731;Stay Alive;441796;3;57;5;52;8;2.8;14;1;13;7;3.3;40388;60
44759;Basic Instinct 2;430912;3.1;149;10;139;6;3.2;35;1;34;2;2.5;28208;33
44761;Brick;393109;7.1;134;106;28;79;7.1;31;25;6;80;3.9;44891;82
44777;Evil Aliens;383353;5.6;10;6;4;60;0;0;0;0;0;0;0;0
44788;This Film Is Not Yet Rated;493459;7.2;115;96;19;83;7;35;28;7;80;3.7;11879;74
44815;ATL;466856;5.9;86;54;32;62;5.7;29;17;12;58;4;55291;81
44828;Slither;439815;6.9;129;110;19;85;6.4;29;22;7;75;3.2;31835;58
44840;The Benchwarmers;437863;3.1;69;8;61;11;3.2;11;2;9;18;3.4;92722;71
44844;Phat Girlz;490196;3.8;43;10;33;23;4.1;13;4;9;30;3.2;19754;64
44849;Renaissance;386741;5.4;68;29;39;42;5.7;17;7;10;41;3.3;10097;58
44864;Friends with Money;436331;0;0;0;0;0;0;0;0;0;0;0;0;0
44889;Reefer Madness: The Movie Musical;404364;6.4;5;3;2;60;0;0;0;0;0;0;0;0
44911;Magic;77889;6.8;18;15;3;83;0;2;1;1;50;3.2;1627;56
44929;Candy;424880;5.8;74;36;38;48;6.1;24;14;10;58;3.8;9542;78
44937;L'enfant;456396;7.5;104;89;15;85;7.7;29;25;4;86;3.2;15237;54
44949;Hoot;453494;4.7;95;25;70;26;4.8;28;8;20;28;3.2;22689;58
44972;Scary Movie 4;362120;4.7;125;46;79;36;5.1;23;10;13;43;3.1;149474;65
44974;Hard Candy;424136;6.4;133;91;42;68;6.3;33;22;11;66;3.7;41391;76
44978;Dead Birds;377749;5.9;7;4;3;57;0;0;0;0;0;0;0;0
45028;A Prairie Home Companion;420087;7.1;188;153;35;81;6.7;39;28;11;71;3;24547;49
45062;The Sentinel;443632;5;134;44;90;32;5.1;32;11;21;34;3.1;26716;47
45074;The Wild;405469;4.5;111;21;90;18;4.8;30;8;22;26;3.1;59950;53
45081;Silent Hill;384537;4.5;89;26;63;29;3;16;0;16;0;3.2;81448;65
45106;American Dreams;319930;\N;\N;\N;\N;\N;\N;\N;\N;\N;\N;\N;\N;\N
45175;Kinky Boots;434124;5.7;106;60;46;56;5.7;32;16;16;50;3.3;19339;63
45183;Tom yum goong;427954;5.6;90;50;40;55;5.4;23;11;12;47;3.6;21374;75
45186;Mission: Impossible III;317919;6.6;217;152;65;70;6.2;42;26;16;61;3.3;86328;69
45208;RV;449089;4.2;119;28;91;23;4;31;6;25;19;3;55493;59
45210;United 93;475276;8.2;200;181;19;90;7.8;40;35;5;87;3.6;39922;76
45221;Stick It;430634;4.9;96;30;66;31;5;25;9;16;36;3.5;82123;76
45335;Footlight Parade;24028;8.4;8;8;0;100;0;0;0;0;0;0;0;0
45361;An American Haunting;429573;3.5;68;8;60;11;3.5;15;2;13;13;3;32251;48
45382;Down in the Valley;398027;6;101;52;49;51;5.6;31;13;18;41;3;15861;47
45412;Kakushi ken oni no tsume;442286;7.2;31;27;4;87;7.4;7;7;0;100;3.1;10744;50
45431;Over the Hedge;327084;6.8;163;121;42;74;6.3;34;22;12;64;3.6;155694;73
45440;Art School Confidential;364955;5.4;133;47;86;35;5.4;33;14;19;42;3;9231;48
45442;Poseidon;409182;4.9;196;65;131;33;4.8;39;11;28;28;3;65499;57
45447;The Da Vinci Code;382625;4.8;219;54;165;24;4.1;42;4;38;9;3.2;124708;64
45499;X-Men: The Last Stand;376994;5.9;227;129;98;56;5.6;42;22;20;52;3.6;198041;73
45501;The Break-Up;452594;5;187;62;125;33;4.5;40;8;32;20;3.1;107481;52
45503;Peaceful Warrior;438315;4.7;72;17;55;23;4.2;23;3;20;13;3.5;16870;66
45517;Cars;317219;6.9;192;142;50;73;6.7;40;29;11;72;3.7;182909;80
45525;The Lost City;343996;4.6;84;21;63;25;4.5;30;7;23;23;3.2;13324;50
45611;Vera Cruz;47647;6.4;9;7;2;77;0;0;0;0;0;0;0;0
45635;The Notorious Bettie Page;404802;6;132;74;58;56;5.9;40;22;18;55;3.1;14609;46
45658;On a Clear Day;410400;6.2;65;43;22;66;6.1;22;12;10;54;3.4;4873;60
45662;The Omen;75005;7;32;27;5;84;0;2;1;1;50;3.5;17016;78
45664;The King;396688;6;77;43;34;55;6;25;13;12;52;3;14647;49
45666;Nacho Libre;457510;5.1;162;64;98;39;5;35;12;23;34;2.9;76491;57
45668;The Lake House;410297;5;154;55;99;35;4.9;40;11;29;27;3.5;118884;75
45672;Click;389860;4.8;165;53;112;32;4.8;36;11;25;30;3.4;221348;72
45679;The Seventh Victim;36341;7.4;11;10;1;90;0;2;1;1;50;3.6;499;68
45720;The Devil Wears Prada;458352;6.6;183;138;45;75;6.9;42;35;7;83;3.6;163192;76
45722;Pirates of the Caribbean: Dead Man's Chest;383574;6;217;117;100;53;5.2;39;16;23;41;3.9;395865;86
45726;You, Me and Dupree;463034;4.3;164;34;130;20;4.2;36;4;32;11;3.2;90944;59
45728;Clerks II;424345;6.1;158;99;59;62;5.8;35;19;16;54;3.7;70058;83
45730;Lady in the Water;452637;4.2;207;50;157;24;3.8;38;5;33;13;3;72266;54
45732;My Super Ex-Girlfriend;465624;5.1;126;50;76;39;5.3;31;14;17;45;2.7;73211;43
45852;See No Evil;437179;2.6;57;5;52;8;2.5;14;1;13;7;3.3;46137;61
45880;Marie Antoinette;422720;6;175;96;79;54;6;40;20;20;50;3;59278;56
45928;Who Killed the Electric Car?;489037;7.2;103;91;12;88;7.1;30;28;2;93;3.6;16624;73
45950;An Inconvenient Truth;497116;7.7;158;147;11;93;7.7;34;32;2;94;3.6;41842;75
45981;Hollow Man II;469916;0;4;0;4;0;0;0;0;0;0;0;0;0
46034;Kekexili;386651;7.6;49;48;1;97;7.6;19;18;1;94;4;844;88
46062;High School Musical;475293;5.4;8;5;3;62;0;0;0;0;0;0;0;0
46194;Adam & Steve;372122;5.5;38;21;17;55;5.3;17;9;8;52;2.9;13053;39
46231;Stoned;426627;4.1;47;7;40;14;3.7;17;1;16;5;3;12252;44
46258;Marked Woman;29217;0;4;4;0;100;0;0;0;0;0;0;0;0
46322;Huo Yuan Jia;446059;0;0;0;0;0;0;0;0;0;0;0;0;0
46335;The Fast and the Furious: Tokyo Drift;463985;4.7;107;38;69;35;5.1;30;13;17;43;3.6;152700;80
46337;Garfield: A Tail of Two Kitties;455499;3.5;73;8;65;10;4.4;22;6;16;27;3.2;42950;60
46347;Metal: A Headbanger's Journey;478209;6.9;29;26;3;89;6.6;10;9;1;90;4.1;3059;89
46430;Waist Deep;456020;4.3;77;21;56;27;4.7;24;9;15;37;3.6;25532;74
46530;Superman Returns;348150;7.1;254;193;61;75;6.8;43;31;12;72;3.3;112381;67
46559;The Road to Guantanamo;468094;7.1;94;81;13;86;7;30;25;5;83;3.4;13498;63
46572;Edmond;443496;5.6;72;33;39;45;5.5;17;8;9;47;2.8;11822;37
46574;The Oh in Ohio;422861;4.6;69;15;54;21;4.6;24;6;18;25;2.9;10204;36
46578;Little Miss Sunshine;449059;7.7;205;186;19;90;7.4;44;39;5;88;4;163418;90
46581;Brothers of the Head;432260;6.4;65;43;22;66;5.9;18;10;8;55;3;11333;42
46653;The 300 Spartans;55719;0;3;1;2;33;0;0;0;0;0;0;0;0
46664;The Fallen Idol;40338;8.6;26;26;0;100;8.5;12;12;0;100;4;609;88
46723;Babel;449467;6.7;192;132;60;68;6.6;42;27;15;64;3.5;86426;76
46772;Strangers with Candy;369994;5.8;98;51;47;52;5.3;30;12;18;40;2.9;24171;49
46803;Young Mr. Lincoln;32155;8.5;19;19;0;100;0;3;3;0;100;3.9;599;80
46839;Zui hao de shi guang;459666;7.8;50;43;7;86;7.8;21;18;3;85;3.6;1630;69
46850;Wordplay;492506;7.4;120;114;6;95;7.3;36;35;1;97;3.2;12179;56
46855;L'armée des ombres;64040;8.6;72;70;2;97;8.4;22;21;1;95;4.4;2190;94
46865;Little Man;430304;3.2;89;11;78;12;3.9;24;6;18;25;3.1;78948;68
46901;The Purple Plain;47376;0;1;1;0;100;0;0;0;0;0;0;0;0
46919;End of the Spear;399862;5.1;51;20;31;39;4.3;17;3;14;17;3.7;2835;82
46948;Monster House;385880;6.8;156;115;41;73;6.2;35;24;11;68;3.2;42058;63
46959;Colour Me Kubrick: A True...ish Story;376543;5.6;58;30;28;51;5.5;22;9;13;40;3.1;3512;43
46965;Snakes on a Plane;417148;6.2;169;116;53;68;5.9;36;21;15;58;2.9;72394;55
46967;Scoop;457513;5.4;137;53;84;38;5.4;36;12;24;33;3.2;28506;56
46970;Talladega Nights: The Ballad of Ricky Bobby;415306;6.5;182;131;51;71;6.7;39;27;12;69;3.4;130490;73
46972;Night at the Museum;477347;5.3;129;56;73;43;5.3;29;12;17;41;3.6;169931;76
46974;World Trade Center;469641;6.7;223;153;70;68;7;43;32;11;74;3.4;67835;67
46976;Stranger Than Fiction;420223;6.8;167;121;46;72;6.8;38;27;11;71;3.6;92551;82
47044;Miami Vice;430357;5.6;189;89;100;47;6.4;41;28;13;68;2.8;55637;48
47049;Shadowboxer;396857;4;57;11;46;19;3.6;21;2;19;9;2.9;11651;40
47099;The Pursuit of Happyness;454921;6.4;166;110;56;66;6.1;38;25;13;65;4.1;211913;88
47117;Fah talai jone;269217;6.6;61;46;15;75;7;18;15;3;83;3.7;894;73
47122;John Tucker Must Die;455967;4.3;92;23;69;25;4.2;26;4;22;15;3.6;194452;74
47124;The Ant Bully;429589;6.2;113;71;42;62;6.2;30;18;12;60;3.1;34181;51
47148;Mrs Palfrey at The Claremont;421229;6.4;55;38;17;69;7;20;15;5;75;3.8;1500;77
47200;Crank;479884;6;87;53;34;60;5;14;4;10;28;3.5;85861;72
47202;The Secret Life of Words;430576;6.3;38;27;11;71;5.9;14;10;4;71;4.1;2452;87
47254;Chaos;402910;0;4;1;3;25;0;0;0;0;0;0;0;0
47261;The Night Listener;448075;5.4;133;53;80;39;5.2;29;9;20;31;2.9;28560;36
47264;Barnyard;414853;4.4;92;21;71;22;5.1;26;9;17;34;3.3;56716;61
47274;Le souffle au coeur;67778;8.3;9;8;1;88;0;1;1;0;100;4;1029;86
47306;I racconti di Canterbury;67647;6.8;7;5;2;71;0;1;0;1;0;3.5;627;63
47330;Dirty Mary Crazy Larry;71424;4.4;12;5;7;41;0;2;0;2;0;3.4;1249;66
47382;Step Up;462590;4.5;99;19;80;19;4.5;27;6;21;22;3.9;236004;85
47384;Zoom;383060;3;58;2;56;3;2.7;15;0;15;0;3;23825;51
47394;Bon Cop, Bad Cop;479647;6.1;6;4;2;66;0;2;2;0;100;3.8;4674;82
47423;Half Nelson;468489;7.6;151;136;15;90;7.9;35;33;2;94;3.8;16884;82
47446;La moustache;428856;7.3;41;35;6;85;7.4;18;16;2;88;3.4;1156;62
47465;Tideland;410764;4;73;21;52;28;2.8;21;1;20;4;3.3;15608;62
47493;Cabin in the Sky;35703;6.9;10;8;2;80;0;0;0;0;0;0;0;0
47516;Material Girls;433412;2.5;50;2;48;4;2.2;13;1;12;7;3;80733;57
47518;Accepted;384793;5;109;40;69;36;4.7;28;7;21;25;3.5;88251;75
47610;The Illusionist;443543;6.9;178;131;47;73;7.3;37;32;5;86;3.8;105389;83
47615;Adventures of Don Juan;40076;0;1;1;0;100;0;0;0;0;0;0;0;0
47629;The Queen;436697;8.4;180;174;6;96;8.6;40;40;0;100;3.5;39506;74
47634;36 Quai des Orfèvres;390808;7.5;5;5;0;100;0;0;0;0;0;0;0;0
47640;Beerfest;486551;5;104;41;63;39;4.4;26;7;19;26;3.4;42736;76
47642;How to Eat Fried Worms;462346;6;71;41;30;57;5.8;25;13;12;52;3;15503;51
47644;Invincible;445990;6.4;132;94;38;71;6.2;32;19;13;59;3.6;34698;75
47646;Idlewild;417225;5.7;125;59;66;47;5.7;35;15;20;42;3.3;11257;63
47721;Le ballon rouge;48980;8.4;15;15;0;100;0;2;2;0;100;4.2;2073;90
47723;Way Out West;29747;8.5;7;7;0;100;0;0;0;0;0;0;0;0
47725;Angel-A;473753;5.5;86;38;48;44;5.1;28;8;20;28;3.4;17241;73
47728;Green for Danger;38577;7.6;10;8;2;80;0;2;1;1;50;3.8;410;81
47778;Quinceañera;451176;7.1;94;81;13;86;6.9;30;25;5;83;3.2;9983;53
47793;The Puffy Chair;436689;0;0;0;0;0;0;0;0;0;0;0;0;0
47805;Lassie;110305;6.8;8;6;2;75;0;2;2;0;100;2.9;2577;52
47810;The Wicker Man;70917;7.7;45;41;4;91;0;4;4;0;100;3.6;8988;79
47815;Crossover;473024;3.2;63;2;61;3;3.1;22;0;22;0;3.3;23508;61
47830;The Quiet;414951;4;93;20;73;21;3.5;26;3;23;11;3.1;10194;51
47836;Sketches of Frank Gehry;446784;6.9;78;63;15;80;6.9;26;19;7;73;2.9;10414;41
47894;The Wind That Shakes the Barley;460989;7.6;111;98;13;88;7.3;26;23;3;88;4;12108;86
47907;Sorstalanság;367082;7.9;63;58;5;92;8.3;20;19;1;95;3.4;5242;63
47937;Severance;464196;6;85;55;30;64;6.1;28;18;10;64;3.3;30894;62
47940;Le temps qui reste;417189;6.6;50;38;12;76;6.6;16;12;4;75;3.4;8681;62
47950;Hollywoodland;427969;6.5;178;122;56;68;6.5;37;23;14;62;3;27144;47
47952;The Covenant;475944;2.7;71;2;69;2;2.8;18;0;18;0;3.3;56344;68
47956;The Assassination of Jesse James by the Coward Robert Ford;443680;7.1;162;121;41;74;6.6;36;22;14;61;3.7;57534;73
47970;The Last Kiss;434139;5.7;124;57;67;45;6;31;15;16;48;3.2;37077;59
47976;Trust the Man;427968;4.6;100;27;73;27;4.5;25;3;22;12;2.9;11451;38
47978;SherryBaby;423169;0;0;0;0;0;0;0;0;0;0;0;0;0
47997;Idiocracy;387808;6.5;40;29;11;72;5.4;5;3;2;60;3.2;21918;57
47999;Jesus Camp;486358;7.2;97;84;13;86;7.2;24;21;3;87;3.6;17583;76
48032;La tigre e la neve;419198;3.6;23;4;19;17;3.1;8;2;6;25;4.1;3393;84
48043;The Fountain;414993;5.9;189;96;93;50;4.4;41;11;30;26;3.4;57823;73
48061;Snoopy Come Home;69289;7.6;9;8;1;88;0;2;1;1;50;3.7;738;80
48082;La science des rêves;354899;6.6;153;107;46;69;6.5;34;23;11;67;3.8;53923;81
48142;The Black Dahlia;387877;4.8;182;60;122;32;4.3;38;4;34;10;2.7;40782;32
48150;The Wood;161100;6;56;34;22;60;5.7;17;10;7;58;3.9;6421;90
48159;Everyone's Hero;430779;5.1;66;26;40;39;5.6;25;11;14;44;3.1;15884;51
48161;Gridiron Gang;421206;5.6;99;41;58;41;5.2;26;8;18;30;3.7;74026;84
48198;Streamers;86377;6.1;9;5;4;55;0;2;0;2;0;3.2;136;49
48214;Land of Plenty;382357;6.3;25;16;9;64;6;7;4;3;57;3.5;683;63
48231;Taxidermia;410730;6.7;46;37;9;80;7.8;7;6;1;85;3.8;2168;78
48262;The Bridge;799954;6.4;55;37;18;67;7;15;13;2;86;3.7;3171;74
48301;The Private Life of Henry VIII.;24473;8;10;10;0;100;0;0;0;0;0;0;0;0
48304;Apocalypto;472043;6.3;184;117;67;63;5.8;43;25;18;58;3.7;132213;79
48319;Flyboys;454824;4.9;126;41;85;32;4.1;30;5;25;16;3.4;25191;69
48322;Jackass Number Two;493430;5.8;103;65;38;63;5.6;24;14;10;58;3.6;75153;83
48326;All the King's Men;405676;0;0;0;0;0;0;0;0;0;0;0;0;0
48342;Conversations with Other Women;435623;6.5;58;42;16;72;5.7;17;9;8;52;3.7;4754;74
48374;Otets Sergiy;8395;0;0;0;0;0;0;0;0;0;0;0;0;0
48385;Borat: Cultural Learnings of America for Make Benefit Glorious Nation of Kazakhstan;443453;8;209;191;18;91;8.1;41;40;1;97;3.4;141091;76
48394;El laberinto del fauno;457430;8.6;193;184;9;95;8.8;39;39;0;100;4.1;183647;90
48412;The Guardian;406816;5.2;143;54;89;37;5.2;34;11;23;32;3.7;58919;83
48414;Open Season;400717;5.4;98;46;52;46;5.7;24;13;11;54;3.4;91895;66
48416;School for Scoundrels;462519;4.6;137;35;102;25;4.5;32;8;24;25;3.2;39981;57
48516;The Departed;407887;8.2;228;211;17;92;8;44;41;3;93;4.1;195210;92
48518;The Texas Chainsaw Massacre: The Beginning;420294;3.5;79;10;69;12;3.1;14;1;13;7;3.2;72600;64
48520;Employee of the Month;424993;4;88;18;70;20;3.9;25;4;21;16;3.2;54090;61
48522;Stormbreaker;457495;4.7;65;21;44;32;4.7;23;8;15;34;3.3;16210;64
48560;Running with Scissors;439289;5;129;39;90;30;5;38;12;26;31;3.1;39912;55
48567;Public Enemies;1152836;6.4;245;166;79;67;5.9;40;24;16;60;3.2;244294;65
48584;Ellie Parker;436262;5.6;46;24;22;52;5.6;16;8;8;50;2.9;1159;41
48591;The Grudge 2;433386;3.4;71;7;64;9;3.4;17;1;16;5;2.8;45131;57
48593;Man of the Year;483726;4.4;141;30;111;21;5;35;11;24;31;3;29127;51
48596;The Marine;419946;4;45;9;36;20;4.5;11;3;8;27;3.2;48769;69
48598;Infamous;420609;6.8;145;104;41;71;6.7;37;26;11;70;3.3;9766;60
48600;One Night with the King;430431;4.3;25;4;21;16;4.4;9;2;7;22;3.9;8409;81
48649;Chapaev;24966;0;0;0;0;0;0;0;0;0;0;0;0;0
48678;Feast;426459;5.8;49;27;22;55;4.6;11;5;6;45;3.3;6353;62
48682;Offside;499537;8;82;78;4;95;8.2;25;24;1;96;3.6;2373;71
48696;Little Children;404203;7.4;154;122;32;79;7.7;40;36;4;90;3.7;34155;79
48698;Deliver Us from Evil;814075;8.4;69;69;0;100;8.2;25;25;0;100;3.7;8806;77
48711;Facing the Giants;805526;4.1;23;2;21;8;3.6;5;0;5;0;3.9;26252;85
48738;The Last King of Scotland;455590;7.3;177;154;23;87;7.4;40;36;4;90;3.8;58962;87
48741;The U.S. vs. John Lennon;478049;6.6;94;72;22;76;6.5;29;20;9;68;3.6;8813;70
48744;Shortbus;367027;6.4;119;78;41;65;5.8;37;21;16;56;3.7;15870;75
48774;Children of Men;206634;8;208;193;15;92;7.8;41;37;4;90;3.7;127695;81
48780;The Prestige;482571;7.1;187;141;46;75;6.2;40;23;17;57;3.9;138467;90
48783;Flags of Our Fathers;418689;7;191;139;52;72;7.5;44;34;10;77;3.5;54914;70
48791;Flicka;434215;5.7;76;41;35;53;5.6;24;12;12;50;3.7;22360;82
48856;A Guide to Recognizing Your Saints;473488;6.6;93;70;23;75;6.3;28;19;9;67;3.3;23093;67
48872;13 Tzameti;475169;7;67;56;11;83;6.3;22;16;6;72;3.9;3433;84
48877;Saw III;489270;4.2;83;21;62;25;3.2;18;1;17;5;3.7;159522;79
48879;Catch a Fire;437232;6.7;137;104;33;75;6.5;37;28;9;75;3.4;13062;64
48883;Death of a President;853096;5.3;99;36;63;36;4.7;33;7;26;21;3.2;5541;54
48899;Der Untertan;44170;\N;\N;\N;\N;\N;\N;\N;\N;\N;\N;\N;\N;\N
48909;The Beast with Five Fingers;38338;6.5;9;7;2;77;0;1;1;0;100;0;0;0
48943;The Butterfly Effect 2;457297;0;1;1;0;100;0;0;0;0;0;0;0;0
48982;Flushed Away;424095;6.7;128;92;36;71;6.7;33;25;8;75;3.3;58694;68
48997;Perfume: The Story of a Murderer;396171;6.2;121;70;51;57;5.6;36;16;20;44;3.4;41387;74
49007;Arabesque;60121;6.1;7;5;2;71;0;0;0;0;0;0;0;0
49013;The Santa Clause 3: The Escape Clause;452681;3.6;64;9;55;14;4.2;16;3;13;18;3.1;31916;59
49110;Mom and Dad Save the World;104905;2.2;9;1;8;11;0;0;0;0;0;0;0;0
49130;A Good Year;401445;4.8;126;30;96;23;4.8;37;11;26;29;3.3;22634;62
49132;Shut Up & Sing;811136;0;0;0;0;0;0;0;0;0;0;0;0;0
49200;A Foreign Affair;40367;7.6;9;9;0;100;0;2;2;0;100;3.7;504;75
49205;The Return;433442;3.9;55;8;47;14;3.9;15;2;13;13;2.9;26258;38
49220;For Your Consideration;470765;5.8;156;78;78;50;6.4;37;23;14;62;3;5643;44
49263;Fuck;486585;5.8;71;39;32;54;5.3;21;10;11;47;3.5;3961;68
49265;Shooting Dogs;420901;7.2;60;50;10;83;6.5;18;13;5;72;3.9;11089;81
49272;Casino Royale;381061;7.8;214;202;12;94;7.8;43;41;2;95;3.9;155430;87
49274;Happy Feet;366548;6.9;158;117;41;74;6.9;36;30;6;83;3.6;194573;75
49276;Let's Go to Prison;454987;2.9;40;4;36;10;3.1;13;1;12;7;3.1;24118;51
49278;Deja Vu;453467;0;0;0;0;0;0;0;0;0;0;0;0;0
49280;Bobby;308055;5.6;167;77;90;46;5.6;39;18;21;46;3.6;13513;74
49282;Deck the Halls;790604;2.9;81;5;76;6;3.2;24;2;22;8;2.8;16598;45
49284;10 Items or Less;499603;6.1;59;36;23;61;5.7;24;13;11;54;3.3;11471;57
49286;The Holiday;457939;0;0;0;0;0;0;0;0;0;0;0;0;0
49312;Snow Cake;448124;6.1;61;40;21;65;4.9;18;7;11;38;4;6153;85
49314;Harsh Times;433387;5.5;98;47;51;47;5.1;29;10;19;34;3.2;27914;56
49347;Fast Food Nation;460792;5.7;140;71;69;50;5.5;34;13;21;38;3;26331;43
49355;La bête humaine;29957;8;12;12;0;100;0;2;2;0;100;4;587;86
49396;Tenacious D in The Pick of Destiny;365830;5.7;119;64;55;53;5.5;34;16;18;47;3.3;63427;69
49422;OSS 117: Le Caire, nid d'espions;464913;6.6;56;42;14;75;6.2;14;8;6;57;3.7;2771;74
49524;The Nativity Story;762121;5.3;126;47;79;37;5.8;35;19;16;54;3.5;18145;74
49526;Van Wilder 2: The Rise of Taj;480271;2.7;44;3;41;6;2.9;18;1;17;5;3;24260;48
49528;Turistas;454970;3.8;100;16;84;16;4;28;6;22;21;2.8;21560;36
49530;Blood Diamond;450259;6.3;209;130;79;62;6.4;43;29;14;67;4;155615;90
49571;Dracula's Daughter;27545;5.6;11;5;6;45;0;0;0;0;0;0;0;0
49642;Unaccompanied Minors;488658;4.5;86;26;60;30;4;26;5;21;19;3.3;18555;62
49644;Off the Black;479965;6.2;40;27;13;67;6.4;17;13;4;76;3.3;1007;57
49647;Charlotte's Web;413895;7;142;111;31;78;6.9;35;25;10;71;3.3;39179;67
49649;Eragon;449010;0;0;0;0;0;0;0;0;0;0;0;0;0
49651;Rocky Balboa;479143;6.5;173;131;42;75;6.4;36;27;9;75;3.5;88339;77
49666;Fur: An Imaginary Portrait of Diane Arbus;422295;4.9;108;34;74;31;4.3;37;7;30;18;3.5;6462;64
49688;The Dam Busters;46889;8.6;5;5;0;100;0;0;0;0;0;0;0;0
49772;The Painted Veil;446755;7.1;143;106;37;74;7.3;35;26;9;74;3.9;20954;85
49793;We Are Marshall;758794;5.8;124;61;63;49;5.1;29;13;16;44;3.6;38195;81
49817;The Plague Dogs;84509;0;1;1;0;100;0;0;0;0;0;0;0;0
49822;The Good Shepherd;343737;6.1;167;90;77;53;6.3;38;21;17;55;3.1;51101;52
49824;Dreamgirls;443489;7.2;200;156;44;78;7.4;44;38;6;86;3.5;87867;73
49856;La tourneuse de pages;487503;6.8;63;49;14;77;6.9;19;13;6;68;3.5;2737;67
49910;Freedom Writers;463998;6.3;121;84;37;69;6.4;32;22;10;68;3.9;77693;88
49932;Inland Empire;460829;7.1;101;73;28;72;6.4;25;13;12;52;3.8;17370;75
49957;The History Boys;464049;6.4;104;66;38;63;6.4;35;21;14;60;3.5;10240;70
49961;Notes on a Scandal;465551;7.5;167;145;22;86;8;36;33;3;91;3.7;22200;81
50003;DOA: Dead or Alive;398913;4.5;44;15;29;34;4.2;10;2;8;20;2.7;71044;43
50005;Man cheng jin dai huang jin jia;473444;6.4;120;79;41;65;6.4;34;20;14;58;3.5;17358;67
50011;Den brysomme mannen;808185;6.6;21;15;6;71;7;6;5;1;83;3.9;2273;83
50064;The Good German;452624;5;146;47;99;32;5;40;12;28;30;2.9;14972;35
50066;Sweet Land;428038;7.3;70;59;11;84;7.5;23;20;3;86;3.9;2319;81
50068;Letters from Iwo Jima;498380;8.2;196;178;18;90;8.3;40;37;3;92;3.8;73433;85
50147;Black Christmas;454082;0;0;0;0;0;0;0;0;0;0;0;0;0
50149;Happily N'Ever After;308353;3;80;3;77;3;3.5;23;0;23;0;2.9;50375;44
50151;Home of the Brave;763840;4.1;56;12;44;21;4.8;17;6;11;35;3.2;13047;51
50153;Code Name: The Cleaner;462229;2.9;81;3;78;3;3.5;20;2;18;10;2.8;15990;45
50158;Stomp the Yard;775539;4.5;88;23;65;26;4.7;27;8;19;29;3.8;131307;83
50160;Miss Potter;482546;6.2;123;81;42;65;5.8;38;20;18;52;3.2;35425;67
50162;Arthur et les Minimoys;344854;4.5;90;19;71;21;4.2;25;4;21;16;3.2;25956;62
50189;American Pie Presents The Naked Mile;808146;0;3;0;3;0;0;0;0;0;0;0;0;0
50229;Les demoiselles de Rochefort;62873;7.9;34;33;1;97;8.6;6;6;0;100;3.9;1140;82
50253;David and Bathsheba;43455;0;0;0;0;0;0;0;0;0;0;0;0;0
50259;Old Joy;468526;7.3;84;71;13;84;7.1;27;23;4;85;3.7;1584;75
50274;Venus;489327;7.3;145;129;16;88;8;35;35;0;100;3.6;3984;73
50347;Rosario Tijeras;382271;0;0;0;0;0;0;0;0;0;0;0;0;0
50354;Le retour de Don Camillo;45081;\N;\N;\N;\N;\N;\N;\N;\N;\N;\N;\N;\N;\N
50356;Don Camillo;43918;0;0;0;0;0;0;0;0;0;0;0;0;0
50440;Primeval;772193;3.6;52;10;42;19;3.5;13;2;11;15;2.7;14738;36
50442;Alpha Dog;426883;5.5;141;78;63;55;5.6;36;20;16;55;3.3;59805;68
50445;The Hitcher;455960;3.8;93;19;74;20;3.5;16;2;14;12;3.1;49309;59
50447;The Dead Girl;783238;0;3;1;2;33;0;0;0;0;0;0;0;0
50477;Le testament d'Orphée, ou ne me demandez pas pourquoi!;54377;7.2;5;4;1;80;0;0;0;0;0;0;0;0
50514;Efter brylluppet;457655;7.4;101;88;13;87;7.6;30;27;3;90;3.7;12261;86
50583;Linda Linda Linda;468795;6.9;9;7;2;77;0;4;3;1;75;4;833;86
50601;Bridge to Terabithia;398808;7.2;143;122;21;85;7.2;27;23;4;85;3.4;97023;71
50619;Le sang d'un poète;21331;7.3;14;13;1;92;0;1;0;1;0;3.9;760;82
50658;49 Up;473434;8.2;61;59;2;96;8.2;24;22;2;91;3.2;6671;57
50685;Waitress;473308;7.3;162;144;18;88;7.6;35;34;1;97;3.4;228321;67
50792;Catch and Release;395495;4.5;131;28;103;21;4.5;33;9;24;27;3.2;45131;57
50794;Smokin' Aces;475394;4.3;153;43;110;28;4;34;6;28;17;3.3;94720;64
50796;Blood and Chocolate;397044;3.6;73;8;65;10;3.3;17;1;16;5;3.1;38058;56
50798;Epic Movie;799949;2.3;62;1;61;1;2.6;15;1;14;6;2.5;152790;38
50800;The Messengers;425430;3.7;83;10;73;12;3.6;19;1;18;5;3.1;129304;48
50802;Because I Said So;490084;3.2;155;8;147;5;3.7;37;4;33;10;3.3;96755;68
50804;Hannibal Rising;367959;3.9;141;21;120;14;3.7;30;2;28;6;3.3;109979;61
50806;Norbit;477051;3.2;120;10;110;8;3.3;29;1;28;3;3.1;204857;56
50842;Direktøren for det hele;469754;6.5;63;46;17;73;7.1;17;14;3;82;3.6;2971;70
50851;Cocaine Cowboys;380268;6.4;49;34;15;69;6.1;17;10;7;58;3.3;18459;68
50858;Lonely Hearts;441774;5.6;42;20;22;47;5.5;14;7;7;50;3.2;4965;52
50872;Ratatouille;382932;8.4;213;205;8;96;8.3;42;41;1;97;3.9;414956;84
50898;Lola;82671;8.1;6;6;0;100;0;1;1;0;100;3.9;529;82
50912;Paris, je t'aime;401711;7;109;93;16;85;7;29;24;5;82;3.8;48639;83
50923;The Astronaut Farmer;469263;6;134;77;57;57;5.9;31;18;13;58;3;30327;52
50970;Myra Breckinridge;66115;4.4;21;6;15;28;0;3;0;3;0;2.8;407;39
51007;Indigènes;444182;7.2;85;70;15;82;7.7;28;26;2;92;3.7;5161;77
51014;The Strange Case of Dr. Jekyll and Mr. Hyde;62908;0;0;0;0;0;0;0;0;0;0;0;0;0
51037;Unknown;450340;5.1;44;17;27;38;4.6;17;4;13;23;3.3;6616;57
51077;Ghost Rider;259324;4.3;130;34;96;26;4.3;21;6;15;28;3.2;233712;56
51080;Breach;401997;7;174;145;29;83;6.8;44;33;11;75;3.4;84757;65
51082;Daddy's Little Girls;778661;4.8;52;14;38;26;5.4;20;8;12;40;3.9;88879;80
51084;Music and Lyrics;758766;6;163;102;61;62;6.4;33;28;5;84;3.4;109147;70
51086;The Number 23;481369;3.5;186;15;171;8;3.6;37;3;34;8;3.2;101409;61
51088;Reno 911!: Miami;499554;5;95;33;62;34;5;24;8;16;33;3;48867;52
51091;Black Snake Moan;462200;6.3;152;100;52;65;5.7;39;19;20;48;3.3;48404;70
51094;Gray Matters;375785;3.8;64;5;59;7;3.5;21;1;20;4;3.1;5341;47
51127;loudQUIETloud: A Film About the Pixies;449121;6.2;21;14;7;66;5.2;7;2;5;28;3.8;484;77
51174;Factory Girl;432402;4.7;112;21;91;18;4.6;36;5;31;13;3.3;24687;60
51255;Hot Fuzz;425112;7.7;194;176;18;90;7.2;39;36;3;92;4;177532;88
51277;Shao Lin san shi liu fang;78243;0;1;0;1;0;0;0;0;0;0;0;0;0
51304;Karla;424938;3.4;12;0;12;0;0;3;0;3;0;2.9;1042;38
51314;Nuovomondo;465188;6.8;86;62;24;72;6.9;27;18;9;66;3.6;2001;68
51372;Cats;173714;4.2;5;1;4;20;0;0;0;0;0;0;0;0
51412;Next;435705;4.6;128;36;92;28;4.2;21;5;16;23;3.2;60971;59
51418;Breaking and Entering;443456;5.2;124;42;82;33;5.2;37;11;26;29;3.2;28113;52
51471;Amazing Grace;454776;6.6;118;83;35;70;6.6;31;20;11;64;4;24835;85
51498;2001 Maniacs;264323;\N;\N;\N;\N;\N;\N;\N;\N;\N;\N;\N;\N;\N
51540;Zodiac;443706;7.6;226;202;24;89;7;48;39;9;81;3.5;90179;73
51562;Babylon 5: The Gathering;106336;0;0;0;0;0;0;0;0;0;0;0;0;0
51575;Wild Hogs;486946;3.8;139;20;119;14;3.4;34;3;31;8;3.4;86633;72
51638;The Westerner;33253;0;4;4;0;100;0;0;0;0;0;0;0;0
51660;The Ultimate Gift;482629;5.1;58;19;39;32;4.6;14;3;11;21;4.1;16774;85
51662;300;416449;6.1;223;133;90;59;5.6;41;19;22;46;4.1;476879;90
51666;Abandon;267248;4.3;109;18;91;16;4.1;26;6;20;23;2.7;2670;37
51678;Julius Caesar;284741;0;1;0;1;0;0;0;0;0;0;0;0;0
51694;Starter for 10;477095;6.9;74;66;8;89;6.9;23;19;4;82;3.4;6446;64
51698;The Last Mimzy;768212;5.8;122;65;57;53;5.8;28;14;14;50;3.1;37595;58
51705;Hors de prix;482088;6.9;70;57;13;81;6.6;17;13;4;76;3.7;9304;74
51709;Gwoemul;468492;7.7;144;133;11;92;7.8;37;35;2;94;3.4;41174;69
51834;Becoming Jane;416508;6;134;78;56;58;6.2;33;19;14;57;3.7;77694;75
51857;A Taste of Honey;55506;7;10;8;2;80;0;3;2;1;66;4;686;86
51884;The Namesake;433416;7.5;124;106;18;85;7.6;33;28;5;84;3.7;28074;78
51903;I Think I Love My Wife;770772;0;0;0;0;0;0;0;0;0;0;0;0;0
51911;The Fugitive Kind;52832;6.4;10;6;4;60;0;0;0;0;0;0;0;0
51925;Premonition;477071;3.8;161;13;148;8;4.3;37;6;31;16;3.1;84740;55
51927;Dead Silence;455760;3.9;73;15;58;20;4.2;13;4;9;30;3.2;53019;57
51931;Reign Over Me;490204;6.3;149;94;55;63;6.6;35;22;13;62;3.8;58189;81
51933;Pride;475355;5.5;107;49;58;45;5.5;34;15;19;44;3.6;27617;73
51935;Shooter;822854;5.6;142;68;74;47;5.6;39;18;21;46;3.8;120688;82
51937;The Hills Have Eyes II;800069;3.2;64;7;57;10;3.6;16;2;14;12;2.9;63799;50
51939;TMNT;453556;5;114;38;76;33;4.4;22;4;18;18;3.2;86247;63
51991;Italianetz;450450;7.2;93;85;8;91;7.3;29;27;2;93;3.3;9946;67
52005;Jindabyne;382765;6.4;94;61;33;64;5.9;27;14;13;51;3.1;3036;50
52037;Fauteuils d'orchestre;444112;6.5;95;71;24;74;7.2;29;27;2;93;3.5;8387;64
52042;Zwartboek;389557;7.1;147;112;35;76;7;36;28;8;77;4;14532;87
52101;Shizukanaru kettô;41870;0;1;1;0;100;0;0;0;0;0;0;0;0
52227;The Darwin Awards;428446;4.9;12;3;9;25;0;3;0;3;0;3.1;2472;48
52241;The Lookout;427470;7.3;163;142;21;87;7.2;34;29;5;85;3.5;29621;71
52245;Blades of Glory;445934;6.2;183;127;56;69;6.4;40;27;13;67;3.4;665973;66
52279;Are We Done Yet?;422774;3.3;93;7;86;7;3.8;24;4;20;16;3.2;59360;61
52281;Grindhouse;462322;7.4;188;155;33;82;7.1;40;31;9;77;3.9;98721;86
52283;The Reaping;444682;3.5;130;11;119;8;3.8;26;2;24;7;3.2;39427;54
52285;Firehouse Dog;476995;4.9;81;31;50;38;5;25;11;14;44;3.4;23925;68
52287;Meet the Robinsons;396555;6.3;135;89;46;65;6.3;31;19;12;61;3.5;80580;75
52321;Seraphim Falls;479537;5.7;81;44;37;54;5.2;19;8;11;42;3.3;4135;55
52328;Sunshine;448134;0;0;0;0;0;0;0;0;0;0;0;0;0
52352;Judge Priest;25335;0;3;3;0;100;0;0;0;0;0;0;0;0
52356;Copying Beethoven;424908;4.7;79;20;59;25;5.3;21;7;14;33;3.4;850;60
52375;The Hoax;462338;0;0;0;0;0;0;0;0;0;0;0;0;0
52413;To vlemma tou Odyssea;114863;5.2;15;6;9;40;0;4;2;2;50;4;697;88
52435;How the Grinch Stole Christmas;170016;5.6;127;67;60;52;5.2;31;16;15;51;3.1;34926;57
52448;Goya's Ghosts;455957;4.8;84;24;60;28;4.7;26;8;18;30;3.3;20033;59
52456;Perfect Stranger;457433;3.5;141;15;126;10;3.7;35;4;31;11;3.2;43661;57
52458;Disturbia;486822;6.2;168;115;53;68;6;35;23;12;65;3.7;701373;75
52460;Pathfinder;446013;3.6;75;8;67;10;3.5;21;1;20;4;2.9;39732;42
52462;Aqua Teen Hunger Force Colon Movie Film for Theaters;455326;5.1;83;39;44;46;5.2;28;14;14;50;3.5;12293;68
52545;Puccini for Beginners;492481;5.6;62;31;31;50;5.7;25;13;12;52;3.2;328;47
52561;Yihe yuan;794374;6.2;28;19;9;67;6.6;10;8;2;80;3.4;653;59
52579;La môme;450188;5.8;12;6;6;50;0;4;1;3;25;3.8;33;80
52591;The Contract;445946;4.3;5;0;5;0;0;0;0;0;0;0;0;0
52604;Fracture;488120;6.5;163;115;48;70;6.7;39;30;9;76;3.5;129211;71
52606;Big Nothing;488085;0;3;3;0;100;0;0;0;0;0;0;0;0
52644;Vacancy;452702;5.5;119;66;53;55;5.5;26;15;11;57;3;51558;46
52666;Benny's Video;103793;5.3;6;2;4;33;0;0;0;0;0;0;0;0
52668;In the Land of Women;419843;5.4;114;50;64;43;5.2;33;15;18;45;3.2;37584;54
52694;Mr. Bean's Holiday;453451;5.4;109;55;54;50;5.6;29;15;14;51;2.9;95541;53
52712;The Invisible;435670;4.1;57;12;45;21;4.3;14;3;11;21;3.3;49604;61
52715;Kickin It Old Skool;772178;0;0;0;0;0;0;0;0;0;0;0;0;0
52717;The Condemned;443473;3.5;99;15;84;15;3.3;28;3;25;10;3.4;27981;63
52722;Spider-Man 3;413300;6.2;239;150;89;62;5.4;45;18;27;40;3.3;1192712;54
52724;Lucky You;338216;5;138;40;98;28;4.9;34;8;26;23;2.8;26515;33
52767;21;75610;0;1;1;0;100;0;0;0;0;0;0;0;0
52838;Year of the Dog;756729;6.4;141;98;43;69;7.1;37;30;7;81;2.9;6288;43
52867;Fast Track;458364;4.4;100;19;81;19;4.2;30;4;26;13;2.8;24933;36
52885;Papurika;851578;7.2;86;71;15;82;7.3;27;22;5;81;4;13141;87
52929;Red Road;471030;7.3;84;74;10;88;7.7;21;18;3;85;3.6;3304;69
52950;Dnevnoy dozor;409904;5.9;95;60;35;63;6.2;23;18;5;78;3.5;13807;69
52952;This Is England;480025;7.7;87;81;6;93;7.6;24;22;2;91;4.1;25557;89
52967;Away from Her;491747;8.1;140;132;8;94;8.2;37;37;0;100;3.6;15253;80
52973;Knocked Up;478311;0;1;0;1;0;0;0;0;0;0;0;0;0
52975;Hairspray;427327;7.7;205;186;19;90;8;41;40;1;97;3.9;382832;84
53000;28 Weeks Later;463854;6.6;182;128;54;70;7;39;30;9;76;3.4;266576;66
53002;Georgia Rule;791304;3.8;116;20;96;17;3.4;30;2;28;6;3;64056;55
53004;Delta Farce;800003;2.6;44;2;42;4;3.1;12;1;11;8;2.8;23589;45
53038;Red Dust;388364;0;4;4;0;100;0;0;0;0;0;0;0;0
53121;Shrek the Third;413267;5.5;203;83;120;40;5.7;39;19;20;48;3.4;1369685;57
53123;Once;907657;8.3;152;147;5;96;8.4;37;37;0;100;4.1;49591;90
53125;Pirates of the Caribbean: At World's End;449088;5.4;213;95;118;44;5.2;40;14;26;35;3.8;1768593;74
53127;Bug;470705;6.2;128;76;52;59;6.6;36;24;12;66;2.5;168834;31
53129;Mr. Brooks;780571;5.7;151;84;67;55;5.3;33;16;17;48;3.6;270348;75
53131;4: Rise of the Silver Surfer;486576;4.8;165;60;105;36;4.5;34;11;23;32;3.2;470350;55
53133;Gracie;441007;5.8;90;53;37;58;5.4;32;16;16;50;3.3;80050;61
53143;Fay Grim;444628;5.4;86;38;48;44;4.8;26;8;18;30;3.1;8851;57
53161;Saibogujiman kwenchana;497137;6.3;7;6;1;85;0;1;1;0;100;3.9;4852;80
53189;Eagle vs Shark;494222;5.6;104;56;48;53;5.4;26;12;14;46;3.5;24010;67
53207;88 Minutes;411061;2.6;120;6;114;5;2.7;29;1;28;3;3.2;37899;51
53318;Cashback;460740;5.4;49;23;26;46;5.8;17;10;7;58;3.8;24862;79
53322;Ocean's Thirteen;496806;6.4;195;136;59;69;6;43;25;18;58;3.6;846364;74
53326;Ils;465203;6;50;30;20;60;6;12;6;6;50;3.4;4394;62
53349;Ten Canoes;466399;7.7;59;58;1;98;7.4;18;18;0;100;3.7;2471;75
53355;Sonnenallee;177242;0;0;0;0;0;0;0;0;0;0;0;0;0
53435;Hostel: Part II;498353;5.1;106;48;58;45;4.6;21;9;12;42;3;282438;45
53447;Paranoid Park;842929;6.9;112;85;27;75;7.1;25;20;5;80;3.5;9375;66
53450;Sleepy Hollow;162661;6.3;124;84;40;67;6.2;30;20;10;66;3.5;93949;79
53460;Surf's Up;423294;6.6;141;109;32;77;7;31;26;5;83;3.4;372345;64
53464;4: Rise of the Silver Surfer;486576;4.8;165;60;105;36;4.5;34;11;23;32;3.2;470350;55
53466;Nancy Drew;479500;5.5;134;66;68;49;5.7;36;20;16;55;3.4;111522;62
53468;Fido;457572;6.4;69;49;20;71;6.2;16;11;5;68;3.6;27143;70
53476;L'iceberg;484113;6.5;32;22;10;68;6.2;11;8;3;72;3.6;492;70
53519;Death Proof;1028528;5.8;35;23;12;65;0;2;2;0;100;3.6;52006;73
53550;Rescue Dawn;462504;7.5;156;140;16;89;7.7;37;32;5;86;3.5;46938;73
53574;The TV Set;473709;6.3;75;48;27;64;6.5;27;19;8;70;3.3;3053;57
53578;La doublure;449851;6.6;81;56;25;69;6.9;29;22;7;75;3.5;3807;66
53737;The Night of the Generals;62038;0;3;2;1;66;0;0;0;0;0;0;0;0
53769;In Search of a Midnight Kiss;989000;7;59;50;9;84;7.1;22;19;3;86;3.8;2278;79
53835;Il mio viaggio in Italia;173772;8.3;20;20;0;100;0;4;4;0;100;3.9;769;82
53883;The Power of Nightmares: The Rise of the Politics of Fear;430484;8.1;7;6;1;85;8;5;4;1;80;4.5;575;96
53887;O Lucky Man!;70464;7.6;17;14;3;82;0;2;1;1;50;0;0;0
53894;Sicko;386032;7.8;199;185;14;92;7.4;43;38;5;88;3.8;93379;87
53921;A Mighty Heart;829459;7;188;147;41;78;7.2;44;37;7;84;3.5;55538;70
53953;1408;450385;6.7;165;129;36;78;6.7;32;25;7;78;3.4;349462;61
53956;Death at a Funeral;795368;0;0;0;0;0;0;0;0;0;0;0;0;0
53972;Live Free or Die Hard;337978;6.8;197;161;36;81;6.7;38;30;8;78;3.9;1145097;86
53974;License to Wed;762114;3.1;122;9;113;7;3.3;26;2;24;7;3.2;197792;55
53988;Evening;765447;4.9;124;34;90;27;4.8;31;8;23;25;3.1;49054;49
53993;Evan Almighty;413099;4.5;190;44;146;23;4;39;3;36;7;3.2;369422;56
53996;Transformers;418279;0;0;0;0;0;0;0;0;0;0;0;0;0
53999;Captivity;374563;2.7;73;5;68;6;2;15;0;15;0;2.8;42072;32
54001;Harry Potter and the Order of the Phoenix;373889;6.8;234;182;52;77;6.7;41;28;13;68;3.9;1449179;82
54004;I Now Pronounce You Chuck & Larry;762107;3.6;154;21;133;13;3.8;34;4;30;11;3.6;920014;73
54075;Arn - Tempelriddaren;837106;\N;\N;\N;\N;\N;\N;\N;\N;\N;\N;\N;\N;\N
54094;Driving Lessons;446687;5.2;75;36;39;48;5.3;23;11;12;47;3.2;22883;67
54116;First Snow;432289;5.9;72;41;31;56;6.2;20;12;8;60;3;2700;42
54190;Across the Universe;445922;5.8;151;80;71;52;5.9;30;15;15;50;4;133408;84
54193;Broken English;772157;6.3;73;47;26;64;6.2;23;14;9;60;3.4;14630;61
54196;Brand Upon the Brain! A Remembrance in 12 Chapters;443455;8;47;43;4;91;7.9;17;16;1;94;4;1698;84
54256;Hot Rod;787475;4.9;101;40;61;39;4.7;25;7;18;28;3.3;69065;64
54259;Stardust;486655;6.8;182;138;44;75;6.7;36;24;12;66;3.9;192854;86
54268;Who's Your Caddy?;785077;2.3;32;2;30;6;2.9;10;1;9;10;3.4;32708;61
54270;Skinwalkers;461703;3.5;36;5;31;13;2.8;11;0;11;0;2.7;28787;33
54272;The Simpsons Movie;462538;7.5;190;170;20;89;7.3;39;32;7;82;3.7;1305720;78
54274;I Know Who Killed Me;897361;2.1;67;5;62;7;2.1;18;1;17;5;2.5;61978;29
54276;No Reservations;481141;5.2;157;63;94;40;5.2;34;12;22;35;3.4;112453;64
54278;Underdog;467110;4;67;10;57;14;4;15;3;12;20;3.1;58055;48
54281;Charlie Bartlett;423977;5.8;130;73;57;56;6;29;15;14;51;3.5;29271;73
54284;El cantante;458522;4.8;103;25;78;24;4.6;29;7;22;24;3.5;4858;64
54286;The Bourne Ultimatum;440963;7.9;228;213;15;93;8.1;39;38;1;97;4.1;1312487;91
54290;Bratz;804452;2.9;71;5;66;7;3.2;23;2;21;8;3;27511;51
54328;Mon meilleur ami;778784;6.6;85;64;21;75;6.6;29;22;7;75;3.5;5539;65
54331;You Kill Me;796375;6.6;112;87;25;77;6.8;30;24;6;80;3.3;17284;60
54372;Ne le dis à personne;362225;7.6;103;96;7;93;7.9;25;24;1;96;3.9;11817;86
54419;Ceský sen;402906;6.6;24;19;5;79;6.8;7;6;1;85;3.7;434;74
54503;Superbad;829482;7.4;198;173;25;87;7.2;41;35;6;85;4.1;315252;87
54505;Arctic Tale;488508;5.8;94;57;37;60;5.4;25;13;12;52;3.5;16362;63
54510;Joshua;808331;6.3;97;61;36;62;6.9;31;24;7;77;2.9;13913;40
54513;Talk to Me;796368;6.9;124;101;23;81;7;32;25;7;78;3.6;16542;77
54612;Resurrecting the Champ;416185;6;116;69;47;59;5.5;30;15;15;50;3.4;18572;62
54621;Molière;796335;6.5;85;60;25;70;6.1;19;11;8;57;3.7;6884;76
54648;Rush Hour 3;293564;4.2;155;30;125;19;4.4;29;6;23;20;3.5;270729;68
54686;The Last Legion;462396;4;54;9;45;16;4;14;1;13;7;2.9;36434;39
54691;Lady Chatterley;459880;6.7;83;62;21;74;7.7;22;19;3;86;3.3;1401;59
54732;Balls of Fury;424823;4.2;127;29;98;22;4.5;24;8;16;33;2.8;85682;36
54734;Sydney White;815244;5;81;30;51;37;4.7;20;5;15;25;3.5;526699;74
54736;The Kingdom;431197;5.8;182;93;89;51;5.5;41;19;22;46;3.6;107436;78
54745;Rocket Science;477078;6.9;105;88;17;83;6.9;31;25;6;80;3.6;7963;72
54768;Daddy Day Camp;462244;2.3;74;1;73;1;2.4;21;0;21;0;2.9;44524;49
54771;The Invasion;427392;4.3;156;30;126;19;4.7;34;9;25;26;3;66767;43
54775;War;499556;0;0;0;0;0;0;0;0;0;0;0;0;0
54780;The Nanny Diaries;489237;0;0;0;0;0;0;0;0;0;0;0;0;0
54783;September Dawn;473700;3.4;54;7;47;12;2.8;18;0;18;0;3.1;5910;49
54785;Halloween;373883;4.1;101;26;75;25;3.9;19;3;16;15;3.3;79946;64
54787;Death Sentence;804461;4.1;110;21;89;19;3.6;28;2;26;7;3.4;42086;62
54796;2 Days in Paris;841044;6.8;113;96;17;84;6.9;34;30;4;88;3.6;27100;71
54881;King Kong;360717;7.7;242;202;40;83;7.6;39;30;9;76;2.8;207337;52
54910;Behind the Mask: The Rise of Leslie Vernon;437857;6.9;34;25;9;73;6.5;10;7;3;70;3.6;7455;72
54934;The Brothers Solomon;784972;3.3;72;11;61;15;3.8;20;3;17;15;2.6;21959;31
54958;Bordertown;445935;0;3;2;1;66;0;1;1;0;100;3.4;5023;64
54962;The Nines;810988;6;60;39;21;65;6.2;10;7;3;70;3.4;19000;61
54978;The Good Night;484111;4.8;41;12;29;29;5;9;3;6;33;2.8;2801;34
54995;Planet Terror;1077258;6.1;23;17;6;73;0;0;0;0;0;0;0;0
54997;3:10 to Yuma;381849;7.5;205;182;23;88;7.3;42;36;6;85;3.9;139372;85
54999;Shoot 'Em Up;465602;6.2;156;103;53;66;5.5;32;17;15;53;3.4;83976;66
55020;12 Angry Men;50083;8.8;36;36;0;100;0;4;4;0;100;4.1;22784;95
55052;Atonement;783233;7.3;202;167;35;82;7.6;41;36;5;87;3.8;138297;79
55063;My Winnipeg;1093842;7.8;79;74;5;93;8.2;25;25;0;100;3.8;1541;77
55069;4 luni, 3 saptamâni si 2 zile;1032846;8.3;131;125;6;95;8.7;33;33;0;100;4;12151;85
55071;No End in Sight;912593;8.1;91;86;5;94;8.2;25;24;1;96;4.3;4168;93
55080;The Brave One;476964;5.5;179;76;103;42;5.6;34;13;21;38;3.4;78908;65
55094;In the Valley of Elah;478134;7;154;112;42;72;7.1;38;27;11;71;3.7;15462;77
55100;I Could Never Be Your Woman;466839;5.5;10;6;4;60;0;3;2;1;66;3.1;13048;45
55110;December Boys;465436;5;67;28;39;41;5.4;16;8;8;50;3.3;14517;55
55116;The Hunting Party;455782;6;89;47;42;52;5.8;26;12;14;46;3.4;13820;67
55118;Eastern Promises;765443;7.6;190;169;21;88;7.4;35;30;5;85;3.8;66267;82
55154;Brooklyn Rules;283503;5.4;39;18;21;46;5.4;14;5;9;35;3.2;11794;51
55156;An Unreasonable Man;492499;7.4;59;54;5;91;7.5;22;20;2;90;3.9;2169;81
55159;Fukushû suru wa ware ni ari;79182;7.7;5;5;0;100;0;0;0;0;0;0;0;0
55176;In the Shadow of the Moon;925248;7.9;108;102;6;94;7.9;35;35;0;100;4.2;2605;90
55178;Stephanie Daley;483812;7.3;49;44;5;89;7.8;17;16;1;94;2.9;2917;51
55190;Love and Other Disasters;452643;3.5;5;1;4;20;0;2;0;2;0;3.4;3576;59
55205;Interview;480269;6;121;70;51;57;5.8;31;15;16;48;3.2;14637;53
55232;Resident Evil: Extinction;432021;4.3;91;20;71;21;3.7;12;2;10;16;3.4;145880;63
55241;Mr. Woodcock;419984;4;108;14;94;12;4.6;23;6;17;26;2.8;78350;35
55245;Good Luck Chuck;452625;2.8;110;5;105;4;2.7;22;0;22;0;3.3;118715;61
55247;Into the Wild;758758;7.5;181;149;32;82;7.2;37;27;10;72;4.2;82515;90
55250;The Game Plan;492956;4.6;96;26;70;27;4.9;22;9;13;40;3.6;118618;75
55253;Se, jie;808357;6.6;140;100;40;71;6.1;38;22;16;57;3.9;28527;83
55255;Feast of Love;800027;5.3;113;45;68;39;5.8;29;16;13;55;3.1;17049;57
55257;Postal;486640;3;39;3;36;7;2.2;10;0;10;0;2.6;11460;34
55259;The Seeker: The Dark Is Rising;484562;0;0;0;0;0;0;0;0;0;0;0;0;0
55261;The Heartbreak Kid;408839;4.7;153;47;106;30;4.6;32;9;23;28;2.9;91228;41
55267;Dan in Real Life;480242;6.2;167;107;60;64;6.6;35;22;13;62;3.5;112489;70
55269;The Darjeeling Limited;838221;6.5;166;113;53;68;6.1;35;20;15;57;3.7;57824;79
55272;We Own the Night;498399;5.8;144;81;63;56;5.8;32;19;13;59;3.4;84878;63
55274;Elizabeth: The Golden Age;414055;5.1;162;56;106;34;5;37;10;27;27;3.3;74366;62
55276;Michael Clayton;465538;7.6;192;173;19;90;7.9;37;35;2;94;3.6;123924;72
55278;Sleuth;857265;5.1;118;42;76;35;5.1;30;10;20;33;3.2;9724;53
55280;Lars and the Real Girl;805564;7.1;132;107;25;81;7.1;35;28;7;80;3.8;44751;84
55282;30 Days of Night;389722;5.5;150;73;77;48;5.1;28;13;15;46;3.3;146766;57
55284;Rendition;804522;5.4;150;69;81;46;5.2;34;12;22;35;3.3;58911;63
55286;Things We Lost in the Fire;469623;6.5;121;78;43;64;6.8;29;20;9;68;3.6;18238;73
55288;Reservation Road;831884;5.2;108;39;69;36;4.8;31;8;23;25;3.3;6196;54
55290;Gone Baby Gone;452623;7.7;164;154;10;93;7.4;36;33;3;91;3.8;95109;84
55292;The Comebacks;790804;2.7;33;3;30;9;2.6;11;1;10;9;2.8;27630;38
55363;The Assassination of Jesse James by the Coward Robert Ford;443680;7.1;162;121;41;74;6.6;36;22;14;61;3.7;57534;73
55391;10th & Wolf;360323;4;27;5;22;18;3.5;10;1;9;10;3.1;9910;44
55402;Beaufort;758732;7;48;42;6;87;7.6;14;12;2;85;3.7;1055;71
55417;Irina Palm;762110;5.9;45;30;15;66;5.7;15;8;7;53;3.7;2412;77
55419;I'm Reed Fish;464061;5.1;20;11;9;55;4.3;7;3;4;42;3.2;2282;45
55440;The Final Season;449018;4.6;51;14;37;27;5.1;12;5;7;41;3.7;1192;68
55442;Persepolis;808417;8.2;145;140;5;96;8.1;37;36;1;97;4.2;29722;92
55444;Control;421082;7.4;107;93;14;86;7.3;26;23;3;88;4.1;22741;88
55451;The Jane Austen Book Club;866437;6.1;112;73;39;65;6.8;26;22;4;84;3.5;13572;68
55492;The Last Winter;454864;6.6;49;37;12;75;6.9;16;13;3;81;2.7;1701;33
55498;Silk;494834;3.8;55;4;51;7;4.2;17;2;15;11;2.8;5170;33
55507;Elizabeth: The Golden Age;414055;5.1;162;56;106;34;5;37;10;27;27;3.3;74366;62
55517;I Want Someone to Eat Cheese With;391229;6.5;48;35;13;72;6.8;17;14;3;82;2.9;2261;38
55553;Black Sheep;779982;6.4;87;61;26;70;6.3;21;15;6;71;3.2;19454;54
55555;Auf der anderen Seite;880502;7.7;70;62;8;88;7.7;22;20;2;90;4.1;5659;89
55566;Why Did I Get Married?;906108;\N;\N;\N;\N;\N;\N;\N;\N;\N;\N;\N;\N;\N
55577;Saw IV;890870;3.7;71;12;59;16;2.6;15;0;15;0;3.5;171505;70
55603;My Mom's New Boyfriend;780534;0;2;0;2;0;0;0;0;0;0;0;0;0
55620;For the Bible Tells Me So;912583;7.5;47;46;1;97;7.6;16;16;0;100;4.1;1345;89
55668;Full of It;446752;3;17;1;16;5;3.7;7;1;6;14;3.1;9568;48
55687;My Kid Could Paint That;912592;7.8;79;74;5;93;7.7;22;21;1;95;3.7;2712;78
55721;Tropa de Elite;861739;5.1;34;18;16;52;0;4;2;2;50;4.1;5760;88
55726;O Ano em Que Meus Pais Saíram de Férias;857355;7;50;41;9;82;7.4;12;11;1;91;3.9;1471;80
55729;King of California;388182;6.2;67;42;25;62;6.4;26;17;9;65;3.4;5772;64
55732;Martian Child;415965;5;104;34;70;32;4.6;29;6;23;20;3.7;48559;73
55765;American Gangster;765429;7;206;163;43;79;6.9;42;32;10;76;4;673602;87
55768;Bee Movie;389790;5.7;165;84;81;50;5.9;37;19;18;51;3.3;137161;57
55805;Before the Devil Knows You're Dead;292963;7.7;158;138;20;87;8;39;36;3;92;3.5;22578;69
55814;Le scaphandre et le papillon;401383;8.2;155;144;11;92;8.2;39;37;2;94;4;34371;91
55820;No Country for Old Men;477348;8.5;223;211;12;94;8.1;44;40;4;90;4;197109;84
55830;Be Kind Rewind;799934;6.2;123;80;43;65;5.9;30;16;14;53;3.2;64435;57
55844;Itty Bitty Titty Committee;496328;5;8;3;5;37;0;1;0;1;0;3.3;2011;57
55851;Crazy Love;790706;7;84;65;19;77;7;32;26;6;81;3.6;2624;70
55854;The Fugitive;106977;7.6;52;49;3;94;8;9;9;0;100;3.6;28862;82
55872;August Rush;426931;4.8;120;44;76;36;4.4;27;7;20;25;4;105941;84
55895;The Desperate Hours;47985;7;5;4;1;80;0;0;0;0;0;0;0;0
55901;Du levande;445336;7.8;36;36;0;100;8;8;8;0;100;3.9;2317;81
55908;The Man from Earth;756683;0;3;3;0;100;0;0;0;0;0;0;0;0
55926;Hellfighters;63060;3.9;7;1;6;14;0;2;0;2;0;3.6;1128;77
55946;Lions for Lambs;891527;4.8;177;47;130;26;4.6;38;7;31;18;3.1;54996;49
55955;Fred Claus;486583;4.2;135;28;107;20;4.3;32;6;26;18;3;100236;49
55995;Beowulf;442933;6.5;189;133;56;70;6.5;36;25;11;69;3.1;101491;52
55999;Mr. Magorium's Wonder Emporium;457419;4.9;120;44;76;36;4.6;27;7;20;25;3.1;57793;56
56001;Love in the Time of Cholera;484740;4.8;107;29;78;27;4.6;29;7;22;24;3.2;20459;48
56003;Southland Tales;405336;4.5;92;33;59;35;4.5;23;9;14;39;2.8;13816;43
56015;Kansas City Confidential;44789;5.9;7;6;1;85;0;0;0;0;0;0;0;0
56028;Rails & Ties;822849;4.6;45;15;30;33;4.3;19;4;15;21;3.2;1200;61
56030;Darfur Now;988102;6.6;57;39;18;68;6.6;24;17;7;70;3.7;1145;74
56060;Obsluhoval jsem anglického krále;284363;7.2;81;65;16;80;7.1;27;23;4;85;3.7;1497;80
56067;Texas Terror;27087;0;1;0;1;0;0;0;0;0;0;0;0;0
56141;La faute à Fidel!;792966;7.4;43;40;3;93;7.8;12;11;1;91;4.1;2344;90
56145;The Mist;884328;6.6;138;101;37;73;5.8;30;17;13;56;3.3;71785;64
56152;Enchanted;461770;7.3;157;145;12;92;7.4;34;31;3;91;3.8;188655;80
56156;Hitman;465494;0;0;0;0;0;0;0;0;0;0;0;0;0
56158;This Christmas;937375;5.9;80;44;36;55;6.1;23;14;9;60;4.1;54791;82
56165;P2;804516;4.3;68;23;45;33;4;15;4;11;26;2.9;29255;39
56167;Om Shanti Om;1024943;6.9;7;6;1;85;0;1;1;0;100;4;9245;78
56169;Awake;211933;4.3;54;13;41;24;4.4;12;3;9;25;3.2;58950;58
56171;The Golden Compass;385752;5.6;186;79;107;42;5.6;35;17;18;48;3.2;145319;55
56174;I Am Legend;480249;6.3;206;142;64;68;6.1;43;25;18;58;3.6;597704;69
56176;Alvin and the Chipmunks;952640;4.4;104;28;76;26;4.3;25;6;19;24;3.6;165304;73
56251;Futurama: Bender's Big Score;471711;7.6;7;7;0;100;0;0;0;0;0;0;0;0
56274;Margot at the Wedding;757361;5.6;162;84;78;51;5.9;34;21;13;61;2.8;9682;39
56286;I'm Not There.;368794;7;152;116;36;76;7;37;27;10;72;3.5;26869;69
56333;The Savages;775529;7.4;165;147;18;89;7.8;37;36;1;97;3.4;26746;72
56339;El orfanato;464141;7.3;154;132;22;85;7.3;28;25;3;89;4;38413;85
56367;Juno;467406;8.1;197;184;13;93;8.4;35;35;0;100;4.1;335812;89
56389;My Blueberry Nights;765120;5.4;120;57;63;47;5;30;9;21;30;3.4;19153;62
56508;Starting Out in the Evening;758784;7.3;97;84;13;86;7.6;33;27;6;81;3.6;1511;68
56511;Redacted;937237;5.3;103;45;58;43;5.2;30;13;17;43;2.9;3154;46
56563;Helvetica;847817;7.1;16;14;2;87;8.1;6;6;0;100;3.9;2857;81
56587;The Bucket List;825232;5.1;163;66;97;40;4.6;35;9;26;25;3.8;126324;81
56607;The Kite Runner;419887;6.4;169;111;58;65;6.7;36;26;10;72;3.7;45797;85
56633;Butterfly on a Wheel;489664;0;3;1;2;33;0;0;0;0;0;0;0;0
56671;The Go-Getter;479289;5.6;23;10;13;43;6.2;11;6;5;54;3.5;1556;66
56700;The Flock;473356;0;2;1;1;50;0;0;0;0;0;0;0;0
56715;Wristcutters: A Love Story;477139;0;1;1;0;100;0;0;0;0;0;0;0;0
56719;Vitus;478829;6.6;59;38;21;64;6.3;19;10;9;52;3.8;10168;77
56744;Longford;759612;0;4;4;0;100;0;1;1;0;100;0;0;0
56748;The Big Bad Swim;460721;0;3;2;1;66;0;1;1;0;100;3.6;407;73
56757;Sweeney Todd: The Demon Barber of Fleet Street;408236;7.6;215;184;31;85;7.5;38;32;6;84;3.9;1391688;81
56775;National Treasure: Book of Secrets;465234;4.7;118;39;79;33;4.6;25;8;17;32;3.6;1237906;72
56782;There Will Be Blood;469494;8.4;202;184;18;91;8.2;39;37;2;94;4;110828;84
56788;Charlie Wilson's War;472062;7;192;156;36;81;6.9;40;32;8;80;3.5;85573;73
56801;AVPR: Aliens vs Predator - Requiem;758730;3.1;66;8;58;12;4;8;3;5;37;2.7;63530;37
56805;Walk Hard: The Dewey Cox Story;841046;6.6;137;102;35;74;6.1;34;25;9;73;3.1;58871;55
56885;The Great Debaters;427309;0;0;0;0;0;0;0;0;0;0;0;0;0
56908;Dedication;490579;5.2;45;18;27;40;4.9;17;5;12;29;3.5;5028;64
56915;The Water Horse;760329;0;0;0;0;0;0;0;0;0;0;0;0;0
56921;Battlestar Galactica: Razor;991178;0;2;2;0;100;0;0;0;0;0;0;0;0
56941;P.S. I Love You;431308;0;0;0;0;0;0;0;0;0;0;0;0;0
56945;The Perfect Holiday;841032;3.8;56;9;47;16;3.6;20;2;18;10;3;24817;57
56949;27 Dresses;988595;5;146;59;87;40;4.9;31;8;23;25;3.6;168630;71
57147;Cassandra's Dream;795493;5.7;115;53;62;46;5.6;30;12;18;40;3.1;18073;51
57223;D-War;372873;3.6;33;9;24;27;3.3;7;1;6;14;2.3;34779;23
57243;Bikur Ha-Tizmoret;1032856;7.9;110;108;2;98;8.1;27;27;0;100;3.9;6276;85
57274;[Rec];1038988;7.8;23;22;1;95;0;1;0;1;0;3.8;30174;77
57326;In the Name of the King: A Dungeon Siege Tale;460780;2.5;44;2;42;4;2.9;8;0;8;0;2.6;26869;29
57353;Flawless;780516;5.7;90;50;40;55;6;17;12;5;70;3.3;5982;56
57368;Cloverfield;1060277;6.7;190;145;45;76;6.3;35;25;10;71;3.4;188811;67
57370;Mad Money;951216;4.4;103;23;80;22;4.6;30;8;22;26;3.2;45502;52
57401;Cleaner;896798;4.4;12;2;10;16;0;3;1;2;33;3.1;6226;45
57464;He Was a Quiet Man;760311;6.2;19;15;4;78;0;1;0;1;0;3.3;5213;61
57476;The Cheyenne Social Club;65542;0;2;2;0;100;0;0;0;0;0;0;0;0
57480;The Iron Horse;15016;7.2;7;6;1;85;0;0;0;0;0;0;0;0
57484;3 Bad Men;17463;0;0;0;0;0;0;0;0;0;0;0;0;0
57504;Toki o kakeru shôjo;808506;6.7;15;13;2;86;0;2;2;0;100;4.2;3403;90
57509;Sex and Breakfast;837803;3.4;11;1;10;9;0;3;0;3;0;2.5;1772;24
57520;One Missed Call;479968;2.5;76;0;76;0;2.4;15;0;15;0;2.7;44868;37
57522;First Sunday;486578;0;0;0;0;0;0;0;0;0;0;0;0;0
57526;Untraceable;880578;4.1;143;21;122;14;4.2;31;6;25;19;3.3;68370;56
57528;Rambo;462499;4.8;138;50;88;36;4;26;6;20;23;3.4;107524;70
57530;How She Move;770810;6;77;52;25;67;6.1;22;14;8;63;3.3;16237;56
57532;Meet the Spartans;1073498;1.9;46;1;45;2;2.4;9;0;9;0;2.4;69166;31
57534;The Eye;406759;4.3;74;16;58;21;4.5;10;2;8;20;3.1;57166;51
57536;Strange Wilderness;489282;2.3;41;0;41;0;2.2;7;0;7;0;2.7;25360;35
57538;Over Her Dead Body;785007;3.7;103;16;87;15;3.8;30;3;27;10;3.1;34429;47
57550;Im Lauf der Zeit;73152;0;3;3;0;100;0;0;0;0;0;0;0;0
57640;Hellboy II: The Golden Army;411477;7.2;197;171;26;86;7.2;33;29;4;87;3.6;94282;70
57655;Ira & Abby;480251;6;41;28;13;68;6.5;12;9;3;75;3.5;1069;62
57669;In Bruges;780536;7;154;124;30;80;6.7;34;23;11;67;3.9;53258;84
57690;The Shoes of the Fisherman;63599;6.1;6;3;3;50;0;0;0;0;0;0;0;0
57792;Sukkar banat;825236;7.1;73;67;6;91;7.2;25;23;2;92;3.9;5165;80
57845;Joe Strummer: The Future Is Unwritten;800099;7.3;59;52;7;88;7.7;21;21;0;100;4;3950;85
57865;The Pleasure of Your Company;484877;4.3;11;4;7;36;0;1;0;1;0;2.9;7325;40
57910;Teeth;780622;6.6;61;50;11;81;6.4;18;15;3;83;3;14996;46
57949;Welcome Home, Roscoe Jenkins;494652;4.4;77;18;59;23;4.8;27;9;18;33;3.3;34393;65
57951;Fool's Gold;770752;3.6;140;14;126;10;3.2;30;0;30;0;3.2;76286;53
57964;Blue State;780486;0;4;1;3;25;0;0;0;0;0;0;0;0
58025;Jumper;489099;4;158;26;132;16;3.7;36;1;35;2;3.2;131920;50
58029;It's a Free World...;807054;6.6;18;15;3;83;6.2;6;4;2;66;3.6;1788;70
58047;Definitely, Maybe;832266;6.5;142;101;41;71;6;32;21;11;65;3.5;71521;72
58059;Ikimono no kiroku;48198;6.4;10;7;3;70;0;2;1;1;50;3.6;357;75
58078;The Air I Breathe;485851;3.9;23;3;20;13;3.6;7;0;7;0;3.4;12498;64
58084;Street Thief;872224;0;0;0;0;0;0;0;0;0;0;0;0;0
58103;Vantage Point;443274;5;149;51;98;34;4.9;29;8;21;27;3.4;88206;61
58105;The Spiderwick Chronicles;416236;6.6;142;113;29;79;6.4;31;22;9;70;3.4;73683;67
58107;Step Up 2: The Streets;1023481;4.8;56;14;42;25;5.1;18;5;13;27;4;92053;81
58146;Witless Protection;1001562;2.1;28;1;27;3;0;4;0;4;0;3.1;9071;51
58154;The Other Boleyn Girl;467200;5.3;136;56;80;41;5.2;34;12;22;35;3.4;73595;65
58156;Semi-Pro;839980;4.5;154;32;122;20;4.8;31;8;23;25;2.9;58206;41
58162;Run Fatboy Run;425413;5.5;143;69;74;48;5.5;31;17;14;54;3.5;43462;66
58191;Taxi to the Dark Side;854678;8.3;85;85;0;100;8.2;23;23;0;100;4;2599;88
58246;Grace Is Gone;772168;5.9;71;44;27;61;5.9;21;13;8;61;3.1;10636;59
58291;College Road Trip;997047;3.3;70;9;61;12;3.2;18;1;17;5;3.3;41096;56
58293;10,000 BC;443649;3.2;139;12;127;8;3.1;29;3;26;10;3;91145;44
58295;The Bank Job;200465;6.7;137;108;29;78;7.1;31;28;3;90;3.5;60915;74
58297;Doomsday;483607;5;65;31;34;47;4.7;10;3;7;30;3.1;35296;47
58299;Horton Hears a Who!;451079;7;130;102;28;78;7;33;27;6;81;3.7;97604;75
58301;Funny Games U.S.;808279;5.6;138;71;67;51;4.7;34;13;21;38;3.2;16153;54
58303;Die Fälscher;813547;\N;\N;\N;\N;\N;\N;\N;\N;\N;\N;\N;\N;\N
58306;Mongol;416044;7.1;98;85;13;86;7.4;27;25;2;92;3.7;11134;75
58309;War Dance;912599;7.1;47;40;7;85;7.4;17;15;2;88;4.3;1246;91
58315;The Love Guru;811138;3.4;161;24;137;14;3.4;35;4;31;11;2.8;42392;39
58332;Diary of the Dead;848557;6.1;125;76;49;60;6.1;26;17;9;65;2.9;13143;43
58334;Hallam Foe;466816;6.5;60;43;17;71;6.9;13;10;3;76;3.5;5333;72
58347;Penelope;472160;5.6;125;65;60;52;5.4;28;14;14;50;3.6;48472;74
58351;Cidade dos Homens;870090;6.7;76;57;19;75;7.1;24;21;3;87;3.8;3953;77
58367;Romulus, My Father;462023;6.1;11;6;5;54;5.6;5;2;3;40;3.6;1466;67
58376;Zeitgeist;1166827;0;0;0;0;0;0;0;0;0;0;0;0;0
58381;Meduzot;807721;7.2;56;48;8;85;7.7;17;16;1;94;3.8;942;77
58418;Then She Found Me;455805;5.5;115;59;56;51;5.5;28;16;12;57;3.1;4911;46
58439;Downhill Racer;64253;7.2;14;11;3;78;0;2;2;0;100;3.3;385;54
58490;Miss Pettigrew Lives for a Day;970468;6.6;138;107;31;77;6.7;29;21;8;72;3.5;21923;70
58492;Snow Angels;453548;6.8;107;71;36;66;7;30;20;10;66;3.5;4241;66
58494;Married Life;804505;5.9;114;63;51;55;6.2;28;15;13;53;3;3205;36
58559;The Dark Knight;468569;8.4;275;257;18;93;8;44;40;4;90;4.5;399618;96
58595;Quiet City;914382;7;16;14;2;87;6.8;6;5;1;83;3.4;995;61
58622;The Hammer;814130;6.1;32;22;10;68;6.3;13;10;3;76;3.9;1768;82
58627;Never Back Down;1023111;4.4;83;19;64;22;4.4;20;4;16;20;2.9;405469;37
58652;Cheung Gong 7 hou;940709;5.3;76;37;39;48;5.3;20;10;10;50;3.3;6905;55
58655;Drillbit Taylor;817538;4.5;138;36;102;26;4.4;30;7;23;23;3.2;45456;49
58706;La misma luna;796307;6.5;91;66;25;72;6.6;26;20;6;76;3.8;11693;80
58783;Youth Without Youth;481797;4.7;99;30;69;30;4.7;29;8;21;27;3;5756;45
58803;21;478087;5.2;161;57;104;35;4.9;31;8;23;25;3.7;112101;73
58806;Smart People;858479;5.6;141;70;71;49;5.8;34;16;18;47;3;26733;41
58839;Leatherheads;379865;5.8;160;83;77;51;5.2;32;11;21;34;3;36074;41
58876;Stop-Loss;489281;6.3;138;89;49;64;6.3;33;22;11;66;2.5;254181;27
58879;Shine a Light;893382;7.4;120;103;17;85;7.3;34;30;4;88;3.6;11885;74
58898;La antena;454065;5.8;10;6;4;60;0;0;0;0;0;0;0;0
58964;À l'intérieur;856288;7.4;12;10;2;83;0;1;1;0;100;3.8;3333;77
58972;Nim's Island;410377;5.7;96;48;48;50;5.9;24;13;11;54;3.1;45465;50
58975;The Ruins;963794;5.4;85;40;45;47;4.4;12;3;9;25;2.4;29652;32
58998;Forgetting Sarah Marshall;800039;7;175;148;27;84;7;37;33;4;89;3.2;102537;75
59000;Sex and Death 101;497972;4.3;39;10;29;25;3.7;13;3;10;23;3;2241;44
59014;Superhero Movie;426592;3.7;48;7;41;14;3.2;12;0;12;0;2.9;45683;37
59016;Street Kings;421073;5.1;149;54;95;36;5;30;8;22;26;3.4;41234;63
59018;The Visitor;857191;7.7;111;100;11;90;7.9;25;24;1;96;3.6;29598;82
59022;Harold & Kumar Escape from Guantanamo Bay;481536;5.6;128;69;59;53;5.8;26;15;11;57;3.5;76122;65
59026;99 francs;875113;0;0;0;0;0;0;0;0;0;0;0;0;0
59037;Speed Racer;811080;5.1;202;76;126;37;4.6;41;13;28;31;3.2;70251;61
59044;Diminished Capacity;1007950;5.3;30;10;20;33;4.9;11;3;8;27;2.6;4729;37
59065;Chapter 27;488988;3.9;47;9;38;19;4.8;16;8;8;50;3;5596;43
59103;The Forbidden Kingdom;865556;6.1;123;79;44;64;5.7;27;18;9;66;3.5;74799;65
59105;Where in the World Is Osama Bin Laden?;963208;4.9;102;38;64;37;4.6;29;9;20;31;3.3;2558;55
59107;The Life Before Her Eyes;815178;4.4;91;22;69;24;4.8;21;7;14;33;3.3;6082;55
59118;Happy-Go-Lucky;1045670;7.7;149;138;11;92;8;33;32;1;96;3.4;13094;65
59126;Religulous;815241;6.4;149;104;45;69;6;33;21;12;63;3.8;16867;79
59129;Outpost;892899;0;2;1;1;50;0;0;0;0;0;0;0;0
59141;Son of Rambow;845046;6.8;114;84;30;73;6.8;27;20;7;74;3.7;17821;79
59143;Super High Me;1111833;5.3;7;4;3;57;0;1;0;1;0;3.4;2525;56
59157;The Invisible Ray;27800;6.2;5;4;1;80;0;0;0;0;0;0;0;0
59173;The Killer Elite;73240;6;8;5;3;62;0;2;0;2;0;3;599;35
59256;Deception;800240;3.8;94;12;82;12;3.5;27;2;25;7;3;23525;37
59258;Baby Mama;871426;6.2;157;99;58;63;6;37;23;14;62;3.4;80435;59
59290;Klimt;417871;5;24;7;17;29;5.6;8;4;4;50;2.7;1898;32
59295;Expelled: No Intelligence Allowed;1091617;2.9;41;4;37;9;2.5;17;0;17;0;3.5;8732;70
59306;Prom Night;926129;2.8;60;5;55;8;2.4;9;1;8;11;3;51435;46
59313;Die weisse Massai;436889;6.3;7;5;2;71;0;2;2;0;100;3.7;628;72
59315;Iron Man;371746;\N;\N;\N;\N;\N;\N;\N;\N;\N;\N;\N;\N;\N
59333;Made of Honor;866439;4;111;15;96;13;4.4;27;5;22;18;3.4;79802;61
59336;Redbelt;1012804;6.3;137;93;44;67;6.5;31;22;9;70;3.4;9293;64
59339;Mister Lonely;475984;5.2;68;30;38;44;5.1;19;8;11;42;3.4;2212;59
59362;Anamorph;497323;4.5;26;6;20;23;4.9;8;3;5;37;2.7;1453;26
59369;Taken;936501;5.8;160;92;68;57;5.2;33;14;19;42;4;307912;83
59382;Le voyage du ballon rouge;826711;6.9;82;65;17;79;7.3;22;19;3;86;3.4;1609;59
59387;The Fall;460791;6.2;101;60;41;59;5.8;21;9;12;42;3.8;23397;85
59392;Stargate: The Ark of Truth;942903;0;4;3;1;75;0;0;0;0;0;0;0;0
59404;Bill;790623;3.8;19;4;15;21;2.7;7;0;7;0;3.1;4060;46
59418;An American Crime;802948;4.6;11;3;8;27;0;2;0;2;0;3.8;6057;79
59421;What Happens in Vegas;1033643;4.5;128;36;92;28;4.5;31;9;22;29;3.7;109183;72
59440;Bella;482463;5.4;62;26;36;41;5.2;24;8;16;33;4;8808;81
59478;Der unbekannte Soldat;844462;6.1;10;6;4;60;0;3;1;2;33;4.2;59;88
59501;The Chronicles of Narnia: Prince Caspian;499448;6.3;179;120;59;67;6.2;37;23;14;62;3.8;154104;78
59519;Reprise;827517;7.4;77;67;10;87;7.7;23;20;3;86;3.9;2013;82
59590;Young @ Heart;1047007;7.5;97;85;12;87;7.7;23;21;2;91;4.2;3340;91
59594;War, Inc.;884224;4.6;79;24;55;30;3.9;22;4;18;18;2.9;17107;40
59604;The Girl Next Door;265208;5.6;156;87;69;55;5;32;17;15;53;3.3;39311;71
59607;King Corn;1112115;7.7;20;19;1;95;7.8;9;9;0;100;3.8;1280;78
59615;Indiana Jones and the Kingdom of the Crystal Skull;367882;6.9;246;190;56;77;6.1;41;25;16;60;3.4;252104;59
59655;Patti Smith: Dream of Life;940620;6.4;37;24;13;64;6.8;14;11;3;78;3.7;513;76
59684;Lake of Fire;841119;7.7;51;48;3;94;7.7;16;16;0;100;4.1;1243;90
59709;The Oxford Murders;488604;3.8;10;1;9;10;0;2;0;2;0;2.9;7692;37
59715;Shutter;440803;0;0;0;0;0;0;0;0;0;0;0;0;0
59721;The Grand;427998;5.2;42;16;26;38;5.1;15;6;9;40;3.1;1445;45
59725;Sex and the City;1000774;5.5;173;85;88;49;5.5;41;21;20;51;3.9;147793;81
59727;The Strangers;482606;5;146;65;81;44;4.8;26;13;13;50;3.1;55773;48
59729;Savage Grace;379976;4.9;89;34;55;38;4.9;25;10;15;40;2.9;3544;40
59731;Bigger Stronger Faster*;1151309;7.7;73;70;3;95;7.8;19;19;0;100;3;9818;73
59738;All the Boys Love Mandy Lane;490076;0;1;0;1;0;0;0;0;0;0;0;0;0
59784;Kung Fu Panda;441773;7.2;163;144;19;88;6.8;34;26;8;76;3.9;162469;83
59795;What Would Jesus Buy?;939681;6.2;54;32;22;59;6;14;9;5;64;3.4;1220;57
59810;Recount;1000771;6.4;17;13;4;76;6.6;10;8;2;80;3.8;2167;81
59816;Kunsten at græde i kor;495040;6;6;3;3;50;0;2;2;0;100;3.9;561;84
59832;Where the Sidewalk Ends;43132;7.6;9;9;0;100;0;3;3;0;100;3.7;424;80
59834;100 Rifles;63970;0;2;0;2;0;0;1;0;1;0;3.3;243;47
59900;You Don't Mess with the Zohan;960144;4.7;178;65;113;36;5.2;36;13;23;36;3.2;91932;50
59908;The Promotion;803057;5.8;76;41;35;53;5.3;21;10;11;47;2.8;7926;29
59910;And When Did You Last See Your Father?;829098;6.6;93;68;25;73;6.8;23;18;5;78;3.1;5170;62
59912;Mio fratello è figlio unico;846040;7;59;51;8;86;7.1;18;16;2;88;3.8;1781;79
59915;Stuck;758786;6.3;86;62;24;72;6.3;22;16;6;72;3.2;1652;55
59985;Chaos Theory;460745;5;56;17;39;30;4.7;20;3;17;15;3.4;4938;61
59995;Boy A;1078188;7.5;57;51;6;89;7.5;23;20;3;86;3.5;5895;84
60037;The Happening;949731;4;168;30;138;17;3.8;36;4;32;11;2.7;85481;29
60040;The Incredible Hulk;800080;6.1;210;138;72;65;5.7;38;21;17;55;3.6;124298;75
60044;Baghead;923600;6.6;90;69;21;76;6.9;27;22;5;81;3;1311;47
60046;The Children of Huang Shi;889588;4.6;72;22;50;30;4.6;21;6;15;28;3.2;8648;67
60069;WALL·E;910970;8.4;226;217;9;96;8.5;40;39;1;97;4.2;192598;89
60072;Wanted;493464;6.5;196;139;57;70;6.8;39;29;10;74;3.7;934918;72
60074;Hancock;448157;5.4;211;85;126;40;5;39;13;26;33;3.7;184958;67
60126;Get Smart;425061;5.5;206;105;101;50;5.5;38;20;18;52;3.6;117099;73
60133;Brick Lane;940585;6.2;94;61;33;64;6.4;22;13;9;59;3;3292;58
60135;Surfwise;479547;7.4;42;41;1;97;7;11;10;1;90;2.9;6425;61
60137;The Rape of Europa;997088;0;0;0;0;0;0;0;0;0;0;0;0;0
60141;St. Trinian's;964587;4.3;40;13;27;32;4;10;2;8;20;3.4;19189;58
60147;Roman de gare;889652;7.1;73;64;9;87;7.2;24;20;4;83;3.7;1112;76
60161;Futurama: The Beast with a Billion Backs;1054485;0;4;4;0;100;0;0;0;0;0;0;0;0
60189;Archangel;426911;0;1;1;0;100;0;0;0;0;0;0;0;0
60201;Sayat Nova;63555;7.4;6;5;1;83;0;0;0;0;0;0;0;0
60237;Canicule;85289;\N;\N;\N;\N;\N;\N;\N;\N;\N;\N;\N;\N;\N
60286;Finding Amanda;889134;5.2;41;17;24;41;5.5;14;5;9;35;2.8;997;30
60289;Kit Kittredge: An American Girl;846308;6.7;96;75;21;78;7;24;22;2;91;3.2;19095;64
60291;Gonzo: The Life and Work of Dr. Hunter S. Thompson;479468;7.1;91;79;12;86;7.5;22;20;2;90;3.3;7310;79
60293;The Wackness;1082886;6.3;124;85;39;68;6.5;25;19;6;76;3.6;8603;72
60295;Up the Yangtze;1114277;7.7;47;45;2;95;8.3;15;15;0;100;3.9;954;83
60309;Along Came Jones;37508;0;4;1;3;25;0;0;0;0;0;0;0;0
60322;Sleepwalking;888693;4.2;57;10;47;17;4.3;22;4;18;18;3;8038;45
60333;Encounters at the End of the World;1093824;7.6;105;98;7;93;8;21;21;0;100;3.4;4183;80
60336;Mauvais sang;91497;0;3;2;1;66;0;0;0;0;0;0;0;0
60341;Standard Operating Procedure;896866;7.1;96;77;19;80;7.2;30;24;6;80;3.8;1257;78
60363;Zombie Strippers!;960890;4.6;61;24;37;39;4.3;11;3;8;27;2.6;3970;33
60389;Battle for Haditha;870211;6;29;19;10;65;6.6;11;9;2;81;3.7;1153;73
60391;Aleksandra;1034427;7.5;51;47;4;92;8.3;11;11;0;100;3.6;547;69
60393;Transylvania;463381;5.6;18;13;5;72;0;2;1;1;50;3.8;788;78
60397;Mamma Mia!;795421;5.5;173;92;81;53;5.2;38;16;22;42;3.8;126612;76
60405;The Game;119174;7.2;43;30;13;69;7.2;11;7;4;63;3.5;23139;82
60411;Erogotoshi-tachi yori: Jinruigaku nyûmon;60560;8;8;8;0;100;0;0;0;0;0;0;0;0
60418;Kabluey;816545;6.9;36;30;6;83;6.9;11;9;2;81;3.4;1396;65
60421;The Stone Angel;847897;5.4;21;9;12;42;6.1;8;4;4;50;3.4;966;59
60471;Rogue;479528;7.7;11;11;0;100;0;1;1;0;100;3.2;3997;52
60484;Waga seishun ni kuinashi;39090;0;2;2;0;100;0;0;0;0;0;0;0;0
60487;It's the Great Pumpkin, Charlie Brown;60550;7.3;15;14;1;93;0;0;0;0;0;0;0;0
60503;Katyn;879843;7.4;59;54;5;91;8.1;15;15;0;100;3.7;3505;75
60514;Journey to the Center of the Earth;373051;6;148;91;57;61;6.6;31;24;7;77;3.2;38002;55
60516;Meet Dave;765476;4.1;98;19;79;19;4.6;24;7;17;29;3;22234;42
60522;Kataude mashin gâru;1050160;6.4;8;5;3;62;0;3;2;1;66;3.5;2727;63
60524;August Rush;426931;4.8;120;44;76;36;4.4;27;7;20;25;4;105941;84
60526;Death Defying Acts;472071;5;36;16;20;44;5.3;6;2;4;33;2.9;2068;31
60530;Naissance des pieuvres;869977;6.5;42;32;10;76;6.5;11;9;2;81;3.5;1175;65
60566;Kærlighed på film;1024942;6.2;42;31;11;73;6.5;10;8;2;80;3.8;956;82
60590;La question humaine;765141;6.5;25;19;6;76;7.2;9;8;1;88;3;290;46
60618;Moving McAllister;444672;2.8;10;1;9;10;0;1;1;0;100;2.8;1079;32
60647;Transsiberian;800241;7.2;75;68;7;90;7.3;17;16;1;94;3.4;6508;62
60649;Space Chimps;482603;4.7;89;32;57;35;4.5;17;8;9;47;2.8;24188;37
60654;Une vieille maîtresse;437526;6.7;90;68;22;75;7.6;21;19;2;90;3.4;1490;60
60674;Stargate: Continuum;929629;0;1;1;0;100;0;0;0;0;0;0;0;0
60688;Conspiracy;1043838;0;2;0;2;0;0;1;0;1;0;2.5;968;22
60728;Steal a Pencil for Me;1045889;7.7;22;21;1;95;8.1;8;8;0;100;3.8;296;80
60735;Shotgun Stories;952682;7.3;40;37;3;92;7.1;10;9;1;90;3.8;1261;79
60745;Blast of Silence;54687;7;11;9;2;81;0;2;2;0;100;3.9;432;84
60753;Felon;1117385;6.4;21;13;8;61;6.1;10;5;5;50;3.8;5305;83
60756;Step Brothers;838283;5.5;176;96;80;54;5.1;34;16;18;47;3.6;77495;68
60758;Brideshead Revisited;412536;6.1;126;79;47;62;6.5;30;21;9;70;3.2;6004;52
60760;The X Files: I Want to Believe;443701;4.8;155;48;107;30;4.5;30;7;23;23;2.8;52241;34
60763;American Teen;486259;6.5;145;103;42;71;7;33;25;8;75;3;11887;59
60766;Man on Wire;1155592;8.4;145;145;0;100;8.4;32;32;0;100;4;10237;88
60832;Pathology;964539;4.7;19;9;10;47;0;4;2;2;50;3;12698;44
60894;The Edge of Love;819714;5.1;55;20;35;36;4.5;13;4;9;30;3;18391;45
60937;The Mummy: Tomb of the Dragon Emperor;859163;3.7;161;21;140;13;3.7;32;3;29;9;3;79989;40
60939;Swing Vote;1027862;5.1;143;53;90;37;5.3;29;15;14;51;3;24529;45
60941;The Midnight Meat Train;805570;6.2;27;19;8;70;0;2;1;1;50;3.1;24490;49
60943;Frozen River;978759;7.3;125;109;16;87;7.9;26;24;2;92;3.2;9338;71
60946;Sixty Six;493450;5.9;48;31;17;64;5.8;14;9;5;64;3.5;1205;65
60948;Bottle Shock;914797;5.6;116;56;60;48;6.1;29;16;13;55;3.3;4827;60
60950;Vicky Cristina Barcelona;497465;6.9;188;154;34;81;7.2;35;29;6;82;3.6;45494;73
60983;Eve and the Fire Horse;431045;7.1;12;10;2;83;0;4;3;1;75;3.8;936;79
60990;Kohayagawa-ke no aki;55052;0;4;4;0;100;0;0;0;0;0;0;0;0
61011;The Walker;783608;5.3;62;32;30;51;5.8;18;10;8;55;2.8;2117;31
61024;Pineapple Express;910936;0;0;0;0;0;0;0;0;0;0;0;0;0
61037;Stellet licht;841925;0;4;4;0;100;0;0;0;0;0;0;0;0
61048;Expired;488535;5.6;22;13;9;59;5.7;7;4;3;57;3;388;45
61071;The Sisterhood of the Traveling Pants 2;1018785;6;92;59;33;64;6.5;29;22;7;75;3.4;36715;68
61073;Hell Ride;411475;3.5;59;6;53;10;3.5;19;2;17;10;2.7;3570;33
61075;Elegy;974554;6.7;112;83;29;74;6.9;28;21;7;75;3.2;10624;60
61123;High School Musical;475293;5.4;8;5;3;62;0;0;0;0;0;0;0;0
61132;Tropic Thunder;942385;7.1;221;183;38;82;6.9;40;33;7;82;3.5;90369;69
61160;Star Wars: The Clone Wars;1185834;4.2;152;29;123;19;3.7;26;4;22;15;3.1;40439;46
61167;Henry Poole Is Here;1029120;5;87;32;55;36;5.2;22;8;14;36;3.3;4016;56
61210;Mutant Chronicles;490181;3.6;31;5;26;16;0;2;0;2;0;2.5;18903;27
61236;Vals Im Bashir;1185616;8.4;134;129;5;96;8.4;31;30;1;96;4;15959;89
61240;Låt den rätte komma in;1139797;8.2;158;154;4;97;7.9;30;29;1;96;4.2;25695;89
61246;Hamlet;116477;8.2;54;51;3;94;7.2;14;11;3;78;3.8;5816;86
61248;Death Race;452608;4.8;145;60;85;41;5.2;23;10;13;43;3.5;50505;69
61250;The House Bunny;852713;5.1;120;47;73;39;5.2;23;8;15;34;3.2;46575;55
61253;The Longshots;1091751;5.2;68;28;40;41;5;19;7;12;36;3.5;8258;66
61255;The Rocker;1031969;5.2;119;48;71;40;5.2;30;11;19;36;3.2;13841;52
61257;I.O.U.S.A.;963807;7.2;59;52;7;88;7.9;14;14;0;100;3.9;762;83
61262;Mirrors;790686;3.9;81;12;69;14;3.5;10;0;10;0;3.2;31437;50
61267;Fly Me to the Moon;486321;3.9;78;14;64;17;4.2;20;4;16;20;2.6;1597;27
61279;Luci del varietà;42692;8.1;10;10;0;100;0;1;1;0;100;3.6;271;68
61289;Sukiyaki Western Django;906665;5.7;49;28;21;57;5.2;10;4;6;40;3.4;5732;59
61312;Noise;809931;0;2;2;0;100;0;0;0;0;0;0;0;0
61323;Burn After Reading;887883;6.8;217;169;48;77;6.2;42;26;16;61;3.4;71248;64
61348;Disaster Movie;1213644;1.8;61;1;60;1;2.2;9;0;9;0;2.3;26026;28
61350;Babylon A.D.;364970;3.2;97;7;90;7;2.8;13;0;13;0;2.8;29288;32
61352;Traitor;988047;6.1;160;98;62;61;5.7;33;18;15;54;3.4;19383;67
61354;College;844671;2.5;40;2;38;5;2.8;12;1;11;8;2.8;10667;35
61357;Trouble the Water;1149405;8.1;70;68;2;97;8.1;21;21;0;100;4;896;86
61361;The Women;430770;3.9;142;18;124;12;3.8;34;4;30;11;3;20081;41
61394;The Onion Movie;392878;0;2;0;2;0;0;0;0;0;0;0;0;0
61401;The Spirit;831887;3.6;108;16;92;14;3.4;27;2;25;7;2.6;56971;30
61434;Oh! What a Lovely War;64754;0;1;1;0;100;0;0;0;0;0;0;0;0
61465;Bangkok Dangerous;814022;3.4;92;8;84;8;3.3;15;1;14;6;2.8;23793;33
61470;The Boys in Company C;77270;0;0;0;0;0;0;0;0;0;0;0;0;0
61473;Un secret;490234;7;43;34;9;79;7.4;15;12;3;80;3.5;1538;62
61475;August Evening;1020936;7.1;23;21;2;91;6.7;9;7;2;77;3.8;206;68
61560;That's Black Entertainment;100768;\N;\N;\N;\N;\N;\N;\N;\N;\N;\N;\N;\N;\N
61628;Xiang ri kui;401808;6.1;13;9;4;69;5.3;6;3;3;50;3.8;344;77
61634;Son of Lassie;38097;0;3;2;1;66;0;0;0;0;0;0;0;0
61646;Azuloscurocasinegro;452971;6.4;18;13;5;72;0;4;2;2;50;3.9;1509;83
61678;The Foot Fist Way;492619;5.5;81;43;38;53;6.5;24;17;7;70;3.1;2433;46
61697;Righteous Kill;1034331;4.1;138;27;111;19;3.8;28;3;25;10;3.1;29471;45
61705;Lakeview Terrace;947802;5.5;153;70;83;45;5.7;31;17;14;54;3.1;23932;44
61707;Ladrón que roba a ladrón;859760;5.6;27;17;10;62;6;10;7;3;70;3.7;1644;73
61724;Varjoja paratiisissa;92149;0;1;1;0;100;0;0;0;0;0;0;0;0
61729;Ghost Town;995039;6.9;173;147;26;84;6.9;35;30;5;85;3.3;23409;61
61742;Maradona by Kusturica;454976;0;0;0;0;0;0;0;0;0;0;0;0;0
61816;Import/Export;459102;6.9;29;24;5;82;6.8;5;4;1;80;3.8;567;76
61818;The Crow: Wicked Prayer;353324;2;5;0;5;0;0;0;0;0;0;0;0;0
61862;En la cama;474642;5.4;5;2;3;40;0;1;1;0;100;3.6;471;66
61931;Private Parts;119951;0;0;0;0;0;0;0;0;0;0;0;0;0
61934;Freebie and the Bean;71521;0;4;2;2;50;0;0;0;0;0;0;0;0
61937;Gycklarnas afton;45848;8;9;9;0;100;0;1;1;0;100;4;575;83
61941;Humboldt County;870122;5.7;19;11;8;57;5.7;5;3;2;60;3.4;626;60
61950;Boot Camp;870204;0;0;0;0;0;0;0;0;0;0;0;0;0
61961;The Beach;163978;4.4;116;22;94;18;3.9;31;4;27;12;2.9;21479;59
61967;Sanma no aji;56444;7.8;11;10;1;90;0;3;2;1;66;4.2;448;89
61970;Project Moon Base;46213;0;1;0;1;0;0;0;0;0;0;0;0;0
61986;Appaloosa;800308;6.6;156;119;37;76;6.6;34;25;9;73;3.2;19629;55
61991;Miracle at St. Anna;1046997;5.2;113;38;75;33;4.8;32;8;24;25;3.3;8435;56
62000;Katok i skripka;53987;7.6;6;5;1;83;0;1;1;0;100;3.9;347;80
62010;Käsky;920461;0;0;0;0;0;0;0;0;0;0;0;0;0
62049;Nineteen Eighty-Four;87803;6.4;14;11;3;78;0;1;1;0;100;3.5;17133;70
62081;Eagle Eye;1059786;4.6;172;47;125;27;4.7;31;8;23;25;3.7;73300;72
62113;How to Lose Friends & Alienate People;455538;5;108;40;68;37;4.3;26;6;20;23;3.1;16565;48
62137;Nights in Rodanthe;956038;4.8;128;40;88;31;4.4;27;6;21;22;3.3;26775;56
62153;Look Back in Anger;51879;7.7;8;7;1;87;0;0;0;0;0;0;0;0
62155;Nick and Norah's Infinite Playlist;981227;6.5;169;123;46;72;6.9;33;27;6;81;3.5;38982;67
62198;Marjoe;68924;7.9;5;5;0;100;0;2;2;0;100;3.9;94;84
62203;Martyrs;1029234;5.7;24;12;12;50;0;1;0;1;0;3.6;4312;71
62235;Trois couleurs: Rouge;111495;8.5;40;40;0;100;8.2;10;10;0;100;4.2;9569;94
62245;Jalsaghar;51792;9;9;9;0;100;0;4;4;0;100;4.4;358;95
62250;Gomorra;929425;7.6;136;124;12;91;8.1;34;33;1;97;3.5;21931;67
62254;Ososhiki;89746;\N;\N;\N;\N;\N;\N;\N;\N;\N;\N;\N;\N;\N
62265;The Accidental Husband;809504;2.8;16;1;15;6;0;0;0;0;0;0;0;0
62293;The Duchess;864761;6.3;161;98;63;60;6.6;35;24;11;68;3.5;22537;69
62299;Alone in the Dark;369226;1.7;116;1;115;0;1.7;26;0;26;0;2.1;8641;21
62331;Dead Leaves;439533;0;0;0;0;0;0;0;0;0;0;0;0;0
62336;FLCL;279077;0;0;0;0;0;0;0;0;0;0;0;0;0
62344;Rachel Getting Married;1084950;7.5;187;160;27;85;7.8;41;37;4;90;3.3;19208;61
62374;Body of Lies;758774;5.8;194;102;92;52;5.6;40;21;19;52;3.5;38376;66
62376;City of Ember;970411;5.7;121;63;58;52;5.9;27;16;11;59;3.2;14662;47
62378;Magicians;841027;4.2;7;2;5;28;0;1;0;1;0;0;0;0
62390;Autism: The Musical;481580;0;2;2;0;100;0;1;1;0;100;4.1;335;89
62394;Max Payne;467197;3.7;128;21;107;16;3.4;26;2;24;7;2.9;48802;36
62434;Zack and Miri Make a Porno;1007028;6.1;183;119;64;65;5.6;36;17;19;47;3.6;63027;70
62437;W.;1175491;6;205;123;82;60;5.4;40;17;23;42;3;24739;43
62439;My Best Friend's Girl;1046163;3.5;56;8;48;14;3.7;12;2;10;16;3.2;22662;52
62511;Synecdoche, New York;383028;6.6;172;116;56;67;6.4;35;22;13;62;3.6;14060;69
62526;The Drowning Pool;72912;5.4;12;7;5;58;0;4;1;3;25;3.3;312;48
62553;The Secret Life of Bees;416212;5.9;131;75;56;57;6.2;27;17;10;62;3.7;35593;79
62577;Flash of Genius;1054588;6;102;60;42;58;5.2;28;10;18;35;3.4;3988;56
62586;An American Carol;1190617;2.9;44;5;39;11;3.1;11;0;11;0;2.9;6246;48
62644;Die Welle;1063669;5.8;13;9;4;69;0;1;1;0;100;3.9;4370;83
62660;Les deux mondes;808230;0;0;0;0;0;0;0;0;0;0;0;0;0
62662;Tokyo-Ga;90182;0;0;0;0;0;0;0;0;0;0;0;0;0
62669;Kuroi kawa;134771;0;0;0;0;0;0;0;0;0;0;0;0;0
62671;Fallout;150500;\N;\N;\N;\N;\N;\N;\N;\N;\N;\N;\N;\N;\N
62718;Angus, Thongs and Perfect Snogging;963743;6;24;17;7;70;0;2;1;1;50;3.9;6295;76
62721;Bad Eggs;312409;0;0;0;0;0;0;0;0;0;0;0;0;0
62729;Niko - Lentäjän poika;885415;0;0;0;0;0;0;0;0;0;0;0;0;0
62733;Quarantine;1082868;5.7;77;45;32;58;4.8;9;4;5;44;3;32796;47
62764;Black Moon Rising;90735;3.9;9;3;6;33;0;2;1;1;50;2.8;1020;32
62788;Lost Boys: The Tribe;1031254;3.2;7;0;7;0;0;0;0;0;0;0;0;0
62792;Pride and Glory;482572;5.1;150;51;99;34;5.3;30;9;21;30;3.3;23470;54
62796;Fifty Pills;426462;0;1;0;1;0;0;0;0;0;0;0;0;0
62799;The Express;469903;6.2;114;70;44;61;6.4;28;19;9;67;3.1;11362;74
62801;Kozure Ôkami: Shinikazeni mukau ubaguruma;68817;0;1;1;0;100;0;0;0;0;0;0;0;0
62803;Kozure Ôkami: Oya no kokoro ko no kokoro;143348;0;1;1;0;100;0;0;0;0;0;0;0;0
62834;Babylon 5: The Legend of the Rangers: To Live and Die in Starlight;280453;0;0;0;0;0;0;0;0;0;0;0;0;0
62836;Babylon 5: The Lost Tales;871427;0;0;0;0;0;0;0;0;0;0;0;0;0
62849;RocknRolla;1032755;6;140;84;56;60;6.1;35;22;13;62;3.6;25930;72
62851;Zen Noir;407337;3.4;14;4;10;28;3.9;5;2;3;40;3.9;274;70
62912;High School Musical 3: Senior Year;962726;5.9;127;83;44;65;6;27;18;9;66;3.6;80210;76
62916;The Wicked Lady;38250;0;0;0;0;0;0;0;0;0;0;0;0;0
62920;I Can Get It for You Wholesale;43663;\N;\N;\N;\N;\N;\N;\N;\N;\N;\N;\N;\N;\N
62956;Futurama: Bender's Game;1054486;0;1;0;1;0;0;0;0;0;0;0;0;0
62970;Tin Man;910812;\N;\N;\N;\N;\N;\N;\N;\N;\N;\N;\N;\N;\N
62972;Into the West;104522;6.4;10;7;3;70;0;2;1;1;50;3.6;744;73
62999;Madagascar: Escape 2 Africa;479952;5.9;145;93;52;64;6.3;30;18;12;60;3.7;89627;73
63033;Blindness;861689;5.2;150;63;87;42;5;30;8;22;26;3.1;17761;49
63062;Changeling;824747;6.3;190;117;73;61;5.6;39;17;22;43;3.8;63438;84
63069;Ginî piggu 2: Chiniku no hana;161635;0;0;0;0;0;0;0;0;0;0;0;0;0
63082;Slumdog Millionaire;1010048;8.2;220;206;14;93;8.2;38;36;2;94;4;328969;90
63113;Quantum of Solace;830515;6.1;241;154;87;63;5.6;41;15;26;36;3.5;125850;62
63119;Filth and Wisdom;1042499;3.9;58;15;43;25;4.2;23;7;16;30;3;1070;42
63121;A Tale of Two Cities;52270;0;0;0;0;0;0;0;0;0;0;0;0;0
63131;Role Models;430922;6.5;152;117;35;76;6.4;34;23;11;67;3.7;63260;75
63181;Tôkyô zankoku keisatsu;1183732;6.8;9;9;0;100;0;3;3;0;100;3.4;1468;61
63187;Kozara;55059;\N;\N;\N;\N;\N;\N;\N;\N;\N;\N;\N;\N;\N
63189;Sauna;1124394;0;0;0;0;0;0;0;0;0;0;0;0;0
63194;Caótica Ana;456340;0;2;1;1;50;0;1;1;0;100;3.5;1071;65
63222;JCVD;1130988;7;98;83;15;84;7.1;25;21;4;84;3.5;8534;71
63237;Ils se marièrent et eurent beaucoup d'enfants;381270;6;40;23;17;57;6.3;19;12;7;63;3.6;1061;70
63239;Cinderella;42332;7.3;26;24;2;92;8;5;5;0;100;3.5;63946;76
63276;Kurôzu zero;1016290;0;0;0;0;0;0;0;0;0;0;0;0;0
63310;Lord of War;399295;6.2;141;86;55;60;5.6;33;14;19;42;3.6;51125;84
63329;Joulutarina;772176;0;0;0;0;0;0;0;0;0;0;0;0;0
63339;Todas las azafatas van al cielo;293654;0;0;0;0;0;0;0;0;0;0;0;0;0
63393;Camp Rock;1055366;5.2;5;1;4;20;0;0;0;0;0;0;0;0
63433;Farscape: The Peacekeeper Wars;387736;0;0;0;0;0;0;0;0;0;0;0;0;0
63436;Saw V;1132626;2.9;69;9;60;13;2.7;13;1;12;7;3.5;64670;63
63446;Un conte de Noël;993789;7.5;111;97;14;87;7.9;26;24;2;92;3.4;12013;64
63458;Critters 4;101628;0;2;0;2;0;0;0;0;0;0;0;0;0
63479;Sex Drive;1135985;5.3;107;49;58;45;5.8;25;13;12;52;3.4;18987;61
63481;Soul Men;1111948;5;97;44;53;45;5.6;29;17;12;58;3.3;12766;61
63540;Beverly Hills Chihuahua;1014775;5;93;38;55;40;5.5;19;9;10;47;3.2;35658;56
63617;Christmas on Mars;363240;5.5;6;3;3;50;0;4;2;2;50;3.3;530;56
63647;Goyôkiba;68650;0;2;2;0;100;0;0;0;0;0;0;0;0
63662;Joi gin a long;202682;0;1;1;0;100;0;0;0;0;0;0;0;0
63676;Tanin no kao;61065;7.4;6;6;0;100;0;1;1;0;100;4.1;598;90
63698;Üç maymun;1233381;6.7;56;43;13;76;7.7;13;12;1;92;3.6;1239;72
63760;Bellissima;43332;0;2;2;0;100;0;1;1;0;100;4;268;88
63768;Irezumi ichidai;59320;0;0;0;0;0;0;0;0;0;0;0;0;0
63772;Bullfighter and the Lady;43363;0;1;0;1;0;0;0;0;0;0;0;0;0
63793;Wagon Master;43117;0;4;4;0;100;0;0;0;0;0;0;0;0
63806;Ring of Darkness;372803;0;0;0;0;0;0;0;0;0;0;0;0;0
63808;Entre les murs;1068646;8.1;143;139;4;97;8.3;33;33;0;100;3.8;6106;80
63853;Australia;455824;5.9;199;109;90;54;5.3;38;18;20;47;3.5;75143;69
63859;Bolt;397892;7.2;174;154;20;88;6.6;31;24;7;77;3.6;68805;76
63876;Milk;1013753;8;217;203;14;93;8.3;38;36;2;94;3.9;55245;88
63989;The Devil-Doll;27521;0;0;0;0;0;0;0;0;0;0;0;0;0
63992;Twilight;1099212;5.5;196;98;98;50;5.9;36;20;16;55;4.1;256646;82
64030;Transporter 3;1129442;4.8;105;39;66;37;4.7;23;7;16;30;3.4;58914;58
64032;Four Christmases;369436;4.3;139;35;104;25;4;27;5;22;18;3.3;79552;52
64034;The Boy in the Striped Pyjamas;914798;6.2;132;84;48;63;6.3;28;18;10;64;3.9;31826;85
64114;Fireproof;1129423;4.4;20;8;12;40;5.2;6;3;3;50;4.2;14600;87
64116;Igor;465502;4.8;87;31;56;35;4.2;18;3;15;16;3;18397;43
64229;Cadillac Records;1042877;6.1;118;79;39;66;6.5;33;23;10;69;3.3;13310;64
64231;Punisher: War Zone;450314;4.2;96;25;71;26;3.7;21;1;20;4;3;29393;47
64245;The Bellboy;53644;6.9;9;6;3;66;0;0;0;0;0;0;0;0
64249;Shrek the Halls;897387;0;2;1;1;50;0;0;0;0;0;0;0;0
64273;Les amants;52556;7.3;8;8;0;100;0;0;0;0;0;0;0;0
64278;The Pervert's Guide to Cinema;828154;7.1;20;18;2;90;7.6;9;9;0;100;4;801;84
64280;Britannia Hospital;83694;6.8;5;3;2;60;0;0;0;0;0;0;0;0
64283;Yoru no onnatachi;40980;\N;\N;\N;\N;\N;\N;\N;\N;\N;\N;\N;\N;\N
64285;Wallace and Gromit in 'A Matter of Loaf and Death';1118511;0;1;1;0;100;0;0;0;0;0;0;0;0
64288;Ace of Hearts;1032746;\N;\N;\N;\N;\N;\N;\N;\N;\N;\N;\N;\N;\N
64338;Gypsy;56048;6.4;11;8;3;72;0;0;0;0;0;0;0;0
64368;Ninja III: The Domination;87805;0;1;0;1;0;0;0;0;0;0;0;0;0
64418;A Man Named Pearl;878134;6.8;29;22;7;75;7;9;8;1;88;4;248;86
64427;Much Ado About Something;298072;\N;\N;\N;\N;\N;\N;\N;\N;\N;\N;\N;\N;\N
64497;The Day the Earth Stood Still;43456;8;50;47;3;94;7;5;4;1;80;3.8;8999;86
64499;Che: Part One;892255;6.3;128;84;44;65;5.6;24;14;10;58;3.7;10315;76
64501;Che: Part Two;374569;6.5;40;31;9;77;0;3;2;1;66;3.5;6290;65
64508;Starship Troopers 3: Marauder;844760;5.4;5;3;2;60;0;0;0;0;0;0;0;0
64519;Boomerang;103859;4.8;27;10;17;37;5.4;8;4;4;50;2.8;4751;55
64575;Doubt;918927;6.9;204;159;45;77;6.4;40;28;12;70;3.7;86761;75
64611;The Forgotten;356618;5;168;51;117;30;4.7;34;10;24;29;2.9;13766;47
64614;Gran Torino;1205489;7.1;211;169;42;80;6.7;39;28;11;71;4.2;193304;90
64620;Frost/Nixon;870111;7.9;216;198;18;91;7.7;41;37;4;90;3.8;38396;86
64622;The Reader;976051;6.3;183;112;71;61;6;35;19;16;54;3.7;89822;78
64701;Il y a longtemps que je t'aime;1068649;7.4;119;106;13;89;7.7;32;31;1;96;3.9;6732;85
64716;Seven Pounds;814314;4.6;180;48;132;26;5;36;13;23;36;3.6;143024;77
64750;Pin;95871;0;0;0;0;0;0;0;0;0;0;0;0;0
64839;The Wrestler;1125849;8.3;207;202;5;97;8.2;37;36;1;97;3.9;57550;86
64900;Sien nui yau wan II yan gaan do;100625;0;1;1;0;100;0;0;0;0;0;0;0;0
64903;The Nazis Strike;184773;\N;\N;\N;\N;\N;\N;\N;\N;\N;\N;\N;\N;\N
64906;The Battle of Britain;182766;0;0;0;0;0;0;0;0;0;0;0;0;0
64918;Petites coupures;304547;0;4;2;2;50;0;0;0;0;0;0;0;0
64921;Arabian Nights;181199;0;3;2;1;66;0;0;0;0;0;0;0;0
64926;The Battle of Russia;36629;\N;\N;\N;\N;\N;\N;\N;\N;\N;\N;\N;\N;\N
64930;The More the Merrier;36172;8.2;12;12;0;100;0;2;2;0;100;3.9;428;85
64942;Tuya de hun shi;949564;7.1;31;28;3;90;6.9;11;9;2;81;3.8;595;80
64957;The Curious Case of Benjamin Button;421715;7.1;228;165;63;72;6.9;37;28;9;75;3.7;216019;81
64959;Divide and Conquer;182989;\N;\N;\N;\N;\N;\N;\N;\N;\N;\N;\N;\N;\N
64969;Yes Man;1068680;5.2;144;62;82;43;4.9;31;12;19;38;3.7;141478;72
64976;Hexed;107107;2;8;1;7;12;0;2;0;2;0;0;0;0
64983;Valkyrie;985699;6;185;113;72;61;6;37;22;15;59;3.5;113378;66
64986;Birds of America;1029134;0;4;0;4;0;0;2;0;2;0;3.1;1163;47
64990;Pete Seeger: The Power of Song;1003116;8.2;20;19;1;95;8;12;11;1;91;4.3;233;93
64993;Byôsoku 5 senchimêtoru;983213;0;2;2;0;100;0;1;1;0;100;4.3;1726;91
64997;War of the Worlds;407304;7;244;178;66;72;6.7;42;28;14;66;2.9;162092;45
64999;War of the Worlds 2: The Next Wave;1183733;0;0;0;0;0;0;0;0;0;0;0;0;0
65006;Impulse;1078899;0;2;0;2;0;0;0;0;0;0;0;0;0
65011;Zona Zamfirova;326449;0;0;0;0;0;0;0;0;0;0;0;0;0
65037;Ben X;953318;6.3;36;24;12;66;6.1;7;4;3;57;3.9;2886;82
65088;Bedtime Stories;960731;4.4;104;26;78;25;4.7;26;6;20;23;3.5;108877;63
65091;Manhattan Melodrama;25464;7;12;10;2;83;0;4;2;2;50;3.7;344;71
65126;Choke;1024715;5.6;135;73;62;54;4.9;26;8;18;30;3.3;13893;55
65130;Revolutionary Road;959337;6.7;194;133;61;68;6.9;36;25;11;69;3.5;46044;70
65133;Blackadder Back & Forth;212579;0;0;0;0;0;0;0;0;0;0;0;0;0
